Id,Label,type,indegree,outdegree,Degree,weighted indegree,weighted outdegree,Weighted Degree,eigencentrality,Eccentricity,closnesscentrality,harmonicclosnesscentrality,betweenesscentrality
《中央周刊》,《中央周刊》,journal,1252,0,1252,2605,0,2605,0.818444,3,0.380059,0.455935,4844009.648957
《时代杂志》,《时代杂志》,journal,871,0,871,2268,0,2268,0.555033,3,0.364593,0.41873,3156299.976849
《国讯》,《国讯》,journal,1530,0,1530,2871,0,2871,1,3,0.392199,0.483082,6163541.611616
《文萃》,《文萃》,journal,313,0,313,399,0,399,0.20474,3,0.344085,0.36424,901333.873324
《再生》,《再生》,journal,769,0,769,1503,0,1503,0.524025,3,0.360664,0.408769,2542659.137156
《观察》,《观察》,journal,1256,0,1256,2083,0,2083,0.803051,3,0.380228,0.456325,4920814.585425
《正报》,《正报》,journal,1021,0,1021,1705,0,1705,0.627508,3,0.370529,0.433377,4002688.140811
《中建》,《中建》,journal,695,0,695,1665,0,1665,0.39966,3,0.357865,0.401543,2693732.675533
《民主:桂林版》,《民主:桂林版》,journal,54,0,54,59,0,59,0.04347,3,0.335331,0.338948,95989.439748
《光明报》,《光明报》,journal,281,0,281,395,0,395,0.207729,3,0.342979,0.361115,640899.000512
杂话(1947),杂话,notion,0,1,1,0,56,56,0.013711,4,0.275027,0.295469,0
《群众》,《群众》,journal,1235,0,1235,2378,0,2378,0.775908,3,0.379341,0.454275,4864321.78338
茶亭(1947),茶亭,notion,0,1,1,0,56,56,0.013711,4,0.275027,0.295469,0
一週(1947),一週,notion,0,1,1,0,54,54,0.014222,4,0.275404,0.296091,0
时事(1947),时事,notion,0,4,4,0,87,87,0.05181,4,0.339635,0.38211,11504.912599
战局(1947),战局,notion,0,8,8,0,62,62,0.093761,4,0.423695,0.455373,47925.23631
官僚政治(1947),官僚政治,notion,0,1,1,0,26,26,0.014732,4,0.276453,0.297813,0
《时与文》,《时与文》,journal,1299,0,1299,2063,0,2063,0.847828,3,0.382058,0.460524,5057777.195152
中国(1947),中国,notion,0,14,14,0,270,270,0.12627,4,0.499524,0.500525,107739.132696
学生(1947),学生,notion,0,9,9,0,82,82,0.097333,4,0.429236,0.459243,51719.499554
亮话(1947),亮话,notion,0,1,1,0,35,35,0.017323,4,0.281723,0.306272,0
华莱士(1947),华莱士,notion,0,7,7,0,34,34,0.08421,4,0.401896,0.43931,34276.447759
民主(1947),民主,notion,0,15,15,0,145,145,0.127139,2,0.50055,0.501099,113126.555332
抗议(1947),抗议,notion,0,8,8,0,30,30,0.079311,4,0.384988,0.425712,32944.484762
民盟(1947),民盟,notion,0,7,7,0,29,29,0.086692,4,0.406587,0.442898,34235.041902
学联(1947),学联,notion,0,2,2,0,15,15,0.031034,4,0.30613,0.341707,2639.595687
要求(1947),要求,notion,0,5,5,0,22,22,0.046254,4,0.328048,0.369171,13295.722419
反对(1947),反对,notion,0,9,9,0,27,27,0.096252,4,0.426022,0.457046,52995.772497
和平(1947),和平,notion,0,14,14,0,82,82,0.12627,4,0.499524,0.500525,107739.132696
多幅(1947),多幅,notion,0,5,5,0,26,26,0.061493,4,0.355628,0.398723,15990.867703
陌上(1947),陌上,notion,0,1,1,0,14,14,0.007422,4,0.26356,0.275695,0
宪政(1947),宪政,notion,0,3,3,0,20,20,0.037338,4,0.310954,0.348103,4493.316655
康熙帝(1947),康熙帝,notion,0,1,1,0,12,12,0.014222,4,0.275404,0.296091,0
社论(1947),社论,notion,0,3,3,0,59,59,0.042664,4,0.32508,0.365571,6696.006793
经济(1947),经济,notion,0,15,15,0,156,156,0.127139,2,0.50055,0.501099,113126.555332
连载(1947),连载,notion,0,1,1,0,20,20,0.014222,4,0.275404,0.296091,0
名着(1947),名着,notion,0,2,2,0,21,21,0.031545,4,0.305336,0.340645,2219.908318
研究(1947),研究,notion,0,8,8,0,34,34,0.09091,4,0.424064,0.45563,51512.769537
历史(1947),历史,notion,0,10,10,0,38,38,0.113656,4,0.47966,0.489917,80550.222195
呼吁(1947),呼吁,notion,0,4,4,0,15,15,0.046613,4,0.326698,0.367536,8119.373289
国际(1947),国际,notion,0,10,10,0,101,101,0.108209,4,0.464959,0.481678,75264.794799
工作(1947),工作,notion,0,10,10,0,97,97,0.102689,4,0.442249,0.467873,69174.078332
批评(1947),批评,notion,0,4,4,0,34,34,0.054263,4,0.346671,0.389581,13138.644642
故事(1947),故事,notion,0,9,9,0,31,31,0.107277,4,0.462127,0.479969,67098.57931
教授(1947),教授,notion,0,7,7,0,25,25,0.082405,4,0.396021,0.434696,30607.428353
知识份子(1947),知识份子,notion,0,5,5,0,16,16,0.044583,4,0.323693,0.364045,11487.062823
美国(1947),美国,notion,0,15,15,0,253,253,0.127139,2,0.50055,0.501099,113126.555332
观察(1947),观察,notion,0,6,6,0,73,73,0.083878,4,0.406732,0.442947,31919.445754
制度(1947),制度,notion,0,8,8,0,35,35,0.091373,4,0.413032,0.447756,44401.173976
华侨(1947),华侨,notion,0,5,5,0,20,20,0.074068,4,0.386821,0.427067,22597.98619
大独裁者(1947),大独裁者,notion,0,1,1,0,9,9,0.013711,4,0.275027,0.295469,0
意见(1947),意见,notion,0,11,11,0,47,47,0.108394,4,0.4548,0.475734,77812.287093
政治(1947),政治,notion,0,13,13,0,106,106,0.122862,4,0.492249,0.496765,100201.812103
民主社会党(1947),民主社会党,notion,0,1,1,0,10,10,0.009035,4,0.265075,0.278404,0
真相(1947),真相,notion,0,6,6,0,15,15,0.061032,4,0.354189,0.397356,20872.577024
苏俄(1947),苏俄,notion,0,1,1,0,9,9,0.014222,4,0.275404,0.296091,0
苏维埃(1947),苏维埃,notion,0,2,2,0,28,28,0.024032,4,0.290894,0.320321,1695.498775
解释(1947),解释,notion,0,3,3,0,13,13,0.042523,4,0.324801,0.365241,6618.635877
问答(1947),问答,notion,0,2,2,0,10,10,0.013784,4,0.270451,0.28784,449.976833
青年(1947),青年,notion,0,9,9,0,74,74,0.111564,4,0.475517,0.487586,72133.369527
中建(1947),中建,notion,0,1,1,0,47,47,0.007422,4,0.26356,0.275695,0
任务(1947),任务,notion,0,8,8,0,17,17,0.097484,4,0.4376,0.464748,55089.097401
各国(1947),各国,notion,0,6,6,0,21,21,0.079203,4,0.389736,0.429544,26956.547236
后果(1947),后果,notion,0,3,3,0,11,11,0.017372,4,0.274739,0.295115,1275.520395
学校(1947),学校,notion,0,6,6,0,19,19,0.079008,4,0.399497,0.437381,33822.042118
宣言(1947),宣言,notion,0,4,4,0,18,18,0.043658,4,0.322896,0.363032,7811.752804
宪法(1947),宪法,notion,0,6,6,0,35,35,0.051345,4,0.334477,0.376556,16088.476095
德国(1947),德国,notion,0,6,6,0,44,44,0.078182,4,0.390538,0.430204,28346.992334
性格(1947),性格,notion,0,3,3,0,11,11,0.037848,4,0.312921,0.35063,4836.024023
日记(1947),日记,notion,0,6,6,0,19,19,0.049467,4,0.333529,0.375494,18070.358262
片断(1947),片断,notion,0,2,2,0,15,15,0.021132,4,0.288412,0.316623,2574.708611
现势(1947),现势,notion,0,4,4,0,11,11,0.040723,4,0.320833,0.360541,9908.657526
生活(1947),生活,notion,0,11,11,0,81,81,0.120012,4,0.489988,0.495471,89491.637995
自助(1947),自助,notion,0,2,2,0,12,12,0.021644,4,0.28732,0.314975,1747.667055
解说(1947),解说,notion,0,1,1,0,8,8,0.011229,4,0.270366,0.287632,0
谈话(1947),谈话,notion,0,7,7,0,24,24,0.079798,4,0.391748,0.431253,33012.8416
东北(1947),东北,notion,0,9,9,0,35,35,0.107841,4,0.459947,0.478688,64077.303046
今日(1947),今日,notion,0,10,10,0,61,61,0.116313,4,0.481963,0.491163,78875.153076
俄罗斯(1947),俄罗斯,notion,0,2,2,0,14,14,0.024542,4,0.292264,0.322335,1826.657886
发展(1947),发展,notion,0,10,10,0,56,56,0.115153,4,0.480673,0.490467,78992.005871
土地(1947),土地,notion,0,5,5,0,22,22,0.058007,4,0.349404,0.392461,17465.921188
孙科(1947),孙科,notion,0,3,3,0,10,10,0.041214,4,0.322074,0.361982,6317.925086
学说(1947),学说,notion,0,3,3,0,10,10,0.031963,4,0.30591,0.341475,6151.757212
悲华经舍(1947),悲华经舍,notion,0,1,1,0,7,7,0.009035,4,0.265075,0.278404,0
政策(1947),政策,notion,0,12,12,0,53,53,0.1236,4,0.495177,0.498206,96960.835096
时局(1947),时局,notion,0,11,11,0,25,25,0.116178,4,0.470795,0.485072,76899.437912
杂记(1947),杂记,notion,0,5,5,0,20,20,0.051207,4,0.33782,0.380194,17701.235591
江南(1947),江南,notion,0,4,4,0,11,11,0.044818,4,0.324585,0.365046,8006.560648
社会(1947),社会,notion,0,10,10,0,52,52,0.113656,4,0.47966,0.489917,80550.222195
苏联(1947),苏联,notion,0,11,11,0,150,150,0.113459,4,0.467123,0.482984,75068.511813
转向(1947),转向,notion,0,2,2,0,8,8,0.023257,4,0.28761,0.315414,1169.271875
世界(1947),世界,notion,0,13,13,0,125,125,0.122862,4,0.492249,0.496765,100201.812103
之谷(1947),之谷,notion,0,1,1,0,7,7,0.014222,4,0.275404,0.296091,0
人民(1947),人民,notion,0,12,12,0,118,118,0.114391,4,0.469565,0.484437,83369.293633
会议(1947),会议,notion,0,9,9,0,54,54,0.097349,4,0.427998,0.4584,53262.826008
作家(1947),作家,notion,0,4,4,0,14,14,0.056087,4,0.347518,0.390459,11793.60224
保障(1947),保障,notion,0,7,7,0,14,14,0.080156,4,0.397311,0.435721,37458.441543
十字架(1947),十字架,notion,0,1,1,0,6,6,0.014222,4,0.275404,0.296091,0
印尼(1947),印尼,notion,0,6,6,0,20,20,0.074546,4,0.381333,0.422477,24856.364038
团体(1947),团体,notion,0,3,3,0,31,31,0.03378,4,0.308426,0.344807,5760.487347
外海(1947),外海,notion,0,1,1,0,6,6,0.007422,4,0.26356,0.275695,0
大学生(1947),大学生,notion,0,4,4,0,11,11,0.052536,4,0.34646,0.389361,14979.850154
如此(1947),如此,notion,0,7,7,0,19,19,0.080598,4,0.393464,0.432645,33510.812421
建议(1947),建议,notion,0,8,8,0,21,21,0.101754,4,0.450954,0.473207,58063.306677
快乐(1947),快乐,notion,0,2,2,0,8,8,0.024032,4,0.290894,0.320321,1695.498775
报导(1947),报导,notion,0,4,4,0,21,21,0.049685,4,0.340312,0.382843,14251.952851
服务(1947),服务,notion,0,4,4,0,18,18,0.050196,4,0.340482,0.383026,13611.702601
纪念(1947),纪念,notion,0,11,11,0,78,78,0.118852,4,0.488585,0.494739,89488.86711
美报(1947),美报,notion,0,1,1,0,6,6,0.017323,4,0.281723,0.306272,0
英国(1947),英国,notion,0,11,11,0,61,61,0.114572,4,0.467251,0.483057,75195.85091
莫斯科(1947),莫斯科,notion,0,9,9,0,40,40,0.084775,4,0.394191,0.433353,43219.831744
解放(1947),解放,notion,0,5,5,0,17,17,0.062929,4,0.360093,0.403081,18838.007415
问题(1947),问题,notion,0,12,12,0,212,212,0.120479,4,0.48719,0.494068,87245.654249
下篇(1947),下篇,notion,0,3,3,0,9,9,0.04058,4,0.317727,0.356672,4950.672902
侨胞(1947),侨胞,notion,0,1,1,0,5,5,0.017323,4,0.281723,0.306272,0
信念(1947),信念,notion,0,1,1,0,5,5,0.009035,4,0.265075,0.278404,0
共和国(1947),共和国,notion,0,5,5,0,19,19,0.06396,4,0.362695,0.405571,18853.035808
发表(1947),发表,notion,0,5,5,0,11,11,0.053979,4,0.337753,0.380121,12321.873442
台湾(1947),台湾,notion,0,9,9,0,27,27,0.106503,4,0.456869,0.476857,64029.715723
合工(1947),合工,notion,0,1,1,0,5,5,0.007422,4,0.26356,0.275695,0
同志(1947),同志,notion,0,4,4,0,21,21,0.03606,4,0.311664,0.34908,9766.219142
周评(1947),周评,notion,0,1,1,0,27,27,0.009035,4,0.265075,0.278404,0
基本(1947),基本,notion,0,6,6,0,13,13,0.071523,4,0.377829,0.419438,28383.101058
大公报(1947),大公报,notion,0,7,7,0,13,13,0.076709,4,0.38044,0.421769,27313.025965
太平洋(1947),太平洋,notion,0,6,6,0,12,12,0.063965,4,0.362387,0.405339,25780.034155
学运(1947),学运,notion,0,3,3,0,12,12,0.045114,4,0.331456,0.372968,7474.911045
市政(1947),市政,notion,0,1,1,0,5,5,0.014222,4,0.275404,0.296091,0
德意志(1947),德意志,notion,0,1,1,0,5,5,0.009035,4,0.265075,0.278404,0
成立(1947),成立,notion,0,3,3,0,10,10,0.042774,4,0.326479,0.367218,7162.216692
政党(1947),政党,notion,0,8,8,0,22,22,0.086044,4,0.39745,0.435892,36642.680445
教育(1947),教育,notion,0,10,10,0,49,49,0.09736,4,0.429128,0.459231,60069.921461
本期(1947),本期,notion,0,1,1,0,5,5,0.014081,4,0.275493,0.296238,0
杂谈(1947),杂谈,notion,0,2,2,0,9,9,0.020265,4,0.284375,0.310471,1611.931322
海外(1947),海外,notion,0,2,2,0,7,7,0.02531,4,0.2954,0.326876,2496.768821
狱中(1947),狱中,notion,0,2,2,0,6,6,0.031404,4,0.30602,0.34156,2430.025091
社会主义(1947),社会主义,notion,0,7,7,0,50,50,0.081295,4,0.39274,0.432059,32289.764964
简记(1947),简记,notion,0,1,1,0,5,5,0.014081,4,0.275493,0.296238,0
纽约(1947),纽约,notion,0,6,6,0,15,15,0.078182,4,0.390538,0.430204,28346.992334
而歌(1947),而歌,notion,0,2,2,0,6,6,0.021502,4,0.288388,0.316586,2245.621531
职工(1947),职工,notion,0,3,3,0,13,13,0.040844,4,0.32171,0.361542,6321.992194
自由(1947),自由,notion,0,8,8,0,37,37,0.095006,4,0.426501,0.457314,46666.208362
被捕(1947),被捕,notion,0,4,4,0,14,14,0.059846,4,0.358316,0.401299,13903.979248
解放区(1947),解放区,notion,0,3,3,0,35,35,0.028639,4,0.298109,0.330782,4064.109793
诗选(1947),诗选,notion,0,1,1,0,5,5,0.014081,4,0.275493,0.296238,0
采风(1947),采风,notion,0,2,2,0,8,8,0.021644,4,0.28732,0.314975,1747.667055
青运(1947),青运,notion,0,1,1,0,10,10,0.011229,4,0.270366,0.287632,0
马来亚(1947),马来亚,notion,0,4,4,0,12,12,0.056087,4,0.347518,0.390459,11793.60224
魏德迈(1947),魏德迈,notion,0,8,8,0,35,35,0.092138,4,0.421602,0.453909,45166.793936
一位(1947),一位,notion,0,3,3,0,6,6,0.046135,4,0.331006,0.372455,6671.362925
上海市(1947),上海市,notion,0,2,2,0,6,6,0.022746,4,0.288631,0.316952,1575.703869
上饶(1947),上饶,notion,0,1,1,0,4,4,0.007422,4,0.26356,0.275695,0
中国政府(1947),中国政府,notion,0,2,2,0,5,5,0.031545,4,0.305336,0.340645,2219.908318
主张(1947),主张,notion,0,5,5,0,10,10,0.05904,4,0.34969,0.392754,14496.407091
书话(1947),书话,notion,0,1,1,0,4,4,0.014732,4,0.276453,0.297813,0
事业(1947),事业,notion,0,5,5,0,54,54,0.043424,4,0.323509,0.363825,11091.598051
作者(1947),作者,notion,0,3,3,0,9,9,0.038622,4,0.31649,0.355134,5969.179521
兄长(1947),兄长,notion,0,1,1,0,4,4,0.00981,4,0.267191,0.28214,0
内幕(1947),内幕,notion,0,9,9,0,24,24,0.107841,4,0.459947,0.478688,64077.303046
内战(1947),内战,notion,0,10,10,0,34,34,0.106368,4,0.446705,0.470692,62182.735694
农村(1947),农村,notion,0,7,7,0,50,50,0.087674,4,0.416103,0.449929,43135.940946
列宁(1947),列宁,notion,0,2,2,0,23,23,0.024542,4,0.292264,0.322335,1826.657886
前线(1947),前线,notion,0,3,3,0,6,6,0.032731,4,0.308565,0.34499,6759.60024
北江(1947),北江,notion,0,2,2,0,9,9,0.02494,4,0.292941,0.323324,1747.290038
十讲(1947),十讲,notion,0,1,1,0,4,4,0.009035,4,0.265075,0.278404,0
南雄(1947),南雄,notion,0,1,1,0,4,4,0.011229,4,0.270366,0.287632,0
参政员(1947),参政员,notion,0,2,2,0,5,5,0.031404,4,0.30602,0.34156,2430.025091
四季(1947),四季,notion,0,1,1,0,4,4,0.014732,4,0.276453,0.297813,0
声援(1947),声援,notion,0,2,2,0,5,5,0.031034,4,0.30613,0.341707,2639.595687
外交政策(1947),外交政策,notion,0,6,6,0,18,18,0.078833,4,0.39112,0.43068,27817.84392
官僚(1947),官僚,notion,0,4,4,0,9,9,0.047783,4,0.328426,0.36955,8037.024334
将军(1947),将军,notion,0,9,9,0,21,21,0.090406,4,0.414385,0.448806,50247.916661
尊严(1947),尊严,notion,0,4,4,0,7,7,0.060357,4,0.356893,0.399907,12921.914509
席上(1947),席上,notion,0,1,1,0,9,9,0.00981,4,0.267191,0.28214,0
广东(1947),广东,notion,0,5,5,0,55,55,0.05734,4,0.349404,0.392461,16148.671786
张东荪(1947),张东荪,notion,0,3,3,0,13,13,0.046135,4,0.331006,0.372455,6671.362925
战争(1947),战争,notion,0,10,10,0,29,29,0.115263,4,0.483327,0.491895,82296.794945
战犯(1947),战犯,notion,0,4,4,0,8,8,0.056745,4,0.35084,0.393865,13092.7345
批判(1947),批判,notion,0,3,3,0,7,7,0.026634,4,0.294865,0.326168,3618.419021
摘要(1947),摘要,notion,0,3,3,0,8,8,0.036968,4,0.31232,0.349861,5188.431101
改造(1947),改造,notion,0,6,6,0,12,12,0.0516,4,0.331424,0.373114,16205.734638
攻势(1947),攻势,notion,0,4,4,0,10,10,0.045962,4,0.330525,0.371967,10636.494002
方言(1947),方言,notion,0,1,1,0,19,19,0.011229,4,0.270366,0.287632,0
昆明(1947),昆明,notion,0,4,4,0,19,19,0.059846,4,0.358316,0.401299,13903.979248
昏话(1947),昏话,notion,0,1,1,0,4,4,0.009035,4,0.265075,0.278404,0
机构(1947),机构,notion,0,2,2,0,8,8,0.017232,4,0.279944,0.303513,1791.004954
李济琛(1947),李济琛,notion,0,2,2,0,5,5,0.031034,4,0.30613,0.341707,2639.595687
每册(1947),每册,notion,0,1,1,0,4,4,0.014081,4,0.275493,0.296238,0
民族(1947),民族,notion,0,9,9,0,31,31,0.089262,4,0.403415,0.440603,42906.883146
民社党(1947),民社党,notion,0,5,5,0,9,9,0.059919,4,0.348975,0.392022,13679.22036
泛亚(1947),泛亚,notion,0,1,1,0,4,4,0.009035,4,0.265075,0.278404,0
活动(1947),活动,notion,0,5,5,0,16,16,0.062997,4,0.364476,0.407256,22136.519946
港九(1947),港九,notion,0,2,2,0,5,5,0.028552,4,0.301506,0.335445,2588.539662
湖南(1947),湖南,notion,0,3,3,0,10,10,0.034996,4,0.3096,0.346345,5295.966128
演说(1947),演说,notion,0,4,4,0,7,7,0.053094,4,0.343393,0.386138,12507.957973
田赋(1947),田赋,notion,0,2,2,0,5,5,0.020265,4,0.284375,0.310471,1611.931322
病态(1947),病态,notion,0,1,1,0,4,4,0.007422,4,0.26356,0.275695,0
私人(1947),私人,notion,0,3,3,0,6,6,0.036152,4,0.310784,0.347883,3947.803671
笔记(1947),笔记,notion,0,2,2,0,6,6,0.028552,4,0.301506,0.335445,2588.539662
第二篇(1947),第二篇,notion,0,2,2,0,5,5,0.024032,4,0.290894,0.320321,1695.498775
紧张(1947),紧张,notion,0,3,3,0,6,6,0.046135,4,0.331006,0.372455,6671.362925
纵横(1947),纵横,notion,0,2,2,0,25,25,0.021132,4,0.288412,0.316623,2574.708611
联合国(1947),联合国,notion,0,7,7,0,18,18,0.08293,4,0.395883,0.434586,32664.700519
自箴语(1947),自箴语,notion,0,1,1,0,4,4,0.017323,4,0.281723,0.306272,0
致函(1947),致函,notion,0,1,1,0,4,4,0.017323,4,0.281723,0.306272,0
花絮(1947),花絮,notion,0,2,2,0,5,5,0.028954,4,0.300154,0.333577,2064.821066
菲岛(1947),菲岛,notion,0,1,1,0,4,4,0.013711,4,0.275027,0.295469,0
蒋主席(1947),蒋主席,notion,0,4,4,0,7,7,0.049214,4,0.334084,0.375995,9103.553854
蜡烛(1947),蜡烛,notion,0,1,1,0,4,4,0.014732,4,0.276453,0.297813,0
计划(1947),计划,notion,0,9,9,0,35,35,0.102232,4,0.443802,0.4688,61175.526546
认识(1947),认识,notion,0,6,6,0,17,17,0.056276,4,0.346074,0.38908,20679.846683
记者(1947),记者,notion,0,5,5,0,13,13,0.059024,4,0.351273,0.394366,15343.321248
访苏(1947),访苏,notion,0,2,2,0,6,6,0.024542,4,0.292264,0.322335,1826.657886
诞生(1947),诞生,notion,0,6,6,0,12,12,0.061182,4,0.35873,0.401824,25067.61233
说老实话(1947),说老实话,notion,0,1,1,0,4,4,0.009035,4,0.265075,0.278404,0
读书(1947),读书,notion,0,5,5,0,22,22,0.064166,4,0.36655,0.409196,22194.826068
贝尔纳斯(1947),贝尔纳斯,notion,0,2,2,0,5,5,0.023257,4,0.28761,0.315414,1169.271875
近事(1947),近事,notion,0,2,2,0,9,9,0.028442,4,0.300022,0.333394,2187.730369
进步(1947),进步,notion,0,7,7,0,17,17,0.072981,4,0.379172,0.42067,29298.622445
重庆(1947),重庆,notion,0,4,4,0,15,15,0.059987,4,0.358354,0.401335,13771.233391
间谍网(1947),间谍网,notion,0,1,1,0,4,4,0.014222,4,0.275404,0.296091,0
阴谋(1947),阴谋,notion,0,7,7,0,13,13,0.084615,4,0.405091,0.441763,36227.164455
革命(1947),革命,notion,0,11,11,0,57,57,0.104781,4,0.445772,0.470167,77182.53201
领域(1947),领域,notion,0,1,1,0,4,4,0.014222,4,0.275404,0.296091,0
风向(1947),风向,notion,0,1,1,0,4,4,0.014222,4,0.275404,0.296091,0
一角(1947),一角,notion,0,2,2,0,4,4,0.018651,4,0.283055,0.30842,2017.209887
三个(1947),三个,notion,0,7,7,0,12,12,0.085124,4,0.406684,0.442972,37424.364796
三篇(1947),三篇,notion,0,1,1,0,3,3,0.009035,4,0.265075,0.278404,0
不满(1947),不满,notion,0,2,2,0,4,4,0.031404,4,0.30602,0.34156,2430.025091
个人(1947),个人,notion,0,3,3,0,5,5,0.030075,4,0.299811,0.333162,4569.529654
主义(1947),主义,notion,0,10,10,0,31,31,0.110983,4,0.462565,0.480287,68724.222699
举行(1947),举行,notion,0,2,2,0,4,4,0.031545,4,0.305336,0.340645,2219.908318
九重天(1947),九重天,notion,0,1,1,0,3,3,0.014222,4,0.275404,0.296091,0
书报(1947),书报,notion,0,2,2,0,10,10,0.024032,4,0.290894,0.320321,1695.498775
书面(1947),书面,notion,0,2,2,0,5,5,0.020912,4,0.285589,0.312338,797.979389
争取(1947),争取,notion,0,5,5,0,11,11,0.049648,4,0.333171,0.375031,14733.056685
事件(1947),事件,notion,0,8,8,0,22,22,0.09518,4,0.423327,0.455117,45079.313308
事务所(1947),事务所,notion,0,1,1,0,3,3,0.014222,4,0.275404,0.296091,0
五华(1947),五华,notion,0,1,1,0,4,4,0.011229,4,0.270366,0.287632,0
五首(1947),五首,notion,0,1,1,0,5,5,0.014081,4,0.275493,0.296238,0
交通(1947),交通,notion,0,3,3,0,6,6,0.031189,4,0.303139,0.33774,5500.666246
产业革命(1947),产业革命,notion,0,1,1,0,3,3,0.009035,4,0.265075,0.278404,0
人权(1947),人权,notion,0,4,4,0,7,7,0.05415,4,0.345164,0.388006,11970.330203
人民团体(1947),人民团体,notion,0,3,3,0,10,10,0.042633,4,0.326885,0.367694,7515.333574
代表(1947),代表,notion,0,6,6,0,10,10,0.069883,4,0.374267,0.416288,24904.984857
伦敦(1947),伦敦,notion,0,4,4,0,7,7,0.056855,4,0.352835,0.395879,14054.832805
何处(1947),何处,notion,0,8,8,0,21,21,0.081446,4,0.388981,0.429044,36096.224091
侨报(1947),侨报,notion,0,1,1,0,3,3,0.017323,4,0.281723,0.306272,0
保障人权(1947),保障人权,notion,0,2,2,0,5,5,0.032055,4,0.30624,0.341853,2215.722594
倾覆(1947),倾覆,notion,0,1,1,0,3,3,0.009035,4,0.265075,0.278404,0
偶拾(1947),偶拾,notion,0,1,1,0,3,3,0.017323,4,0.281723,0.306272,0
先生(1947),先生,notion,0,12,12,0,88,88,0.120944,4,0.492746,0.496961,98658.501292
全国(1947),全国,notion,0,6,6,0,23,23,0.085297,4,0.412782,0.447451,34016.202026
共党(1947),共党,notion,0,4,4,0,7,7,0.054661,4,0.342807,0.385516,10704.742773
关键(1947),关键,notion,0,1,1,0,5,5,0.009035,4,0.265075,0.278404,0
军事(1947),军事,notion,0,8,8,0,18,18,0.090931,4,0.418244,0.451528,43894.600781
农场(1947),农场,notion,0,5,5,0,12,12,0.062857,4,0.362194,0.405095,20668.056886
农话(1947),农话,notion,0,1,1,0,3,3,0.009035,4,0.265075,0.278404,0
冯玉祥(1947),冯玉祥,notion,0,1,1,0,3,3,0.017323,4,0.281723,0.306272,0
决议(1947),决议,notion,0,5,5,0,7,7,0.04955,4,0.333953,0.375909,13155.358548
几种(1947),几种,notion,0,2,2,0,8,8,0.021502,4,0.288388,0.316586,2245.621531
列传(1947),列传,notion,0,1,1,0,3,3,0.017323,4,0.281723,0.306272,0
前途(1947),前途,notion,0,9,9,0,23,23,0.102332,4,0.451133,0.473378,59133.692043
加盟(1947),加盟,notion,0,1,1,0,5,5,0.00981,4,0.267191,0.28214,0
北平(1947),北平,notion,0,8,8,0,54,54,0.085902,4,0.407266,0.443472,43696.652125
北朝鲜(1947),北朝鲜,notion,0,2,2,0,5,5,0.027133,4,0.29671,0.328744,1770.9936
医生(1947),医生,notion,0,1,1,0,3,3,0.017323,4,0.281723,0.306272,0
南斯拉夫(1947),南斯拉夫,notion,0,2,2,0,4,4,0.023521,4,0.291018,0.320504,1911.402908
印度(1947),印度,notion,0,6,6,0,30,30,0.079203,4,0.389736,0.429544,26956.547236
参会(1947),参会,notion,0,2,2,0,4,4,0.028552,4,0.301506,0.335445,2588.539662
友人(1947),友人,notion,0,1,1,0,4,4,0.00981,4,0.267191,0.28214,0
发凡(1947),发凡,notion,0,1,1,0,3,3,0.009035,4,0.265075,0.278404,0
史大林(1947),史大林,notion,0,3,3,0,15,15,0.033067,4,0.303059,0.33763,3948.173354
史学(1947),史学,notion,0,2,2,0,4,4,0.017921,4,0.280658,0.304648,1255.9419
叶事(1947),叶事,notion,0,1,1,0,3,3,0.017323,4,0.281723,0.306272,0
号召(1947),号召,notion,0,3,3,0,6,6,0.023115,4,0.289267,0.317965,2904.446287
吁请(1947),吁请,notion,0,1,1,0,3,3,0.017323,4,0.281723,0.306272,0
合作(1947),合作,notion,0,8,8,0,22,22,0.089302,4,0.415192,0.449331,48909.200631
否认(1947),否认,notion,0,2,2,0,4,4,0.032055,4,0.30624,0.341853,2215.722594
周围(1947),周围,notion,0,1,1,0,4,4,0.00981,4,0.267191,0.28214,0
哲学(1947),哲学,notion,0,4,4,0,8,8,0.05207,4,0.336886,0.379107,10035.939165
商榷(1947),商榷,notion,0,4,4,0,9,9,0.049218,4,0.334018,0.375922,10883.827782
国外(1947),国外,notion,0,2,2,0,4,4,0.024542,4,0.292264,0.322335,1826.657886
国民党(1947),国民党,notion,0,9,9,0,24,24,0.089045,4,0.404851,0.441702,45522.799209
地主(1947),地主,notion,0,1,1,0,3,3,0.009035,4,0.265075,0.278404,0
培植(1947),培植,notion,0,1,1,0,3,3,0.009035,4,0.265075,0.278404,0
声明(1947),声明,notion,0,8,8,0,19,19,0.091165,4,0.417477,0.450979,44079.873175
复兴(1947),复兴,notion,0,5,5,0,15,15,0.057812,4,0.348334,0.391363,17238.234627
外高加索(1947),外高加索,notion,0,1,1,0,3,3,0.00981,4,0.267191,0.28214,0
天问(1947),天问,notion,0,1,1,0,3,3,0.014222,4,0.275404,0.296091,0
奋斗(1947),奋斗,notion,0,3,3,0,17,17,0.034555,4,0.310445,0.347444,6246.60752
学潮(1947),学潮,notion,0,6,6,0,23,23,0.074141,4,0.375213,0.417131,21756.254713
安全(1947),安全,notion,0,7,7,0,10,10,0.081177,4,0.397358,0.435758,36257.736426
客座(1947),客座,notion,0,1,1,0,3,3,0.014081,4,0.275493,0.296238,0
宣布(1947),宣布,notion,0,2,2,0,4,4,0.026359,4,0.294788,0.325997,1561.492709
家属(1947),家属,notion,0,1,1,0,3,3,0.017323,4,0.281723,0.306272,0
对外(1947),对外,notion,0,3,3,0,7,7,0.028639,4,0.296994,0.329208,3547.635303
小景(1947),小景,notion,0,2,2,0,5,5,0.018431,4,0.28119,0.30549,1040.874592
局势(1947),局势,notion,0,7,7,0,19,19,0.08177,4,0.394738,0.43367,32728.140353
巡礼(1947),巡礼,notion,0,3,3,0,5,5,0.032873,4,0.307536,0.343636,6118.645654
工业(1947),工业,notion,0,9,9,0,16,16,0.095659,4,0.429722,0.459572,57171.583019
广州(1947),广州,notion,0,6,6,0,29,29,0.061039,4,0.354815,0.397979,21193.218097
建设(1947),建设,notion,0,7,7,0,39,39,0.083122,4,0.402987,0.440152,40297.246458
开始(1947),开始,notion,0,7,7,0,14,14,0.075222,4,0.385249,0.42587,36147.793151
张君劢(1947),张君劢,notion,0,4,4,0,9,9,0.051558,4,0.338691,0.381085,11004.748529
归国(1947),归国,notion,0,1,1,0,3,3,0.00981,4,0.267191,0.28214,0
徐海(1947),徐海,notion,0,1,1,0,3,3,0.007422,4,0.26356,0.275695,0
急救(1947),急救,notion,0,1,1,0,3,3,0.014081,4,0.275493,0.296238,0
总动员(1947),总动员,notion,0,4,4,0,10,10,0.048844,4,0.335067,0.377093,9608.040099
悬棺(1947),悬棺,notion,0,1,1,0,3,3,0.014222,4,0.275404,0.296091,0
戏剧(1947),戏剧,notion,0,3,3,0,7,7,0.039532,4,0.319751,0.359162,6816.359733
成都(1947),成都,notion,0,3,3,0,9,9,0.042664,4,0.32508,0.365571,6696.006793
战后(1947),战后,notion,0,9,9,0,28,28,0.101581,4,0.442823,0.468178,61668.276214
投书(1947),投书,notion,0,2,2,0,4,4,0.031404,4,0.30602,0.34156,2430.025091
抗战(1947),抗战,notion,0,5,5,0,16,16,0.044,4,0.323386,0.363679,13725.742574
指趣(1947),指趣,notion,0,1,1,0,3,3,0.009035,4,0.265075,0.278404,0
提案(1947),提案,notion,0,1,1,0,4,4,0.017323,4,0.281723,0.306272,0
提示(1947),提示,notion,0,1,1,0,3,3,0.007422,4,0.26356,0.275695,0
提纲(1947),提纲,notion,0,2,2,0,5,5,0.028552,4,0.301506,0.335445,2588.539662
提要(1947),提要,notion,0,1,1,0,3,3,0.017323,4,0.281723,0.306272,0
援助(1947),援助,notion,0,6,6,0,19,19,0.066193,4,0.364165,0.407024,22587.707497
政府(1947),政府,notion,0,9,9,0,46,46,0.102669,4,0.439799,0.466237,53348.907001
文化(1947),文化,notion,0,9,9,0,29,29,0.091779,4,0.425014,0.45635,55469.454519
斗争(1947),斗争,notion,0,8,8,0,38,38,0.074165,4,0.372226,0.414579,31676.18781
新华社(1947),新华社,notion,0,1,1,0,8,8,0.013711,4,0.275027,0.295469,0
新疆(1947),新疆,notion,0,3,3,0,10,10,0.035103,4,0.311209,0.348433,5127.690094
新话(1947),新话,notion,0,1,1,0,7,7,0.017323,4,0.281723,0.306272,0
新闻自由(1947),新闻自由,notion,0,4,4,0,10,10,0.044027,4,0.322744,0.362848,7567.418427
方案(1947),方案,notion,0,6,6,0,12,12,0.053207,4,0.334772,0.376886,17530.876411
施行(1947),施行,notion,0,1,1,0,3,3,0.009035,4,0.265075,0.278404,0
旅法(1947),旅法,notion,0,1,1,0,3,3,0.017323,4,0.281723,0.306272,0
日本(1947),日本,notion,0,9,9,0,58,58,0.101361,4,0.434979,0.463088,53493.589158
时代(1947),时代,notion,0,10,10,0,33,33,0.104694,4,0.447349,0.471095,67960.570464
《主流》,《主流》,journal,164,0,164,276,0,276,0.11397,3,0.338994,0.34969,434878.670843
明哲(1947),明哲,notion,0,1,1,0,3,3,0.017323,4,0.281723,0.306272,0
春秋(1947),春秋,notion,0,2,2,0,10,10,0.031545,4,0.305336,0.340645,2219.908318
普及(1947),普及,notion,0,3,3,0,11,11,0.039532,4,0.319751,0.359162,6816.359733
暴行(1947),暴行,notion,0,8,8,0,15,15,0.088173,4,0.411836,0.446878,44371.755615
最新(1947),最新,notion,0,1,1,0,8,8,0.00981,4,0.267191,0.28214,0
杂文(1947),杂文,notion,0,1,1,0,6,6,0.014732,4,0.276453,0.297813,0
杜鲁门(1947),杜鲁门,notion,0,9,9,0,25,25,0.108891,4,0.458773,0.477992,60907.149178
杰作(1947),杰作,notion,0,1,1,0,8,8,0.00981,4,0.267191,0.28214,0
梅县(1947),梅县,notion,0,2,2,0,6,6,0.014818,4,0.274563,0.294761,698.886811
概况(1947),概况,notion,0,3,3,0,5,5,0.033067,4,0.303059,0.33763,3948.173354
欧洲(1947),欧洲,notion,0,10,10,0,26,26,0.10976,4,0.459762,0.478639,65362.879085
欲说还休(1947),欲说还休,notion,0,1,1,0,3,3,0.013711,4,0.275027,0.295469,0
正当(1947),正当,notion,0,3,3,0,5,5,0.034555,4,0.310445,0.347444,6246.60752
歧视(1947),歧视,notion,0,1,1,0,3,3,0.017323,4,0.281723,0.306272,0
民意测验(1947),民意测验,notion,0,1,1,0,3,3,0.017323,4,0.281723,0.306272,0
水利(1947),水利,notion,0,1,1,0,3,3,0.007422,4,0.26356,0.275695,0
江苏(1947),江苏,notion,0,1,1,0,3,3,0.007422,4,0.26356,0.275695,0
浙大(1947),浙大,notion,0,2,2,0,8,8,0.032055,4,0.30624,0.341853,2215.722594
海陆丰(1947),海陆丰,notion,0,2,2,0,5,5,0.02494,4,0.292941,0.323324,1747.290038
演词(1947),演词,notion,0,2,2,0,5,5,0.018845,4,0.280243,0.303989,1083.402703
特徵(1947),特徵,notion,0,1,1,0,3,3,0.014081,4,0.275493,0.296238,0
献给(1947),献给,notion,0,2,2,0,6,6,0.025451,4,0.295094,0.326437,2353.768712
环绕(1947),环绕,notion,0,2,2,0,5,5,0.018845,4,0.280243,0.303989,1083.402703
理事会(1947),理事会,notion,0,3,3,0,6,6,0.037601,4,0.316372,0.354988,6433.59957
生存(1947),生存,notion,0,3,3,0,5,5,0.03378,4,0.308426,0.344807,5760.487347
电流(1947),电流,notion,0,1,1,0,3,3,0.007422,4,0.26356,0.275695,0
病人(1947),病人,notion,0,1,1,0,3,3,0.017323,4,0.281723,0.306272,0
矛盾(1947),矛盾,notion,0,4,4,0,8,8,0.047381,4,0.331907,0.373541,9930.284138
《现代文摘(上海)》,《现代文摘(上海)》,journal,370,0,370,567,0,567,0.28138,3,0.346074,0.369806,849337.528479
石庄(1947),石庄,notion,0,1,1,0,3,3,0.017323,4,0.281723,0.306272,0
科学(1947),科学,notion,0,7,7,0,12,12,0.083581,4,0.396343,0.434952,32148.398231
第一届(1947),第一届,notion,0,1,1,0,11,11,0.014732,4,0.276453,0.297813,0
第三(1947),第三,notion,0,2,2,0,4,4,0.021644,4,0.28732,0.314975,1747.667055
第三篇(1947),第三篇,notion,0,1,1,0,3,3,0.00981,4,0.267191,0.28214,0
答覆(1947),答覆,notion,0,5,5,0,7,7,0.064471,4,0.360359,0.403337,17371.544246
精神(1947),精神,notion,0,9,9,0,24,24,0.092768,4,0.417375,0.450967,52508.811787
结构(1947),结构,notion,0,2,2,0,5,5,0.031404,4,0.30602,0.34156,2430.025091
罗素(1947),罗素,notion,0,1,1,0,3,3,0.009035,4,0.265075,0.278404,0
群众(1947),群众,notion,0,1,1,0,7,7,0.011229,4,0.270366,0.287632,0
考绩(1947),考绩,notion,0,1,1,0,6,6,0.007422,4,0.26356,0.275695,0
胜利(1947),胜利,notion,0,9,9,0,27,27,0.111564,4,0.475517,0.487586,72133.369527
英美(1947),英美,notion,0,7,7,0,23,23,0.070739,4,0.366472,0.409245,23232.50808
蒲立特(1947),蒲立特,notion,0,4,4,0,6,6,0.054801,4,0.345688,0.388555,11632.431431
街头(1947),街头,notion,0,2,2,0,5,5,0.028442,4,0.300022,0.333394,2187.730369
观后(1947),观后,notion,0,1,1,0,5,5,0.014732,4,0.276453,0.297813,0
言论(1947),言论,notion,0,3,3,0,5,5,0.033577,4,0.304872,0.340083,4362.246793
警告(1947),警告,notion,0,1,1,0,3,3,0.017323,4,0.281723,0.306272,0
计划经济(1947),计划经济,notion,0,1,1,0,4,4,0.009035,4,0.265075,0.278404,0
记言(1947),记言,notion,0,1,1,0,3,3,0.014081,4,0.275493,0.296238,0
论衡(1947),论衡,notion,0,1,1,0,3,3,0.014222,4,0.275404,0.296091,0
评论(1947),评论,notion,0,4,4,0,6,6,0.044543,4,0.326823,0.367682,9870.622687
诊断(1947),诊断,notion,0,3,3,0,5,5,0.042523,4,0.324801,0.365241,6618.635877
译诗(1947),译诗,notion,0,1,1,0,5,5,0.014081,4,0.275493,0.296238,0
诗词(1947),诗词,notion,0,5,5,0,10,10,0.065106,4,0.361351,0.404289,15765.104512
读史(1947),读史,notion,0,1,1,0,4,4,0.003588,4,0.255396,0.260534,0
谈苏侨(1947),谈苏侨,notion,0,1,1,0,3,3,0.00981,4,0.267191,0.28214,0
谣言(1947),谣言,notion,0,4,4,0,7,7,0.059846,4,0.358316,0.401299,13903.979248
财务(1947),财务,notion,0,1,1,0,4,4,0.007422,4,0.26356,0.275695,0
财政(1947),财政,notion,0,7,7,0,17,17,0.076234,4,0.377997,0.419645,26637.753157
过程(1947),过程,notion,0,3,3,0,15,15,0.032731,4,0.308565,0.34499,6759.60024
运动(1947),运动,notion,0,13,13,0,88,88,0.125692,4,0.499378,0.500391,106414.843419
运动史(1947),运动史,notion,0,1,1,0,3,3,0.003588,4,0.255396,0.260534,0
进程(1947),进程,notion,0,2,2,0,4,4,0.016314,4,0.277757,0.299998,853.020505
选举(1947),选举,notion,0,6,6,0,31,31,0.069041,4,0.372267,0.414494,27683.879839
选粹(1947),选粹,notion,0,1,1,0,3,3,0.014222,4,0.275404,0.296091,0
重要(1947),重要,notion,0,5,5,0,8,8,0.060006,4,0.357753,0.400811,20743.395558
随笔(1947),随笔,notion,0,3,3,0,10,10,0.025232,4,0.291889,0.321847,3549.408312
饥饿(1947),饥饿,notion,0,4,4,0,12,12,0.056995,4,0.352143,0.395183,13610.726952
马歇尔(1947),马歇尔,notion,0,12,12,0,48,48,0.117047,4,0.471836,0.485718,81721.95494
高尔基(1947),高尔基,notion,0,2,2,0,18,18,0.023521,4,0.291018,0.320504,1911.402908
going(1947),going,notion,0,1,1,0,2,2,0.013711,4,0.275027,0.295469,0
一九(1947),一九,notion,0,1,1,0,4,4,0.00981,4,0.267191,0.28214,0
一代(1947),一代,notion,0,3,3,0,4,4,0.021063,4,0.282773,0.308042,1794.605539
一只(1947),一只,notion,0,1,1,0,3,3,0.014732,4,0.276453,0.297813,0
一天(1947),一天,notion,0,2,2,0,3,3,0.028812,4,0.299917,0.333248,2025.61524
一套(1947),一套,notion,0,2,2,0,3,3,0.027791,4,0.29968,0.332918,2405.290268
一封(1947),一封,notion,0,3,3,0,5,5,0.031107,4,0.29968,0.332979,2873.893718
一张(1947),一张,notion,0,3,3,0,4,4,0.045114,4,0.331456,0.372968,7474.911045
一点(1947),一点,notion,0,3,3,0,8,8,0.040041,4,0.320772,0.360407,6754.232663
一票(1947),一票,notion,0,2,2,0,3,3,0.028442,4,0.300022,0.333394,2187.730369
一面(1947),一面,notion,0,3,3,0,4,4,0.041865,4,0.321892,0.361762,5813.37408
七年(1947),七年,notion,0,1,1,0,2,2,0.00981,4,0.267191,0.28214,0
三中全会(1947),三中全会,notion,0,4,4,0,6,6,0.05207,4,0.336886,0.379107,10035.939165
三十(1947),三十,notion,0,1,1,0,11,11,0.00981,4,0.267191,0.28214,0
三幅(1947),三幅,notion,0,2,2,0,4,4,0.028812,4,0.299917,0.333248,2025.61524
三报(1947),三报,notion,0,3,3,0,4,4,0.036152,4,0.310784,0.347883,3947.803671
三民主义(1947),三民主义,notion,0,4,4,0,5,5,0.049976,4,0.33609,0.378229,10141.517331
上书(1947),上书,notion,0,1,1,0,2,2,0.017323,4,0.281723,0.306272,0
上帝(1947),上帝,notion,0,3,3,0,5,5,0.042523,4,0.324801,0.365241,6618.635877
上期(1947),上期,notion,0,1,1,0,2,2,0.017323,4,0.281723,0.306272,0
上海(1947),上海,notion,0,8,8,0,56,56,0.085784,4,0.409661,0.445266,47358.966033
上篇(1947),上篇,notion,0,2,2,0,4,4,0.026359,4,0.294788,0.325997,1561.492709
下一代(1947),下一代,notion,0,3,3,0,16,16,0.030679,4,0.300048,0.333492,4431.324601
下次(1947),下次,notion,0,1,1,0,2,2,0.009035,4,0.265075,0.278404,0
不再(1947),不再,notion,0,1,1,0,2,2,0.013711,4,0.275027,0.295469,0
不列颠(1947),不列颠,notion,0,1,1,0,2,2,0.00981,4,0.267191,0.28214,0
不止(1947),不止,notion,0,1,1,0,2,2,0.013711,4,0.275027,0.295469,0
专科(1947),专科,notion,0,1,1,0,3,3,0.014081,4,0.275493,0.296238,0
东京(1947),东京,notion,0,2,2,0,4,4,0.024032,4,0.290894,0.320321,1695.498775
东南欧(1947),东南欧,notion,0,1,1,0,5,5,0.00981,4,0.267191,0.28214,0
东山再起(1947),东山再起,notion,0,1,1,0,2,2,0.014081,4,0.275493,0.296238,0
东欧(1947),东欧,notion,0,2,2,0,3,3,0.023257,4,0.28761,0.315414,1169.271875
两党(1947),两党,notion,0,3,3,0,5,5,0.038112,4,0.315379,0.353742,5778.22737
两种(1947),两种,notion,0,11,11,0,16,16,0.114565,4,0.474988,0.487415,83899.810582
中国人(1947),中国人,notion,0,5,5,0,8,8,0.05836,4,0.348476,0.391509,15394.381798
中学生(1947),中学生,notion,0,2,2,0,3,3,0.025451,4,0.295094,0.326437,2353.768712
中能(1947),中能,notion,0,1,1,0,2,2,0.009035,4,0.265075,0.278404,0
中间派(1947),中间派,notion,0,3,3,0,4,4,0.032511,4,0.304981,0.34023,4419.905974
中间路线(1947),中间路线,notion,0,2,2,0,4,4,0.01832,4,0.280681,0.304685,795.39908
为了(1947),为了,notion,0,2,2,0,4,4,0.025451,4,0.295094,0.326437,2353.768712
主席(1947),主席,notion,0,6,6,0,12,12,0.074141,4,0.375213,0.417131,21756.254713
主流(1947),主流,notion,0,3,3,0,6,6,0.010429,4,0.264254,0.277062,880.568442
之处(1947),之处,notion,0,1,1,0,2,2,0.009035,4,0.265075,0.278404,0
之梦(1947),之梦,notion,0,2,2,0,3,3,0.018829,4,0.280473,0.304355,655.354404
书市(1947),书市,notion,0,1,1,0,2,2,0.014732,4,0.276453,0.297813,0
书评(1947),书评,notion,0,3,3,0,15,15,0.02888,4,0.299181,0.332284,2260.73314
二三(1947),二三,notion,0,5,5,0,11,11,0.05664,4,0.348726,0.391766,18697.184766
二幅(1947),二幅,notion,0,4,4,0,5,5,0.052333,4,0.34212,0.384783,12473.603065
二题(1947),二题,notion,0,1,1,0,3,3,0.014732,4,0.276453,0.297813,0
于子(1947),于子,notion,0,4,4,0,8,8,0.056995,4,0.352143,0.395183,13610.726952
于案(1947),于案,notion,0,1,1,0,2,2,0.017323,4,0.281723,0.306272,0
云南(1947),云南,notion,0,2,2,0,3,3,0.032055,4,0.30624,0.341853,2215.722594
五四(1947),五四,notion,0,4,4,0,11,11,0.055171,4,0.344572,0.387383,11043.264417
亚洲(1947),亚洲,notion,0,2,2,0,3,3,0.031404,4,0.30602,0.34156,2430.025091
交友(1947),交友,notion,0,1,1,0,8,8,0.007422,4,0.26356,0.275695,0
产生(1947),产生,notion,0,4,4,0,6,6,0.038075,4,0.311835,0.349299,7200.81617
享受(1947),享受,notion,0,2,2,0,3,3,0.026359,4,0.294788,0.325997,1561.492709
人口(1947),人口,notion,0,2,2,0,7,7,0.028302,4,0.298866,0.331783,1965.8222
人文学科(1947),人文学科,notion,0,1,1,0,2,2,0.014081,4,0.275493,0.296238,0
今昔(1947),今昔,notion,0,3,3,0,5,5,0.028516,4,0.294381,0.325472,2570.363567
介绍(1947),介绍,notion,0,5,5,0,16,16,0.058375,4,0.3543,0.397405,16072.741579
令人(1947),令人,notion,0,1,1,0,3,3,0.014081,4,0.275493,0.296238,0
以上(1947),以上,notion,0,1,1,0,3,3,0.014081,4,0.275493,0.296238,0
以外(1947),以外,notion,0,1,1,0,2,2,0.009035,4,0.265075,0.278404,0
仲夏夜(1947),仲夏夜,notion,0,2,2,0,3,3,0.018829,4,0.280473,0.304355,655.354404
伟大(1947),伟大,notion,0,4,4,0,21,21,0.043957,4,0.324616,0.365082,8731.620493
使命(1947),使命,notion,0,6,6,0,10,10,0.061495,4,0.355147,0.398308,21844.202741
使美(1947),使美,notion,0,1,1,0,2,2,0.017323,4,0.281723,0.306272,0
侨汇(1947),侨汇,notion,0,1,1,0,2,2,0.011229,4,0.270366,0.287632,0
侵略战争(1947),侵略战争,notion,0,1,1,0,2,2,0.014222,4,0.275404,0.296091,0
俘虏(1947),俘虏,notion,0,2,2,0,4,4,0.027791,4,0.29968,0.332918,2405.290268
保送入学(1947),保送入学,notion,0,1,1,0,2,2,0.017323,4,0.281723,0.306272,0
健全(1947),健全,notion,0,1,1,0,17,17,0.007422,4,0.26356,0.275695,0
傻子(1947),傻子,notion,0,1,1,0,2,2,0.007422,4,0.26356,0.275695,0
儿童(1947),儿童,notion,0,4,4,0,23,23,0.046185,4,0.329727,0.371051,11659.744108
儿童节(1947),儿童节,notion,0,2,2,0,17,17,0.021644,4,0.28732,0.314975,1747.667055
光荣(1947),光荣,notion,0,3,3,0,8,8,0.035771,4,0.311949,0.349385,5932.702117
克赛(1947),克赛,notion,0,1,1,0,3,3,0.00981,4,0.267191,0.28214,0
党派(1947),党派,notion,0,2,2,0,6,6,0.013784,4,0.270451,0.28784,449.976833
八百年(1947),八百年,notion,0,1,1,0,4,4,0.00981,4,0.267191,0.28214,0
公开信(1947),公开信,notion,0,4,4,0,8,8,0.040917,4,0.31471,0.352961,6503.664524
公民(1947),公民,notion,0,1,1,0,2,2,0.017323,4,0.281723,0.306272,0
共产党(1947),共产党,notion,0,7,7,0,15,15,0.089411,4,0.416763,0.450405,41019.486518
共和(1947),共和,notion,0,2,2,0,3,3,0.017299,4,0.278915,0.301865,688.562525
关系(1947),关系,notion,0,4,4,0,11,11,0.049287,4,0.336953,0.379181,12823.082372
内部(1947),内部,notion,0,4,4,0,8,8,0.050456,4,0.338322,0.380682,12583.641464
内阁制(1947),内阁制,notion,0,1,1,0,3,3,0.009035,4,0.265075,0.278404,0
再度(1947),再度,notion,0,1,1,0,3,3,0.017323,4,0.281723,0.306272,0
再生(1947),再生,notion,0,2,2,0,4,4,0.023116,4,0.288412,0.316623,1358.22258
农业(1947),农业,notion,0,6,6,0,21,21,0.077589,4,0.392334,0.431668,31334.968043
农民(1947),农民,notion,0,7,7,0,27,27,0.082752,4,0.402749,0.439969,40576.036308
几个(1947),几个,notion,0,6,6,0,16,16,0.070474,4,0.379383,0.420792,31386.61114
出版(1947),出版,notion,0,7,7,0,13,13,0.077455,4,0.385859,0.426383,30605.355625
分裂(1947),分裂,notion,0,5,5,0,10,10,0.062129,4,0.357828,0.400884,18216.970911
创造者(1947),创造者,notion,0,3,3,0,7,7,0.024389,4,0.29169,0.321554,2862.186157
利益(1947),利益,notion,0,3,3,0,4,4,0.045626,4,0.330014,0.37132,6615.755609
制宪(1947),制宪,notion,0,1,1,0,2,2,0.009035,4,0.265075,0.278404,0
副业(1947),副业,notion,0,1,1,0,2,2,0.007422,4,0.26356,0.275695,0
力量(1947),力量,notion,0,8,8,0,17,17,0.083607,4,0.40147,0.439041,45824.295991
办法(1947),办法,notion,0,9,9,0,20,20,0.101166,4,0.445365,0.469789,62211.096262
办理(1947),办理,notion,0,2,2,0,3,3,0.021644,4,0.28732,0.314975,1747.667055
动向(1947),动向,notion,0,6,6,0,9,9,0.071478,4,0.37892,0.42039,28238.57878
动员(1947),动员,notion,0,4,4,0,6,6,0.054263,4,0.346671,0.389581,13138.644642
努力(1947),努力,notion,0,8,8,0,12,12,0.083733,4,0.400716,0.438455,42828.714807
势力(1947),势力,notion,0,4,4,0,6,6,0.052073,4,0.342085,0.384747,12532.017523
北大(1947),北大,notion,0,5,5,0,7,7,0.068881,4,0.373284,0.415348,19851.584609
医药(1947),医药,notion,0,1,1,0,2,2,0.007422,4,0.26356,0.275695,0
十六(1947),十六,notion,0,4,4,0,5,5,0.040667,4,0.317491,0.35644,8378.88556
南京(1947),南京,notion,0,7,7,0,22,22,0.086692,4,0.406587,0.442898,34235.041902
危机(1947),危机,notion,0,7,7,0,17,17,0.0811,4,0.391255,0.430851,32030.598577
原子能(1947),原子能,notion,0,1,1,0,3,3,0.00981,4,0.267191,0.28214,0
厦门(1947),厦门,notion,0,1,1,0,2,2,0.017323,4,0.281723,0.306272,0
参加(1947),参加,notion,0,3,3,0,4,4,0.040439,4,0.318885,0.3581,5349.74038
双十节(1947),双十节,notion,0,2,2,0,3,3,0.032055,4,0.30624,0.341853,2215.722594
反攻(1947),反攻,notion,0,4,4,0,14,14,0.04275,4,0.322774,0.362885,8750.502266
反民主(1947),反民主,notion,0,2,2,0,3,3,0.024542,4,0.292264,0.322335,1826.657886
发表谈话(1947),发表谈话,notion,0,1,1,0,2,2,0.017323,4,0.281723,0.306272,0
口号(1947),口号,notion,0,2,2,0,3,3,0.027791,4,0.29968,0.332918,2405.290268
可以(1947),可以,notion,0,7,7,0,8,8,0.072966,4,0.381162,0.422391,32752.062161
司徒(1947),司徒,notion,0,2,2,0,3,3,0.028552,4,0.301506,0.335445,2588.539662
各界(1947),各界,notion,0,2,2,0,3,3,0.028552,4,0.301506,0.335445,2588.539662
同学(1947),同学,notion,0,7,7,0,13,13,0.092719,4,0.432335,0.461208,47820.112447
吴勤(1947),吴勤,notion,0,1,1,0,2,2,0.011229,4,0.270366,0.287632,0
周末(1947),周末,notion,0,2,2,0,3,3,0.01741,4,0.280151,0.303843,1198.480437
和约(1947),和约,notion,0,8,8,0,26,26,0.097662,4,0.428374,0.458596,45105.634408
售华(1947),售华,notion,0,1,1,0,2,2,0.017323,4,0.281723,0.306272,0
嘉定县(1947),嘉定县,notion,0,1,1,0,2,2,0.007422,4,0.26356,0.275695,0
四场(1947),四场,notion,0,1,1,0,2,2,0.011229,4,0.270366,0.287632,0
四大家族(1947),四大家族,notion,0,1,1,0,2,2,0.011229,4,0.270366,0.287632,0
回忆录(1947),回忆录,notion,0,1,1,0,2,2,0.017323,4,0.281723,0.306272,0
国共(1947),国共,notion,0,4,4,0,8,8,0.030403,4,0.297823,0.33044,5200.805323
国军(1947),国军,notion,0,3,3,0,4,4,0.040439,4,0.318885,0.3581,5349.74038
国大代表(1947),国大代表,notion,0,1,1,0,2,2,0.014222,4,0.275404,0.296091,0
国家(1947),国家,notion,0,7,7,0,29,29,0.086819,4,0.409612,0.445169,39597.790819
国际形势(1947),国际形势,notion,0,7,7,0,14,14,0.077487,4,0.383992,0.424808,31594.467435
地方(1947),地方,notion,0,3,3,0,8,8,0.038825,4,0.319841,0.359272,7360.255589
坚持(1947),坚持,notion,0,3,3,0,6,6,0.038455,4,0.320381,0.359931,7898.913264
域外(1947),域外,notion,0,1,1,0,3,3,0.014732,4,0.276453,0.297813,0
塑像(1947),塑像,notion,0,1,1,0,2,2,0.014222,4,0.275404,0.296091,0
塞外(1947),塞外,notion,0,2,2,0,3,3,0.028954,4,0.300154,0.333577,2064.821066
壁报(1947),壁报,notion,0,1,1,0,2,2,0.007422,4,0.26356,0.275695,0
处理(1947),处理,notion,0,5,5,0,7,7,0.049508,4,0.328996,0.37027,12622.235894
复活(1947),复活,notion,0,4,4,0,7,7,0.044027,4,0.322744,0.362848,7567.418427
外交(1947),外交,notion,0,7,7,0,21,21,0.083951,4,0.394465,0.433451,31025.088576
外长(1947),外长,notion,0,6,6,0,11,11,0.07533,4,0.385119,0.425699,28246.451164
多党(1947),多党,notion,0,1,1,0,2,2,0.009035,4,0.265075,0.278404,0
大事(1947),大事,notion,0,1,1,0,2,2,0.017323,4,0.281723,0.306272,0
大会(1947),大会,notion,0,5,5,0,14,14,0.066295,4,0.370248,0.412602,21244.648686
大厅(1947),大厅,notion,0,1,1,0,2,2,0.014222,4,0.275404,0.296091,0
大家(1947),大家,notion,0,2,2,0,4,4,0.021132,4,0.288412,0.316623,2574.708611
大局(1947),大局,notion,0,6,6,0,11,11,0.078817,4,0.391838,0.431266,26358.543568
大战(1947),大战,notion,0,3,3,0,5,5,0.032141,4,0.305063,0.34034,4085.405862
大纲(1947),大纲,notion,0,2,2,0,6,6,0.021132,4,0.288412,0.316623,2574.708611
大连(1947),大连,notion,0,2,2,0,5,5,0.031545,4,0.305336,0.340645,2219.908318
大选(1947),大选,notion,0,5,5,0,17,17,0.06578,4,0.364944,0.407695,18648.119027
天下(1947),天下,notion,0,3,3,0,5,5,0.041214,4,0.322074,0.361982,6317.925086
天府(1947),天府,notion,0,1,1,0,2,2,0.014732,4,0.276453,0.297813,0
天风(1947),天风,notion,0,1,1,0,2,2,0.014222,4,0.275404,0.296091,0
夫人(1947),夫人,notion,0,4,4,0,7,7,0.053699,4,0.345548,0.388409,13466.822371
奋鬥(1947),奋鬥,notion,0,2,2,0,6,6,0.027932,4,0.299811,0.333101,2443.455357
奴役(1947),奴役,notion,0,1,1,0,2,2,0.014222,4,0.275404,0.296091,0
奴才(1947),奴才,notion,0,3,3,0,6,6,0.037478,4,0.313669,0.351582,5215.620442
妄想(1947),妄想,notion,0,1,1,0,2,2,0.013711,4,0.275027,0.295469,0
妇女(1947),妇女,notion,0,5,5,0,11,11,0.069146,4,0.375915,0.417692,21598.898598
始业(1947),始业,notion,0,1,1,0,10,10,0.014222,4,0.275404,0.296091,0
委员会(1947),委员会,notion,0,7,7,0,12,12,0.089411,4,0.416763,0.450405,41019.486518
姚牧(1947),姚牧,notion,0,1,1,0,2,2,0.014732,4,0.276453,0.297813,0
孙中山(1947),孙中山,notion,0,2,2,0,5,5,0.023521,4,0.291018,0.320504,1911.402908
季米特洛夫(1947),季米特洛夫,notion,0,1,1,0,2,2,0.013711,4,0.275027,0.295469,0
学业(1947),学业,notion,0,1,1,0,2,2,0.017323,4,0.281723,0.306272,0
学习(1947),学习,notion,0,9,9,0,18,18,0.090039,4,0.413733,0.44833,53870.564044
安徽(1947),安徽,notion,0,2,2,0,5,5,0.028812,4,0.299917,0.333248,2025.61524
宋子文(1947),宋子文,notion,0,8,8,0,15,15,0.088448,4,0.406878,0.443179,39656.109756
官吏(1947),官吏,notion,0,3,3,0,5,5,0.043034,4,0.324061,0.364362,6056.258506
实践(1947),实践,notion,0,2,2,0,3,3,0.022153,4,0.289808,0.31871,2534.094371
对华(1947),对华,notion,0,4,4,0,7,7,0.044279,4,0.322988,0.363141,8286.895785
对华政策(1947),对华政策,notion,0,6,6,0,10,10,0.063109,4,0.353017,0.396184,18472.407604
对德(1947),对德,notion,0,1,1,0,4,4,0.00981,4,0.267191,0.28214,0
对於(1947),对於,notion,0,3,3,0,17,17,0.042013,4,0.324215,0.364545,6814.567825
封锁(1947),封锁,notion,0,2,2,0,4,4,0.017669,4,0.279944,0.303513,871.280033
尖锐(1947),尖锐,notion,0,1,1,0,2,2,0.014222,4,0.275404,0.296091,0
展望(1947),展望,notion,0,8,8,0,16,16,0.076821,4,0.383345,0.42432,34532.718361
展览会(1947),展览会,notion,0,3,3,0,8,8,0.043034,4,0.324061,0.364362,6056.258506
屯溪(1947),屯溪,notion,0,1,1,0,2,2,0.007422,4,0.26356,0.275695,0
山鬼(1947),山鬼,notion,0,1,1,0,2,2,0.014222,4,0.275404,0.296091,0
崇明(1947),崇明,notion,0,1,1,0,3,3,0.007422,4,0.26356,0.275695,0
崩溃(1947),崩溃,notion,0,6,6,0,11,11,0.057155,4,0.343359,0.386224,18286.193096
巡回(1947),巡回,notion,0,1,1,0,2,2,0.017323,4,0.281723,0.306272,0
工人(1947),工人,notion,0,6,6,0,29,29,0.073716,4,0.386777,0.427091,32059.848159
工作者(1947),工作者,notion,0,1,1,0,2,2,0.00981,4,0.267191,0.28214,0
工协(1947),工协,notion,0,1,1,0,2,2,0.017323,4,0.281723,0.306272,0
工友(1947),工友,notion,0,1,1,0,2,2,0.007422,4,0.26356,0.275695,0
工商界(1947),工商界,notion,0,1,1,0,5,5,0.017323,4,0.281723,0.306272,0
工场(1947),工场,notion,0,1,1,0,2,2,0.011229,4,0.270366,0.287632,0
工联(1947),工联,notion,0,2,2,0,3,3,0.031034,4,0.30613,0.341707,2639.595687
巨头(1947),巨头,notion,0,2,2,0,3,3,0.031545,4,0.305336,0.340645,2219.908318
巴黎(1947),巴黎,notion,0,8,8,0,17,17,0.098695,4,0.439346,0.465883,50538.872502
币制(1947),币制,notion,0,7,7,0,13,13,0.074117,4,0.37398,0.416093,25995.553085
希望(1947),希望,notion,0,7,7,0,18,18,0.0913,4,0.425862,0.456814,45497.151242
希腊(1947),希腊,notion,0,4,4,0,18,18,0.05039,4,0.333692,0.375555,9500.567981
平津(1947),平津,notion,0,2,2,0,6,6,0.032055,4,0.30624,0.341853,2215.722594
广西(1947),广西,notion,0,2,2,0,10,10,0.02494,4,0.292941,0.323324,1747.290038
序幕(1947),序幕,notion,0,2,2,0,3,3,0.021502,4,0.288388,0.316586,2245.621531
库克(1947),库克,notion,0,2,2,0,4,4,0.024542,4,0.292264,0.322335,1826.657886
库券(1947),库券,notion,0,1,1,0,2,2,0.009035,4,0.265075,0.278404,0
建築(1947),建築,notion,0,1,1,0,3,3,0.014222,4,0.275404,0.296091,0
张澜(1947),张澜,notion,0,2,2,0,4,4,0.026359,4,0.294788,0.325997,1561.492709
归感录(1947),归感录,notion,0,1,1,0,2,2,0.009035,4,0.265075,0.278404,0
当前(1947),当前,notion,0,7,7,0,36,36,0.086238,4,0.410055,0.445498,39003.946954
录之七(1947),录之七,notion,0,1,1,0,2,2,0.007422,4,0.26356,0.275695,0
彭泽民(1947),彭泽民,notion,0,2,2,0,3,3,0.020912,4,0.285589,0.312338,797.979389
彭湃(1947),彭湃,notion,0,2,2,0,3,3,0.02494,4,0.292941,0.323324,1747.290038
待续(1947),待续,notion,0,3,3,0,8,8,0.033067,4,0.303059,0.33763,3948.173354
徵用(1947),徵用,notion,0,1,1,0,2,2,0.014081,4,0.275493,0.296238,0
心理(1947),心理,notion,0,6,6,0,15,15,0.06424,4,0.356557,0.3997,21367.153305
必须(1947),必须,notion,0,7,7,0,9,9,0.077549,4,0.389469,0.429386,36092.392336
快速(1947),快速,notion,0,1,1,0,2,2,0.011229,4,0.270366,0.287632,0
怒潮(1947),怒潮,notion,0,2,2,0,3,3,0.028552,4,0.301506,0.335445,2588.539662
思想(1947),思想,notion,0,7,7,0,20,20,0.090046,4,0.418244,0.451467,38673.931387
性质(1947),性质,notion,0,4,4,0,7,7,0.054661,4,0.342807,0.385516,10704.742773
总理(1947),总理,notion,0,2,2,0,6,6,0.031545,4,0.305336,0.340645,2219.908318
悲剧(1947),悲剧,notion,0,7,7,0,13,13,0.075892,4,0.386558,0.426969,28097.347582
悼念(1947),悼念,notion,0,1,1,0,11,11,0.003588,4,0.255396,0.260534,0
情调(1947),情调,notion,0,1,1,0,2,2,0.014222,4,0.275404,0.296091,0
惨案(1947),惨案,notion,0,7,7,0,11,11,0.070075,4,0.370007,0.412504,28475.712819
意义(1947),意义,notion,0,4,4,0,10,10,0.047799,4,0.328426,0.36955,9291.83851
我国(1947),我国,notion,0,6,6,0,25,25,0.059318,4,0.346636,0.389666,20084.423225
战场(1947),战场,notion,0,5,5,0,10,10,0.055772,4,0.347483,0.390484,17198.987333
战斗(1947),战斗,notion,0,3,3,0,6,6,0.028461,4,0.299496,0.332723,5682.41047
户口普查(1947),户口普查,notion,0,1,1,0,4,4,0.014222,4,0.275404,0.296091,0
打仗(1947),打仗,notion,0,1,1,0,2,2,0.003699,4,0.256009,0.261706,0
扩张主义(1947),扩张主义,notion,0,1,1,0,4,4,0.00981,4,0.267191,0.28214,0
承认(1947),承认,notion,0,1,1,0,2,2,0.017323,4,0.281723,0.306272,0
把握(1947),把握,notion,0,1,1,0,2,2,0.007422,4,0.26356,0.275695,0
投豆(1947),投豆,notion,0,1,1,0,2,2,0.011229,4,0.270366,0.287632,0
报告(1947),报告,notion,0,9,9,0,16,16,0.111564,4,0.475517,0.487586,72133.369527
报纸(1947),报纸,notion,0,4,4,0,7,7,0.038261,4,0.312149,0.349702,6866.585262
抨击(1947),抨击,notion,0,2,2,0,3,3,0.031404,4,0.30602,0.34156,2430.025091
拒绝(1947),拒绝,notion,0,5,5,0,6,6,0.065106,4,0.361351,0.404289,15765.104512
拾遗(1947),拾遗,notion,0,2,2,0,3,3,0.032055,4,0.30624,0.341853,2215.722594
指导(1947),指导,notion,0,3,3,0,7,7,0.035724,4,0.311778,0.349165,5959.110786
推广(1947),推广,notion,0,1,1,0,6,6,0.007422,4,0.26356,0.275695,0
提出(1947),提出,notion,0,4,4,0,6,6,0.045009,4,0.329123,0.370355,11978.168218
援华(1947),援华,notion,0,5,5,0,9,9,0.054472,4,0.339365,0.381878,11599.125472
援欧(1947),援欧,notion,0,4,4,0,8,8,0.055312,4,0.343947,0.386724,10683.402766
摧残(1947),摧残,notion,0,2,2,0,6,6,0.017299,4,0.278915,0.301865,688.562525
支持(1947),支持,notion,0,5,5,0,12,12,0.071075,4,0.381461,0.422526,22968.426372
支部(1947),支部,notion,0,1,1,0,2,2,0.017323,4,0.281723,0.306272,0
改组(1947),改组,notion,0,5,5,0,16,16,0.06578,4,0.364944,0.407695,18648.119027
改革(1947),改革,notion,0,11,11,0,31,31,0.110764,4,0.45785,0.477565,75527.382352
政制(1947),政制,notion,0,3,3,0,5,5,0.040439,4,0.318885,0.3581,5349.74038
政协(1947),政协,notion,0,3,3,0,4,4,0.016323,4,0.274298,0.294383,1617.886569
政团(1947),政团,notion,0,1,1,0,2,2,0.017323,4,0.281723,0.306272,0
政局(1947),政局,notion,0,8,8,0,16,16,0.096612,4,0.429506,0.459365,48054.620942
政治局(1947),政治局,notion,0,2,2,0,3,3,0.023257,4,0.28761,0.315414,1169.271875
敎育(1947),敎育,notion,0,3,3,0,12,12,0.042013,4,0.324215,0.364545,6814.567825
救国(1947),救国,notion,0,3,3,0,4,4,0.027479,4,0.296169,0.328036,3644.555051
教师(1947),教师,notion,0,1,1,0,3,3,0.017323,4,0.281723,0.306272,0
散记(1947),散记,notion,0,2,2,0,3,3,0.018431,4,0.28119,0.30549,1040.874592
断片(1947),断片,notion,0,2,2,0,3,3,0.021039,4,0.286524,0.313766,1874.195629
斯宾塞(1947),斯宾塞,notion,0,1,1,0,2,2,0.014081,4,0.275493,0.296238,0
新世界(1947),新世界,notion,0,2,2,0,7,7,0.024032,4,0.290894,0.320321,1695.498775
新任(1947),新任,notion,0,1,1,0,3,3,0.017323,4,0.281723,0.306272,0
方法(1947),方法,notion,0,6,6,0,13,13,0.069699,4,0.374554,0.416545,29227.117797
旅美(1947),旅美,notion,0,1,1,0,2,2,0.017323,4,0.281723,0.306272,0
旧诗(1947),旧诗,notion,0,1,1,0,6,6,0.017323,4,0.281723,0.306272,0
普希金(1947),普希金,notion,0,1,1,0,7,7,0.00981,4,0.267191,0.28214,0
暑期(1947),暑期,notion,0,2,2,0,5,5,0.018651,4,0.283055,0.30842,2017.209887
暹罗(1947),暹罗,notion,0,4,4,0,9,9,0.056995,4,0.352143,0.395183,13610.726952
曼谷(1947),曼谷,notion,0,3,3,0,6,6,0.042263,4,0.32539,0.365937,6975.425387
最大(1947),最大,notion,0,4,4,0,5,5,0.049993,4,0.337219,0.379474,12046.790671
最近(1947),最近,notion,0,7,7,0,14,14,0.079523,4,0.392605,0.431949,33477.363691
朝鲜(1947),朝鲜,notion,0,6,6,0,21,21,0.079203,4,0.389736,0.429544,26956.547236
未来(1947),未来,notion,0,3,3,0,4,4,0.033637,4,0.307703,0.343855,4199.414102
本党(1947),本党,notion,0,1,1,0,2,2,0.009035,4,0.265075,0.278404,0
本市(1947),本市,notion,0,1,1,0,2,2,0.017323,4,0.281723,0.306272,0
杂志(1947),杂志,notion,0,3,3,0,5,5,0.030721,4,0.30063,0.334298,3225.341612
李闻(1947),李闻,notion,0,3,3,0,4,4,0.034992,4,0.309853,0.346675,4099.284513
杜史(1947),杜史,notion,0,1,1,0,2,2,0.017323,4,0.281723,0.306272,0
杠杆(1947),杠杆,notion,0,1,1,0,2,2,0.014732,4,0.276453,0.297813,0
杭州(1947),杭州,notion,0,4,4,0,12,12,0.054801,4,0.345688,0.388555,11632.431431
标准(1947),标准,notion,0,1,1,0,2,2,0.007422,4,0.26356,0.275695,0
梵谛冈(1947),梵谛冈,notion,0,1,1,0,2,2,0.00981,4,0.267191,0.28214,0
检讨(1947),检讨,notion,0,7,7,0,24,24,0.077691,4,0.389202,0.429166,35092.391851
森林(1947),森林,notion,0,1,1,0,2,2,0.011229,4,0.270366,0.287632,0
榴花(1947),榴花,notion,0,1,1,0,2,2,0.011229,4,0.270366,0.287632,0
欧洲各国(1947),欧洲各国,notion,0,1,1,0,2,2,0.00981,4,0.267191,0.28214,0
歼灭(1947),歼灭,notion,0,1,1,0,2,2,0.011229,4,0.270366,0.287632,0
殉难(1947),殉难,notion,0,2,2,0,3,3,0.028552,4,0.301506,0.335445,2588.539662
每期(1947),每期,notion,0,1,1,0,3,3,0.014081,4,0.275493,0.296238,0
民主人士(1947),民主人士,notion,0,1,1,0,3,3,0.017323,4,0.281723,0.306272,0
民国(1947),民国,notion,0,2,2,0,3,3,0.021022,4,0.286837,0.314242,1344.24886
民国初年(1947),民国初年,notion,0,1,1,0,2,2,0.003588,4,0.255396,0.260534,0
气象台(1947),气象台,notion,0,1,1,0,2,2,0.017323,4,0.281723,0.306272,0
永久中立(1947),永久中立,notion,0,1,1,0,2,2,0.014081,4,0.275493,0.296238,0
沈案(1947),沈案,notion,0,1,1,0,2,2,0.017323,4,0.281723,0.306272,0
沿革(1947),沿革,notion,0,1,1,0,2,2,0.009035,4,0.265075,0.278404,0
法国(1947),法国,notion,0,10,10,0,32,32,0.112479,4,0.463382,0.480763,67059.708024
法币(1947),法币,notion,0,5,5,0,6,6,0.059919,4,0.348975,0.392022,13679.22036
法庭(1947),法庭,notion,0,2,2,0,3,3,0.024032,4,0.290894,0.320321,1695.498775
法意(1947),法意,notion,0,3,3,0,4,4,0.042263,4,0.32539,0.365937,6975.425387
法治(1947),法治,notion,0,3,3,0,6,6,0.043034,4,0.324061,0.364362,6056.258506
泗礁(1947),泗礁,notion,0,1,1,0,2,2,0.007422,4,0.26356,0.275695,0
注目(1947),注目,notion,0,1,1,0,3,3,0.017323,4,0.281723,0.306272,0
浙江(1947),浙江,notion,0,3,3,0,6,6,0.042523,4,0.324801,0.365241,6618.635877
浦东(1947),浦东,notion,0,1,1,0,7,7,0.007422,4,0.26356,0.275695,0
海军(1947),海军,notion,0,1,1,0,3,3,0.00981,4,0.267191,0.28214,0
海南(1947),海南,notion,0,2,2,0,7,7,0.025451,4,0.295094,0.326437,2353.768712
海涛(1947),海涛,notion,0,1,1,0,2,2,0.014222,4,0.275404,0.296091,0
海蛰(1947),海蛰,notion,0,1,1,0,2,2,0.007422,4,0.26356,0.275695,0
淳安(1947),淳安,notion,0,1,1,0,3,3,0.007422,4,0.26356,0.275695,0
清剿(1947),清剿,notion,0,2,2,0,4,4,0.02531,4,0.2954,0.326876,2496.768821
渔船(1947),渔船,notion,0,1,1,0,2,2,0.007422,4,0.26356,0.275695,0
游苏(1947),游苏,notion,0,1,1,0,2,2,0.003699,4,0.256009,0.261706,0
準备(1947),準备,notion,0,2,2,0,3,3,0.027932,4,0.299811,0.333101,2443.455357
演变(1947),演变,notion,0,5,5,0,6,6,0.061713,4,0.359903,0.402898,20130.798118
演辞(1947),演辞,notion,0,3,3,0,5,5,0.030721,4,0.30063,0.334298,3225.341612
演进(1947),演进,notion,0,2,2,0,4,4,0.023257,4,0.28761,0.315414,1169.271875
澳门(1947),澳门,notion,0,2,2,0,3,3,0.031545,4,0.305336,0.340645,2219.908318
激战(1947),激战,notion,0,1,1,0,2,2,0.017323,4,0.281723,0.306272,0
火红(1947),火红,notion,0,1,1,0,2,2,0.011229,4,0.270366,0.287632,0
炉边(1947),炉边,notion,0,1,1,0,2,2,0.014081,4,0.275493,0.296238,0
烽火(1947),烽火,notion,0,2,2,0,4,4,0.028954,4,0.300154,0.333577,2064.821066
燕大(1947),燕大,notion,0,2,2,0,3,3,0.020912,4,0.285589,0.312338,797.979389
爲了(1947),爲了,notion,0,2,2,0,4,4,0.027932,4,0.299811,0.333101,2443.455357
物价(1947),物价,notion,0,7,7,0,16,16,0.087852,4,0.407315,0.443448,33925.397637
物资(1947),物资,notion,0,3,3,0,5,5,0.036804,4,0.310983,0.34814,3746.347299
特点(1947),特点,notion,0,3,3,0,4,4,0.036169,4,0.309685,0.346455,4415.889012
犯罪(1947),犯罪,notion,0,1,1,0,2,2,0.014081,4,0.275493,0.296238,0
独树港(1947),独树港,notion,0,1,1,0,3,3,0.007422,4,0.26356,0.275695,0
独立运动(1947),独立运动,notion,0,4,4,0,5,5,0.055066,4,0.347837,0.390789,12680.854645
王任(1947),王任,notion,0,1,1,0,4,4,0.017323,4,0.281723,0.306272,0
现代(1947),现代,notion,0,5,5,0,12,12,0.056818,4,0.341196,0.383856,12466.681826
现行(1947),现行,notion,0,3,3,0,4,4,0.037338,4,0.310954,0.348103,4493.316655
理解(1947),理解,notion,0,1,1,0,2,2,0.007422,4,0.26356,0.275695,0
琼崖(1947),琼崖,notion,0,3,3,0,8,8,0.042263,4,0.32539,0.365937,6975.425387
甚么(1947),甚么,notion,0,2,2,0,3,3,0.032055,4,0.30624,0.341853,2215.722594
留英(1947),留英,notion,0,1,1,0,2,2,0.017323,4,0.281723,0.306272,0
皖中(1947),皖中,notion,0,1,1,0,2,2,0.014081,4,0.275493,0.296238,0
皖北(1947),皖北,notion,0,1,1,0,2,2,0.017323,4,0.281723,0.306272,0
益阳(1947),益阳,notion,0,1,1,0,2,2,0.014732,4,0.276453,0.297813,0
目前(1947),目前,notion,0,10,10,0,15,15,0.11143,4,0.464706,0.481532,70286.172777
看法(1947),看法,notion,0,7,7,0,16,16,0.074117,4,0.37398,0.416093,25995.553085
石家庄(1947),石家庄,notion,0,2,2,0,3,3,0.025961,4,0.295759,0.327389,2231.848602
矿工(1947),矿工,notion,0,1,1,0,2,2,0.013711,4,0.275027,0.295469,0
礼制(1947),礼制,notion,0,1,1,0,2,2,0.014222,4,0.275404,0.296091,0
祖国(1947),祖国,notion,0,6,6,0,9,9,0.072942,4,0.383259,0.424125,30449.537739
福利(1947),福利,notion,0,1,1,0,4,4,0.014222,4,0.275404,0.296091,0
秋季(1947),秋季,notion,0,3,3,0,12,12,0.037742,4,0.315787,0.354255,6050.35704
科学界(1947),科学界,notion,0,1,1,0,2,2,0.00981,4,0.267191,0.28214,0
租话(1947),租话,notion,0,1,1,0,2,2,0.009035,4,0.265075,0.278404,0
笔谈(1947),笔谈,notion,0,2,2,0,35,35,0.018651,4,0.283055,0.30842,2017.209887
第一(1947),第一,notion,0,3,3,0,5,5,0.046277,4,0.33091,0.372345,6500.451978
第三党(1947),第三党,notion,0,2,2,0,3,3,0.027133,4,0.29671,0.328744,1770.9936
第二段(1947),第二段,notion,0,1,1,0,2,2,0.009035,4,0.265075,0.278404,0
第四(1947),第四,notion,0,3,3,0,5,5,0.03254,4,0.304682,0.339827,3978.012047
等於(1947),等於,notion,0,1,1,0,2,2,0.014081,4,0.275493,0.296238,0
筹组(1947),筹组,notion,0,1,1,0,2,2,0.017323,4,0.281723,0.306272,0
管制(1947),管制,notion,0,5,5,0,10,10,0.064471,4,0.360359,0.403337,17371.544246
管窥(1947),管窥,notion,0,1,1,0,2,2,0.003699,4,0.256009,0.261706,0
类似(1947),类似,notion,0,1,1,0,2,2,0.017323,4,0.281723,0.306272,0
粮食(1947),粮食,notion,0,2,2,0,3,3,0.023257,4,0.28761,0.315414,1169.271875
纵队(1947),纵队,notion,0,1,1,0,4,4,0.011229,4,0.270366,0.287632,0
组织(1947),组织,notion,0,7,7,0,15,15,0.085603,4,0.408533,0.444363,40904.989122
经济危机(1947),经济危机,notion,0,10,10,0,21,21,0.106301,4,0.451253,0.473512,69890.613077
经济基础(1947),经济基础,notion,0,2,2,0,4,4,0.024542,4,0.292264,0.322335,1826.657886
统治(1947),统治,notion,0,6,6,0,8,8,0.080252,4,0.397311,0.43566,30063.266385
续完(1947),续完,notion,0,7,7,0,23,23,0.075787,4,0.384122,0.424918,34477.042565
编者(1947),编者,notion,0,5,5,0,58,58,0.069656,4,0.376704,0.418388,21529.940037
罗斯福(1947),罗斯福,notion,0,5,5,0,6,6,0.067779,4,0.372958,0.415055,22133.906433
罗隆基(1947),罗隆基,notion,0,2,2,0,4,4,0.031404,4,0.30602,0.34156,2430.025091
罢课(1947),罢课,notion,0,2,2,0,4,4,0.028552,4,0.301506,0.335445,2588.539662
美棉(1947),美棉,notion,0,1,1,0,5,5,0.007422,4,0.26356,0.275695,0
美苏(1947),美苏,notion,0,7,7,0,23,23,0.08537,4,0.402274,0.439603,33936.283816
耕者有其田(1947),耕者有其田,notion,0,2,2,0,8,8,0.02494,4,0.292941,0.323324,1747.290038
联合(1947),联合,notion,0,6,6,0,10,10,0.064613,4,0.364905,0.407719,26064.902455
联合会(1947),联合会,notion,0,4,4,0,9,9,0.049879,4,0.335331,0.377386,10542.591475
联合国安全理事会(1947),联合国安全理事会,notion,0,1,1,0,2,2,0.00981,4,0.267191,0.28214,0
联盟(1947),联盟,notion,0,2,2,0,7,7,0.027133,4,0.29671,0.328744,1770.9936
联络(1947),联络,notion,0,2,2,0,3,3,0.022153,4,0.289808,0.31871,2534.094371
胜败(1947),胜败,notion,0,1,1,0,2,2,0.003699,4,0.256009,0.261706,0
胡适(1947),胡适,notion,0,4,4,0,9,9,0.049465,4,0.336256,0.378412,10626.65254
胶东(1947),胶东,notion,0,1,1,0,2,2,0.017323,4,0.281723,0.306272,0
自己(1947),自己,notion,0,8,8,0,12,12,0.08685,4,0.408827,0.444644,46563.52373
自治(1947),自治,notion,0,6,6,0,8,8,0.067548,4,0.366511,0.409221,22415.645004
自治领(1947),自治领,notion,0,2,2,0,3,3,0.024542,4,0.292264,0.322335,1826.657886
自由主义(1947),自由主义,notion,0,7,7,0,12,12,0.07784,4,0.381162,0.422391,27939.82783
自绝(1947),自绝,notion,0,1,1,0,2,2,0.013711,4,0.275027,0.295469,0
航讯(1947),航讯,notion,0,2,2,0,10,10,0.028552,4,0.301506,0.335445,2588.539662
艰苦奋斗(1947),艰苦奋斗,notion,0,1,1,0,2,2,0.011229,4,0.270366,0.287632,0
荀子(1947),荀子,notion,0,1,1,0,2,2,0.014081,4,0.275493,0.296238,0
莫忘(1947),莫忘,notion,0,2,2,0,3,3,0.028302,4,0.298866,0.331783,1965.8222
莫洛托夫(1947),莫洛托夫,notion,0,1,1,0,3,3,0.00981,4,0.267191,0.28214,0
莱尼(1947),莱尼,notion,0,1,1,0,3,3,0.00981,4,0.267191,0.28214,0
菜圃(1947),菜圃,notion,0,1,1,0,2,2,0.007422,4,0.26356,0.275695,0
萧条(1947),萧条,notion,0,3,3,0,5,5,0.036169,4,0.309685,0.346455,4415.889012
蒋介石(1947),蒋介石,notion,0,2,2,0,18,18,0.017299,4,0.278915,0.301865,688.562525
蒋军(1947),蒋军,notion,0,2,2,0,6,6,0.02494,4,0.292941,0.323324,1747.290038
蒋管区(1947),蒋管区,notion,0,2,2,0,4,4,0.02494,4,0.292941,0.323324,1747.290038
蔡军(1947),蔡军,notion,0,1,1,0,2,2,0.011229,4,0.270366,0.287632,0
藏文(1947),藏文,notion,0,1,1,0,2,2,0.014222,4,0.275404,0.296091,0
行宪(1947),行宪,notion,0,3,3,0,17,17,0.033051,4,0.303382,0.338069,3278.387497
行政(1947),行政,notion,0,3,3,0,10,10,0.038112,4,0.315379,0.353742,5778.22737
补白(1947),补白,notion,0,1,1,0,3,3,0.014081,4,0.275493,0.296238,0
西贡(1947),西贡,notion,0,2,2,0,4,4,0.031034,4,0.30613,0.341707,2639.595687
观察家(1947),观察家,notion,0,1,1,0,2,2,0.017323,4,0.281723,0.306272,0
观感(1947),观感,notion,0,7,7,0,11,11,0.086692,4,0.406587,0.442898,34235.041902
观点(1947),观点,notion,0,9,9,0,12,12,0.096381,4,0.426235,0.457192,53329.404281
解决(1947),解决,notion,0,8,8,0,12,12,0.087472,4,0.410252,0.445706,47620.739402
解剖(1947),解剖,notion,0,1,1,0,2,2,0.009035,4,0.265075,0.278404,0
解蔽(1947),解蔽,notion,0,1,1,0,2,2,0.014081,4,0.275493,0.296238,0
讨论(1947),讨论,notion,0,4,4,0,9,9,0.057365,4,0.353676,0.396721,13988.52001
训练(1947),训练,notion,0,4,4,0,5,5,0.049435,4,0.338221,0.380572,13382.565022
说起(1947),说起,notion,0,10,10,0,19,19,0.115263,4,0.483327,0.491895,82296.794945
请愿(1947),请愿,notion,0,2,2,0,5,5,0.031034,4,0.30613,0.341707,2639.595687
请选(1947),请选,notion,0,1,1,0,2,2,0.014732,4,0.276453,0.297813,0
读者(1947),读者,notion,0,6,6,0,65,65,0.061001,4,0.356855,0.399993,25284.370159
课本(1947),课本,notion,0,1,1,0,2,2,0.014222,4,0.275404,0.296091,0
调查(1947),调查,notion,0,5,5,0,6,6,0.067175,4,0.372145,0.414323,21577.273519
谴责(1947),谴责,notion,0,1,1,0,2,2,0.017323,4,0.281723,0.306272,0
财政危机(1947),财政危机,notion,0,2,2,0,3,3,0.015803,4,0.277803,0.300071,1213.264941
责任(1947),责任,notion,0,4,4,0,18,18,0.034641,4,0.309769,0.346626,9591.688956
贷款(1947),贷款,notion,0,7,7,0,12,12,0.076243,4,0.383259,0.424186,33824.90627
贸易(1947),贸易,notion,0,7,7,0,17,17,0.087852,4,0.407315,0.443448,33925.397637
资产阶级(1947),资产阶级,notion,0,3,3,0,5,5,0.032556,4,0.304112,0.339058,4570.509479
赋额(1947),赋额,notion,0,1,1,0,2,2,0.009035,4,0.265075,0.278404,0
赔偿(1947),赔偿,notion,0,3,3,0,5,5,0.02878,4,0.296067,0.327889,3128.084172
越南(1947),越南,notion,0,6,6,0,12,12,0.065189,4,0.362733,0.405669,18817.54651
转变(1947),转变,notion,0,6,6,0,8,8,0.065192,4,0.36181,0.40479,20590.804252
辛亥革命(1947),辛亥革命,notion,0,3,3,0,6,6,0.034622,4,0.309572,0.346309,4126.137601
辩证法(1947),辩证法,notion,0,1,1,0,2,2,0.009035,4,0.265075,0.278404,0
辽阳(1947),辽阳,notion,0,1,1,0,2,2,0.009035,4,0.265075,0.278404,0
迎接(1947),迎接,notion,0,6,6,0,15,15,0.064697,4,0.360283,0.403325,21754.7641
还乡(1947),还乡,notion,0,3,3,0,4,4,0.034996,4,0.3096,0.346345,5295.966128
这样(1947),这样,notion,0,4,4,0,10,10,0.056995,4,0.352143,0.395183,13610.726952
进修(1947),进修,notion,0,2,2,0,15,15,0.021644,4,0.28732,0.314975,1747.667055
进展(1947),进展,notion,0,1,1,0,2,2,0.014222,4,0.275404,0.296091,0
远东(1947),远东,notion,0,4,4,0,9,9,0.055436,4,0.346989,0.38991,12199.154379
迫切(1947),迫切,notion,0,1,1,0,2,2,0.009035,4,0.265075,0.278404,0
选政(1947),选政,notion,0,1,1,0,2,2,0.014222,4,0.275404,0.296091,0
选灾(1947),选灾,notion,0,2,2,0,3,3,0.023116,4,0.288412,0.316623,1358.22258
通电(1947),通电,notion,0,1,1,0,2,2,0.017323,4,0.281723,0.306272,0
速写(1947),速写,notion,0,2,2,0,3,3,0.021132,4,0.288412,0.316623,2574.708611
逮捕(1947),逮捕,notion,0,4,4,0,5,5,0.049354,4,0.334969,0.376984,9324.989644
道德(1947),道德,notion,0,3,3,0,5,5,0.033561,4,0.304356,0.339388,3349.170174
邓初民(1947),邓初民,notion,0,2,2,0,3,3,0.031034,4,0.30613,0.341707,2639.595687
鄂皖(1947),鄂皖,notion,0,1,1,0,2,2,0.017323,4,0.281723,0.306272,0
酒神(1947),酒神,notion,0,1,1,0,2,2,0.014222,4,0.275404,0.296091,0
重大(1947),重大,notion,0,2,2,0,3,3,0.01897,4,0.280427,0.304282,657.210893
重阳(1947),重阳,notion,0,2,2,0,3,3,0.024745,4,0.295069,0.3264,2684.608967
野心(1947),野心,notion,0,3,3,0,4,4,0.031882,4,0.302173,0.336422,3408.792279
野村(1947),野村,notion,0,1,1,0,2,2,0.017323,4,0.281723,0.306272,0
金元(1947),金元,notion,0,3,3,0,6,6,0.041865,4,0.321892,0.361762,5813.37408
针刺(1947),针刺,notion,0,1,1,0,2,2,0.014222,4,0.275404,0.296091,0
铅山(1947),铅山,notion,0,1,1,0,2,2,0.007422,4,0.26356,0.275695,0
长沙(1947),长沙,notion,0,2,2,0,5,5,0.027791,4,0.29968,0.332918,2405.290268
関係(1947),関係,notion,0,1,1,0,3,3,0.014222,4,0.275404,0.296091,0
闻一多(1947),闻一多,notion,0,4,4,0,11,11,0.0361,4,0.309236,0.34593,6420.020908
阁潮(1947),阁潮,notion,0,3,3,0,4,4,0.025788,4,0.292715,0.323056,3546.742116
防共(1947),防共,notion,0,1,1,0,3,3,0.017323,4,0.281723,0.306272,0
阶段(1947),阶段,notion,0,7,7,0,13,13,0.082338,4,0.397404,0.435794,35812.235401
陈案(1947),陈案,notion,0,1,1,0,2,2,0.017323,4,0.281723,0.306272,0
陶行知(1947),陶行知,notion,0,2,2,0,4,4,0.027133,4,0.29671,0.328744,1770.9936
集体化(1947),集体化,notion,0,1,1,0,2,2,0.007422,4,0.26356,0.275695,0
集释(1947),集释,notion,0,1,1,0,2,2,0.014222,4,0.275404,0.296091,0
雕像(1947),雕像,notion,0,1,1,0,4,4,0.00981,4,0.267191,0.28214,0
露骨(1947),露骨,notion,0,1,1,0,2,2,0.017323,4,0.281723,0.306272,0
青岛(1947),青岛,notion,0,3,3,0,7,7,0.046135,4,0.331006,0.372455,6671.362925
革新派(1947),革新派,notion,0,1,1,0,2,2,0.017323,4,0.281723,0.306272,0
顶好(1947),顶好,notion,0,1,1,0,2,2,0.013711,4,0.275027,0.295469,0
预告(1947),预告,notion,0,2,2,0,3,3,0.023116,4,0.288412,0.316623,1358.22258
香港(1947),香港,notion,0,6,6,0,20,20,0.074664,4,0.38538,0.425919,26820.534209
高度(1947),高度,notion,0,1,1,0,2,2,0.014732,4,0.276453,0.297813,0
鬥争(1947),鬥争,notion,0,3,3,0,12,12,0.042013,4,0.324215,0.364545,6814.567825
鸟瞰(1947),鸟瞰,notion,0,2,2,0,4,4,0.028954,4,0.300154,0.333577,2064.821066
黄炎培(1947),黄炎培,notion,0,2,2,0,4,4,0.020912,4,0.285589,0.312338,797.979389
黄金(1947),黄金,notion,0,3,3,0,5,5,0.037848,4,0.312921,0.35063,4836.024023
黄龙(1947),黄龙,notion,0,1,1,0,2,2,0.007422,4,0.26356,0.275695,0
Affairs(1947),Affairs,notion,0,1,1,0,1,1,0.014222,4,0.275404,0.296091,0
Albert(1947),Albert,notion,0,1,1,0,1,1,0.014081,4,0.275493,0.296238,0
Briggs(1947),Briggs,notion,0,1,1,0,1,1,0.014081,4,0.275493,0.296238,0
DorothyCarrington(1947),DorothyCarrington,notion,0,1,1,0,1,1,0.014081,4,0.275493,0.296238,0
Finletter(1947),Finletter,notion,0,1,1,0,1,1,0.014081,4,0.275493,0.296238,0
Frank(1947),Frank,notion,0,1,1,0,1,1,0.014081,4,0.275493,0.296238,0
Gunther(1947),Gunther,notion,0,1,1,0,1,1,0.014081,4,0.275493,0.296238,0
Herbert(1947),Herbert,notion,0,1,1,0,1,1,0.014081,4,0.275493,0.296238,0
INCOGNITA(1947),INCOGNITA,notion,0,1,1,0,1,1,0.00981,4,0.267191,0.28214,0
John(1947),John,notion,0,1,1,0,1,1,0.014081,4,0.275493,0.296238,0
Mathiez(1947),Mathiez,notion,0,1,1,0,1,1,0.014081,4,0.275493,0.296238,0
POST(1947),POST,notion,0,1,1,0,1,1,0.014081,4,0.275493,0.296238,0
Pacific(1947),Pacific,notion,0,1,1,0,1,1,0.014222,4,0.275404,0.296091,0
TERRA(1947),TERRA,notion,0,1,1,0,1,1,0.00981,4,0.267191,0.28214,0
TV(1947),TV,notion,0,1,1,0,1,1,0.013711,4,0.275027,0.295469,0
Thomas(1947),Thomas,notion,0,1,1,0,1,1,0.014081,4,0.275493,0.296238,0
Tsao(1947),Tsao,notion,0,1,1,0,1,1,0.014081,4,0.275493,0.296238,0
WASHINGTON(1947),WASHINGTON,notion,0,1,1,0,1,1,0.014081,4,0.275493,0.296238,0
Weldon(1947),Weldon,notion,0,1,1,0,1,1,0.014081,4,0.275493,0.296238,0
guilty(1947),guilty,notion,0,1,1,0,1,1,0.014732,4,0.276453,0.297813,0
not(1947),not,notion,0,1,1,0,1,1,0.014732,4,0.276453,0.297813,0
一一二(1947),一一二,notion,0,1,1,0,1,1,0.011229,4,0.270366,0.287632,0
一七(1947),一七,notion,0,1,1,0,1,1,0.00981,4,0.267191,0.28214,0
一三五(1947),一三五,notion,0,1,1,0,1,1,0.011229,4,0.270366,0.287632,0
一个半月(1947),一个半月,notion,0,1,1,0,1,1,0.013711,4,0.275027,0.295469,0
一个多月(1947),一个多月,notion,0,1,1,0,1,1,0.014732,4,0.276453,0.297813,0
一个月(1947),一个月,notion,0,1,1,0,1,1,0.007422,4,0.26356,0.275695,0
一举成名(1947),一举成名,notion,0,1,1,0,1,1,0.014732,4,0.276453,0.297813,0
一九三(1947),一九三,notion,0,1,1,0,1,1,0.014222,4,0.275404,0.296091,0
一九五(1947),一九五,notion,0,1,1,0,1,1,0.00981,4,0.267191,0.28214,0
一九四(1947),一九四,notion,0,1,1,0,1,1,0.00981,4,0.267191,0.28214,0
一九四三年(1947),一九四三年,notion,0,1,1,0,1,1,0.00981,4,0.267191,0.28214,0
一九四八(1947),一九四八,notion,0,1,1,0,1,1,0.017323,4,0.281723,0.306272,0
一事(1947),一事,notion,0,1,1,0,1,1,0.014732,4,0.276453,0.297813,0
一二(1947),一二,notion,0,1,1,0,1,1,0.017323,4,0.281723,0.306272,0
一二九(1947),一二九,notion,0,1,1,0,1,1,0.017323,4,0.281723,0.306272,0
一件(1947),一件,notion,0,1,1,0,1,1,0.007422,4,0.26356,0.275695,0
一份(1947),一份,notion,0,1,1,0,1,1,0.007422,4,0.26356,0.275695,0
一例(1947),一例,notion,0,2,2,0,4,4,0.023891,4,0.292014,0.321969,2116.906395
一党(1947),一党,notion,0,1,1,0,1,1,0.014081,4,0.275493,0.296238,0
一八(1947),一八,notion,0,1,1,0,1,1,0.013711,4,0.275027,0.295469,0
一再(1947),一再,notion,0,1,1,0,1,1,0.014081,4,0.275493,0.296238,0
一切(1947),一切,notion,0,4,4,0,6,6,0.044296,4,0.323908,0.36424,9788.069017
一刻(1947),一刻,notion,0,1,1,0,1,1,0.007422,4,0.26356,0.275695,0
一千万(1947),一千万,notion,0,1,1,0,1,1,0.013711,4,0.275027,0.295469,0
一千四百(1947),一千四百,notion,0,1,1,0,1,1,0.014222,4,0.275404,0.296091,0
一发(1947),一发,notion,0,2,2,0,7,7,0.024745,4,0.295069,0.3264,2684.608967
一句(1947),一句,notion,0,3,3,0,3,3,0.040069,4,0.319541,0.358906,5776.792264
一叶知秋(1947),一叶知秋,notion,0,1,1,0,1,1,0.017323,4,0.281723,0.306272,0
一名(1947),一名,notion,0,2,2,0,2,2,0.022746,4,0.288631,0.316952,1575.703869
一告(1947),一告,notion,0,1,1,0,1,1,0.014081,4,0.275493,0.296238,0
一周年(1947),一周年,notion,0,1,1,0,1,1,0.00981,4,0.267191,0.28214,0
一团和气(1947),一团和气,notion,0,1,1,0,1,1,0.014081,4,0.275493,0.296238,0
一场(1947),一场,notion,0,2,2,0,3,3,0.028954,4,0.300154,0.333577,2064.821066
一夕(1947),一夕,notion,0,1,1,0,1,1,0.014732,4,0.276453,0.297813,0
一定(1947),一定,notion,0,4,4,0,4,4,0.053752,4,0.345374,0.388226,13094.543338
一封信(1947),一封信,notion,0,2,2,0,3,3,0.021502,4,0.288388,0.316586,2245.621531
一幅(1947),一幅,notion,0,1,1,0,1,1,0.004749,4,0.257108,0.263793,0
一幕(1947),一幕,notion,0,1,1,0,2,2,0.013711,4,0.275027,0.295469,0
一年(1947),一年,notion,0,12,12,0,21,21,0.102794,4,0.441848,0.467738,78526.195299
一年级(1947),一年级,notion,0,1,1,0,1,1,0.014081,4,0.275493,0.296238,0
一座(1947),一座,notion,0,1,1,0,1,1,0.013711,4,0.275027,0.295469,0
一往无前(1947),一往无前,notion,0,1,1,0,1,1,0.011229,4,0.270366,0.287632,0
一得(1947),一得,notion,0,1,1,0,1,1,0.007422,4,0.26356,0.275695,0
一心(1947),一心,notion,0,1,1,0,1,1,0.014081,4,0.275493,0.296238,0
一把(1947),一把,notion,0,1,1,0,1,1,0.013711,4,0.275027,0.295469,0
一文(1947),一文,notion,0,1,1,0,1,1,0.014081,4,0.275493,0.296238,0
一斑(1947),一斑,notion,0,2,2,0,2,2,0.024745,4,0.295069,0.3264,2684.608967
一曲(1947),一曲,notion,0,1,1,0,1,1,0.014081,4,0.275493,0.296238,0
一期(1947),一期,notion,0,1,1,0,1,1,0.014081,4,0.275493,0.296238,0
一本(1947),一本,notion,0,1,1,0,1,1,0.017323,4,0.281723,0.306272,0
一条(1947),一条,notion,0,5,5,0,10,10,0.071075,4,0.381461,0.422526,22968.426372
一样(1947),一样,notion,0,1,1,0,1,1,0.014222,4,0.275404,0.296091,0
一次(1947),一次,notion,0,5,5,0,7,7,0.049186,4,0.336488,0.378729,17432.184529
一步(1947),一步,notion,0,2,2,0,2,2,0.02494,4,0.292941,0.323324,1747.290038
一段(1947),一段,notion,0,2,2,0,2,2,0.032055,4,0.30624,0.341853,2215.722594
一熏(1947),一熏,notion,0,1,1,0,1,1,0.014081,4,0.275493,0.296238,0
一环(1947),一环,notion,0,1,1,0,1,1,0.014222,4,0.275404,0.296091,0
一班(1947),一班,notion,0,1,1,0,1,1,0.017323,4,0.281723,0.306272,0
一生(1947),一生,notion,0,1,1,0,1,1,0.014732,4,0.276453,0.297813,0
一百(1947),一百,notion,0,1,1,0,1,1,0.00981,4,0.267191,0.28214,0
一直(1947),一直,notion,0,1,1,0,1,1,0.017323,4,0.281723,0.306272,0
一瞥(1947),一瞥,notion,0,3,3,0,3,3,0.035974,4,0.315262,0.353596,7290.358516
一石(1947),一石,notion,0,1,1,0,1,1,0.014732,4,0.276453,0.297813,0
一种(1947),一种,notion,0,5,5,0,6,6,0.054835,4,0.344676,0.387554,16653.958479
一笔(1947),一笔,notion,0,2,2,0,3,3,0.023521,4,0.291018,0.320504,1911.402908
一篇(1947),一篇,notion,0,3,3,0,3,3,0.046277,4,0.33091,0.372345,6500.451978
一经(1947),一经,notion,0,1,1,0,1,1,0.009035,4,0.265075,0.278404,0
一群(1947),一群,notion,0,2,2,0,2,2,0.011121,4,0.268981,0.285313,1110.190852
一联(1947),一联,notion,0,1,1,0,1,1,0.017323,4,0.281723,0.306272,0
一脚(1947),一脚,notion,0,1,1,0,1,1,0.014732,4,0.276453,0.297813,0
一致(1947),一致,notion,0,3,3,0,3,3,0.033383,4,0.30932,0.345979,6783.15286
一般(1947),一般,notion,0,3,3,0,4,4,0.045766,4,0.331424,0.372931,7043.04865
一读(1947),一读,notion,0,2,2,0,2,2,0.028302,4,0.298866,0.331783,1965.8222
一课(1947),一课,notion,0,1,1,0,1,1,0.017323,4,0.281723,0.306272,0
一贩狗者(1947),一贩狗者,notion,0,1,1,0,1,1,0.014732,4,0.276453,0.297813,0
一起(1947),一起,notion,0,1,1,0,2,2,0.00981,4,0.267191,0.28214,0
一边(1947),一边,notion,0,1,1,0,1,1,0.011229,4,0.270366,0.287632,0
一週年(1947),一週年,notion,0,1,1,0,1,1,0.013711,4,0.275027,0.295469,0
一部(1947),一部,notion,0,1,1,0,1,1,0.013711,4,0.275027,0.295469,0
一部分(1947),一部分,notion,0,1,1,0,1,1,0.017323,4,0.281723,0.306272,0
一面镜子(1947),一面镜子,notion,0,1,1,0,1,1,0.00981,4,0.267191,0.28214,0
一页(1947),一页,notion,0,2,2,0,2,2,0.02531,4,0.2954,0.326876,2496.768821
一项(1947),一项,notion,0,1,1,0,1,1,0.007422,4,0.26356,0.275695,0
一颗(1947),一颗,notion,0,1,1,0,1,1,0.017323,4,0.281723,0.306272,0
一首(1947),一首,notion,0,1,1,0,1,1,0.014081,4,0.275493,0.296238,0
一齐(1947),一齐,notion,0,1,1,0,1,1,0.014081,4,0.275493,0.296238,0
丁亥(1947),丁亥,notion,0,1,1,0,1,1,0.017323,4,0.281723,0.306272,0
丁香(1947),丁香,notion,0,1,1,0,1,1,0.014732,4,0.276453,0.297813,0
七一(1947),七一,notion,0,1,1,0,1,1,0.013711,4,0.275027,0.295469,0
七七(1947),七七,notion,0,2,2,0,2,2,0.028442,4,0.300022,0.333394,2187.730369
七亿(1947),七亿,notion,0,1,1,0,1,1,0.014081,4,0.275493,0.296238,0
七十(1947),七十,notion,0,1,1,0,2,2,0.017323,4,0.281723,0.306272,0
七十九(1947),七十九,notion,0,1,1,0,4,4,0.00981,4,0.267191,0.28214,0
七点(1947),七点,notion,0,1,1,0,2,2,0.014081,4,0.275493,0.296238,0
万人(1947),万人,notion,0,1,1,0,1,1,0.017323,4,0.281723,0.306272,0
万人分(1947),万人分,notion,0,1,1,0,1,1,0.011229,4,0.270366,0.287632,0
万元(1947),万元,notion,0,1,1,0,1,1,0.014732,4,0.276453,0.297813,0
万县(1947),万县,notion,0,1,1,0,1,1,0.014081,4,0.275493,0.296238,0
万季(1947),万季,notion,0,1,1,0,1,1,0.014222,4,0.275404,0.296091,0
万学(1947),万学,notion,0,1,1,0,1,1,0.017323,4,0.281723,0.306272,0
万岁(1947),万岁,notion,0,2,2,0,2,2,0.027932,4,0.299811,0.333101,2443.455357
万工奴(1947),万工奴,notion,0,1,1,0,1,1,0.014222,4,0.275404,0.296091,0
万教(1947),万教,notion,0,1,1,0,1,1,0.017323,4,0.281723,0.306272,0
万祥(1947),万祥,notion,0,1,1,0,1,1,0.007422,4,0.26356,0.275695,0
万能(1947),万能,notion,0,1,1,0,1,1,0.014732,4,0.276453,0.297813,0
万里(1947),万里,notion,0,1,1,0,1,1,0.017323,4,0.281723,0.306272,0
丈夫(1947),丈夫,notion,0,1,1,0,1,1,0.014222,4,0.275404,0.296091,0
三一八(1947),三一八,notion,0,1,1,0,1,1,0.014732,4,0.276453,0.297813,0
三三制(1947),三三制,notion,0,1,1,0,1,1,0.009035,4,0.265075,0.278404,0
三世(1947),三世,notion,0,1,1,0,1,1,0.00981,4,0.267191,0.28214,0
三五(1947),三五,notion,0,1,1,0,1,1,0.009035,4,0.265075,0.278404,0
三代(1947),三代,notion,0,1,1,0,1,1,0.017323,4,0.281723,0.306272,0
三件(1947),三件,notion,0,1,1,0,1,1,0.011229,4,0.270366,0.287632,0
三位(1947),三位,notion,0,1,1,0,1,1,0.017323,4,0.281723,0.306272,0
三党(1947),三党,notion,0,1,1,0,2,2,0.009035,4,0.265075,0.278404,0
三八(1947),三八,notion,0,1,1,0,1,1,0.013711,4,0.275027,0.295469,0
三八妇女节(1947),三八妇女节,notion,0,3,3,0,3,3,0.03475,4,0.309488,0.346199,5532.888574
三六在(1947),三六在,notion,0,1,1,0,1,1,0.014222,4,0.275404,0.296091,0
三分(1947),三分,notion,0,1,1,0,1,1,0.017323,4,0.281723,0.306272,0
三劳(1947),三劳,notion,0,1,1,0,1,1,0.002092,4,0.25318,0.25625,0
三十六(1947),三十六,notion,0,1,1,0,1,1,0.013711,4,0.275027,0.295469,0
三十周年(1947),三十周年,notion,0,1,1,0,1,1,0.017323,4,0.281723,0.306272,0
三十年(1947),三十年,notion,0,4,4,0,7,7,0.055575,4,0.347944,0.390899,12552.103043
三千(1947),三千,notion,0,2,2,0,3,3,0.014928,4,0.275516,0.296336,1118.339317
三千万(1947),三千万,notion,0,1,1,0,1,1,0.013711,4,0.275027,0.295469,0
三千元(1947),三千元,notion,0,1,1,0,1,1,0.014081,4,0.275493,0.296238,0
三君(1947),三君,notion,0,1,1,0,1,1,0.017323,4,0.281723,0.306272,0
三四(1947),三四,notion,0,1,1,0,1,1,0.009035,4,0.265075,0.278404,0
三外(1947),三外,notion,0,1,1,0,1,1,0.003588,4,0.255396,0.260534,0
三大(1947),三大,notion,0,2,2,0,2,2,0.027932,4,0.299811,0.333101,2443.455357
三大报(1947),三大报,notion,0,1,1,0,1,1,0.013711,4,0.275027,0.295469,0
三头六臂(1947),三头六臂,notion,0,1,1,0,1,1,0.014732,4,0.276453,0.297813,0
三宝(1947),三宝,notion,0,1,1,0,1,1,0.007422,4,0.26356,0.275695,0
三年(1947),三年,notion,0,2,2,0,2,2,0.031545,4,0.305336,0.340645,2219.908318
三座(1947),三座,notion,0,1,1,0,1,1,0.011229,4,0.270366,0.287632,0
三强(1947),三强,notion,0,1,1,0,1,1,0.014222,4,0.275404,0.296091,0
三征(1947),三征,notion,0,1,1,0,1,1,0.011229,4,0.270366,0.287632,0
三愿(1947),三愿,notion,0,1,1,0,1,1,0.017323,4,0.281723,0.306272,0
三校(1947),三校,notion,0,1,1,0,1,1,0.014732,4,0.276453,0.297813,0
三案(1947),三案,notion,0,1,1,0,1,1,0.017323,4,0.281723,0.306272,0
三次(1947),三次,notion,0,2,2,0,2,2,0.028552,4,0.301506,0.335445,2588.539662
三水(1947),三水,notion,0,1,1,0,1,1,0.011229,4,0.270366,0.287632,0
三活(1947),三活,notion,0,1,1,0,1,1,0.011229,4,0.270366,0.287632,0
三潮(1947),三潮,notion,0,1,1,0,1,1,0.017323,4,0.281723,0.306272,0
三点(1947),三点,notion,0,1,1,0,1,1,0.017323,4,0.281723,0.306272,0
三病(1947),三病,notion,0,1,1,0,1,1,0.003699,4,0.256009,0.261706,0
三百(1947),三百,notion,0,1,1,0,1,1,0.014222,4,0.275404,0.296091,0
三百万(1947),三百万,notion,0,1,1,0,1,1,0.011229,4,0.270366,0.287632,0
三百二十三(1947),三百二十三,notion,0,1,1,0,1,1,0.014081,4,0.275493,0.296238,0
三种(1947),三种,notion,0,1,1,0,1,1,0.007422,4,0.26356,0.275695,0
三站(1947),三站,notion,0,1,1,0,1,1,0.011229,4,0.270366,0.287632,0
三队(1947),三队,notion,0,1,1,0,1,1,0.007422,4,0.26356,0.275695,0
三阶(1947),三阶,notion,0,1,1,0,1,1,0.007422,4,0.26356,0.275695,0
三青团(1947),三青团,notion,0,1,1,0,1,1,0.011229,4,0.270366,0.287632,0
三题(1947),三题,notion,0,1,1,0,1,1,0.014732,4,0.276453,0.297813,0
三首(1947),三首,notion,0,1,1,0,1,1,0.017323,4,0.281723,0.306272,0
上下册(1947),上下册,notion,0,1,1,0,1,1,0.014222,4,0.275404,0.296091,0
上午(1947),上午,notion,0,1,1,0,1,1,0.013711,4,0.275027,0.295469,0
上坟(1947),上坟,notion,0,1,1,0,1,1,0.014732,4,0.276453,0.297813,0
上层(1947),上层,notion,0,1,1,0,1,1,0.014081,4,0.275493,0.296238,0
上当(1947),上当,notion,0,1,1,0,1,1,0.013711,4,0.275027,0.295469,0
上林(1947),上林,notion,0,1,1,0,1,1,0.011229,4,0.270366,0.287632,0
上次(1947),上次,notion,0,1,1,0,1,1,0.014222,4,0.275404,0.296091,0
上海滩(1947),上海滩,notion,0,1,1,0,1,1,0.014732,4,0.276453,0.297813,0
上涨(1947),上涨,notion,0,2,2,0,3,3,0.028442,4,0.300022,0.333394,2187.730369
上游(1947),上游,notion,0,1,1,0,1,1,0.011229,4,0.270366,0.287632,0
上演(1947),上演,notion,0,2,2,0,3,3,0.024542,4,0.292264,0.322335,1826.657886
上行下效(1947),上行下效,notion,0,2,2,0,2,2,0.01948,4,0.281468,0.30593,668.20053
上课(1947),上课,notion,0,1,1,0,1,1,0.014732,4,0.276453,0.297813,0
上院(1947),上院,notion,0,1,1,0,1,1,0.009035,4,0.265075,0.278404,0
下乡(1947),下乡,notion,0,3,3,0,3,3,0.032361,4,0.30646,0.342207,6339.208536
下分(1947),下分,notion,0,1,1,0,1,1,0.011229,4,0.270366,0.287632,0
下午(1947),下午,notion,0,1,1,0,1,1,0.014081,4,0.275493,0.296238,0
下去(1947),下去,notion,0,2,2,0,3,3,0.020912,4,0.285589,0.312338,797.979389
下台(1947),下台,notion,0,1,1,0,1,1,0.011229,4,0.270366,0.287632,0
下文(1947),下文,notion,0,1,1,0,1,1,0.014081,4,0.275493,0.296238,0
下斯(1947),下斯,notion,0,1,1,0,1,1,0.00981,4,0.267191,0.28214,0
下期(1947),下期,notion,0,3,3,0,3,3,0.032926,4,0.304301,0.339314,4558.531678
下来(1947),下来,notion,0,2,2,0,2,2,0.01897,4,0.280427,0.304282,657.210893
不下于(1947),不下于,notion,0,1,1,0,1,1,0.003588,4,0.255396,0.260534,0
不中用(1947),不中用,notion,0,1,1,0,1,1,0.013711,4,0.275027,0.295469,0
不了(1947),不了,notion,0,2,2,0,3,3,0.02494,4,0.292941,0.323324,1747.290038
不会(1947),不会,notion,0,4,4,0,4,4,0.059987,4,0.358354,0.401335,13771.233391
不但(1947),不但,notion,0,1,1,0,1,1,0.017323,4,0.281723,0.306272,0
不倒(1947),不倒,notion,0,1,1,0,1,1,0.013711,4,0.275027,0.295469,0
不像(1947),不像,notion,0,1,1,0,1,1,0.013711,4,0.275027,0.295469,0
不免(1947),不免,notion,0,1,1,0,1,1,0.014081,4,0.275493,0.296238,0
不到(1947),不到,notion,0,1,1,0,1,1,0.013711,4,0.275027,0.295469,0
不劳而获(1947),不劳而获,notion,0,1,1,0,1,1,0.017323,4,0.281723,0.306272,0
不匀(1947),不匀,notion,0,1,1,0,1,1,0.013711,4,0.275027,0.295469,0
不变(1947),不变,notion,0,2,2,0,2,2,0.025961,4,0.295759,0.327389,2231.848602
不可(1947),不可,notion,0,3,3,0,5,5,0.030905,4,0.302521,0.336898,4055.116212
不同(1947),不同,notion,0,1,1,0,1,1,0.004749,4,0.257108,0.263793,0
不塞(1947),不塞,notion,0,1,1,0,1,1,0.002092,4,0.25318,0.25625,0
不如(1947),不如,notion,0,1,1,0,1,1,0.004749,4,0.257108,0.263793,0
不妥(1947),不妥,notion,0,1,1,0,1,1,0.014081,4,0.275493,0.296238,0
不安(1947),不安,notion,0,2,2,0,2,2,0.023116,4,0.288412,0.316623,1358.22258
不定(1947),不定,notion,0,1,1,0,1,1,0.017323,4,0.281723,0.306272,0
不容(1947),不容,notion,0,2,2,0,2,2,0.016314,4,0.277757,0.299998,853.020505
不尽(1947),不尽,notion,0,3,3,0,3,3,0.035864,4,0.314102,0.352131,7296.533351
不应(1947),不应,notion,0,3,3,0,3,3,0.028516,4,0.294381,0.325472,2570.363567
不得(1947),不得,notion,0,1,1,0,1,1,0.014081,4,0.275493,0.296238,0
不得了(1947),不得了,notion,0,2,2,0,2,2,0.021022,4,0.286837,0.314242,1344.24886
不必(1947),不必,notion,0,1,1,0,1,1,0.017323,4,0.281723,0.306272,0
不怕(1947),不怕,notion,0,1,1,0,1,1,0.013711,4,0.275027,0.295469,0
不愿(1947),不愿,notion,0,2,2,0,2,2,0.031545,4,0.305336,0.340645,2219.908318
不懈(1947),不懈,notion,0,1,1,0,1,1,0.007422,4,0.26356,0.275695,0
不收(1947),不收,notion,0,1,1,0,1,1,0.014081,4,0.275493,0.296238,0
不敢(1947),不敢,notion,0,2,2,0,2,2,0.020912,4,0.285589,0.312338,797.979389
不易(1947),不易,notion,0,1,1,0,1,1,0.013711,4,0.275027,0.295469,0
不是(1947),不是,notion,0,5,5,0,7,7,0.05307,4,0.339702,0.382245,14618.342471
不朽(1947),不朽,notion,0,1,1,0,1,1,0.014222,4,0.275404,0.296091,0
不死(1947),不死,notion,0,2,2,0,2,2,0.031034,4,0.30613,0.341707,2639.595687
不灭(1947),不灭,notion,0,2,2,0,2,2,0.025451,4,0.295094,0.326437,2353.768712
不直(1947),不直,notion,0,1,1,0,1,1,0.017323,4,0.281723,0.306272,0
不知(1947),不知,notion,0,2,2,0,2,2,0.031034,4,0.30613,0.341707,2639.595687
不祥(1947),不祥,notion,0,1,1,0,1,1,0.017323,4,0.281723,0.306272,0
不能(1947),不能,notion,0,5,5,0,15,15,0.070565,4,0.380865,0.422013,23290.464154
不要(1947),不要,notion,0,6,6,0,7,7,0.066628,4,0.358881,0.40197,19964.522089
不要紧(1947),不要紧,notion,0,1,1,0,1,1,0.014081,4,0.275493,0.296238,0
不见(1947),不见,notion,0,1,1,0,1,1,0.014222,4,0.275404,0.296091,0
不让(1947),不让,notion,0,1,1,0,1,1,0.017323,4,0.281723,0.306272,0
不过(1947),不过,notion,0,1,1,0,1,1,0.017323,4,0.281723,0.306272,0
不进(1947),不进,notion,0,1,1,0,1,1,0.013711,4,0.275027,0.295469,0
不远(1947),不远,notion,0,1,1,0,1,1,0.013711,4,0.275027,0.295469,0
不问(1947),不问,notion,0,1,1,0,1,1,0.013711,4,0.275027,0.295469,0
不靠(1947),不靠,notion,0,1,1,0,1,1,0.009035,4,0.265075,0.278404,0
与其(1947),与其,notion,0,1,1,0,1,1,0.009035,4,0.265075,0.278404,0
与备(1947),与备,notion,0,1,1,0,1,1,0.014081,4,0.275493,0.296238,0
与斯考(1947),与斯考,notion,0,1,1,0,1,1,0.014081,4,0.275493,0.296238,0
与民(1947),与民,notion,0,1,1,0,1,1,0.014732,4,0.276453,0.297813,0
与汇(1947),与汇,notion,0,1,1,0,1,1,0.014081,4,0.275493,0.296238,0
与非(1947),与非,notion,0,1,1,0,1,1,0.017323,4,0.281723,0.306272,0
丑恶(1947),丑恶,notion,0,1,1,0,1,1,0.003699,4,0.256009,0.261706,0
丑角(1947),丑角,notion,0,2,2,0,2,2,0.032055,4,0.30624,0.341853,2215.722594
专员(1947),专员,notion,0,1,1,0,1,1,0.011229,4,0.270366,0.287632,0
专家(1947),专家,notion,0,1,1,0,2,2,0.017323,4,0.281723,0.306272,0
专政(1947),专政,notion,0,1,1,0,1,1,0.00981,4,0.267191,0.28214,0
专校(1947),专校,notion,0,1,1,0,1,1,0.014732,4,0.276453,0.297813,0
专科学校(1947),专科学校,notion,0,1,1,0,1,1,0.017323,4,0.281723,0.306272,0
专访(1947),专访,notion,0,1,1,0,3,3,0.014222,4,0.275404,0.296091,0
专页(1947),专页,notion,0,1,1,0,6,6,0.007422,4,0.26356,0.275695,0
世局(1947),世局,notion,0,2,2,0,3,3,0.01897,4,0.280427,0.304282,657.210893
世界史(1947),世界史,notion,0,1,1,0,1,1,0.00981,4,0.267191,0.28214,0
世界大战(1947),世界大战,notion,0,2,2,0,4,4,0.022072,4,0.287175,0.314755,862.424175
世界市场(1947),世界市场,notion,0,1,1,0,1,1,0.017323,4,0.281723,0.306272,0
世界形势(1947),世界形势,notion,0,2,2,0,2,2,0.008337,4,0.261721,0.272423,277.124936
世界性(1947),世界性,notion,0,1,1,0,1,1,0.014222,4,0.275404,0.296091,0
世界潮流(1947),世界潮流,notion,0,1,1,0,1,1,0.014081,4,0.275493,0.296238,0
世界观(1947),世界观,notion,0,1,1,0,1,1,0.007422,4,0.26356,0.275695,0
世界霸权(1947),世界霸权,notion,0,1,1,0,1,1,0.004749,4,0.257108,0.263793,0
世纪(1947),世纪,notion,0,1,1,0,1,1,0.009035,4,0.265075,0.278404,0
世间(1947),世间,notion,0,1,1,0,1,1,0.013711,4,0.275027,0.295469,0
业务(1947),业务,notion,0,1,1,0,9,9,0.007422,4,0.26356,0.275695,0
业绩(1947),业绩,notion,0,1,1,0,1,1,0.014732,4,0.276453,0.297813,0
东乡(1947),东乡,notion,0,1,1,0,1,1,0.011229,4,0.270366,0.287632,0
东北民主联军(1947),东北民主联军,notion,0,1,1,0,1,1,0.013711,4,0.275027,0.295469,0
东南(1947),东南,notion,0,2,2,0,4,4,0.024745,4,0.295069,0.3264,2684.608967
东南亚(1947),东南亚,notion,0,2,2,0,3,3,0.027133,4,0.29671,0.328744,1770.9936
东方(1947),东方,notion,0,3,3,0,3,3,0.031312,4,0.305145,0.34045,6153.53288
东来(1947),东来,notion,0,1,1,0,1,1,0.011229,4,0.270366,0.287632,0
东段(1947),东段,notion,0,1,1,0,1,1,0.017323,4,0.281723,0.306272,0
东江(1947),东江,notion,0,1,1,0,3,3,0.011229,4,0.270366,0.287632,0
东江纵队(1947),东江纵队,notion,0,1,1,0,1,1,0.011229,4,0.270366,0.287632,0
东洋(1947),东洋,notion,0,1,1,0,1,1,0.017323,4,0.281723,0.306272,0
东纵(1947),东纵,notion,0,1,1,0,1,1,0.011229,4,0.270366,0.287632,0
东进(1947),东进,notion,0,1,1,0,1,1,0.014222,4,0.275404,0.296091,0
东部(1947),东部,notion,0,1,1,0,2,2,0.00981,4,0.267191,0.28214,0
丞其人(1947),丞其人,notion,0,1,1,0,1,1,0.017323,4,0.281723,0.306272,0
两个(1947),两个,notion,0,7,7,0,9,9,0.07357,4,0.371335,0.413713,26309.200836
两事(1947),两事,notion,0,1,1,0,1,1,0.014081,4,0.275493,0.296238,0
两则(1947),两则,notion,0,2,2,0,2,2,0.012734,4,0.270087,0.287217,736.032122
两君(1947),两君,notion,0,1,1,0,1,1,0.009035,4,0.265075,0.278404,0
两周(1947),两周,notion,0,2,2,0,4,4,0.021039,4,0.286524,0.313766,1874.195629
两周年(1947),两周年,notion,0,2,2,0,2,2,0.027133,4,0.29671,0.328744,1770.9936
两国(1947),两国,notion,0,1,1,0,1,1,0.017323,4,0.281723,0.306272,0
两大(1947),两大,notion,0,2,2,0,3,3,0.022072,4,0.287175,0.314755,862.424175
两头(1947),两头,notion,0,1,1,0,1,1,0.014222,4,0.275404,0.296091,0
两套(1947),两套,notion,0,1,1,0,1,1,0.011229,4,0.270366,0.287632,0
两封信(1947),两封信,notion,0,2,2,0,3,3,0.016457,4,0.27778,0.300034,1514.385671
两年(1947),两年,notion,0,4,4,0,5,5,0.045674,4,0.330749,0.372223,12825.599099
两广(1947),两广,notion,0,1,1,0,1,1,0.017323,4,0.281723,0.306272,0
两方(1947),两方,notion,0,1,1,0,1,1,0.004749,4,0.257108,0.263793,0
两日游(1947),两日游,notion,0,1,1,0,1,1,0.014732,4,0.276453,0.297813,0
两条路(1947),两条路,notion,0,1,1,0,1,1,0.014732,4,0.276453,0.297813,0
两条路线(1947),两条路线,notion,0,2,2,0,2,2,0.024745,4,0.295069,0.3264,2684.608967
两条道路(1947),两条道路,notion,0,1,1,0,1,1,0.017323,4,0.281723,0.306272,0
两极(1947),两极,notion,0,2,2,0,2,2,0.011902,4,0.269703,0.286558,736.093424
两极化(1947),两极化,notion,0,1,1,0,1,1,0.011229,4,0.270366,0.287632,0
两过(1947),两过,notion,0,1,1,0,1,1,0.013711,4,0.275027,0.295469,0
两部(1947),两部,notion,0,1,1,0,1,1,0.003699,4,0.256009,0.261706,0
两面(1947),两面,notion,0,1,1,0,1,1,0.014222,4,0.275404,0.296091,0
两项(1947),两项,notion,0,1,1,0,1,1,0.013711,4,0.275027,0.295469,0
两颗(1947),两颗,notion,0,1,1,0,1,1,0.014732,4,0.276453,0.297813,0
两题(1947),两题,notion,0,1,1,0,1,1,0.007422,4,0.26356,0.275695,0
两首(1947),两首,notion,0,1,1,0,1,1,0.000869,4,0.251131,0.252222,0
严惩(1947),严惩,notion,0,1,1,0,1,1,0.009035,4,0.265075,0.278404,0
严杰(1947),严杰,notion,0,1,1,0,1,1,0.014732,4,0.276453,0.297813,0
严格(1947),严格,notion,0,1,1,0,1,1,0.011229,4,0.270366,0.287632,0
严正(1947),严正,notion,0,1,1,0,1,1,0.014222,4,0.275404,0.296091,0
严然(1947),严然,notion,0,1,1,0,1,1,0.014732,4,0.276453,0.297813,0
严禁(1947),严禁,notion,0,2,2,0,2,2,0.032055,4,0.30624,0.341853,2215.722594
严重(1947),严重,notion,0,7,7,0,9,9,0.077305,4,0.391165,0.430777,36703.386764
丧失(1947),丧失,notion,0,1,1,0,1,1,0.014732,4,0.276453,0.297813,0
个人主义(1947),个人主义,notion,0,2,2,0,2,2,0.027932,4,0.299811,0.333101,2443.455357
中东(1947),中东,notion,0,1,1,0,1,1,0.00981,4,0.267191,0.28214,0
中之(1947),中之,notion,0,1,1,0,1,1,0.014081,4,0.275493,0.296238,0
中产阶级(1947),中产阶级,notion,0,2,2,0,2,2,0.005791,4,0.258785,0.267004,433.712148
中公(1947),中公,notion,0,1,1,0,1,1,0.014222,4,0.275404,0.296091,0
中共(1947),中共,notion,0,5,5,0,8,8,0.064085,4,0.362733,0.405608,17196.453769
中共中央(1947),中共中央,notion,0,1,1,0,2,2,0.013711,4,0.275027,0.295469,0
中区(1947),中区,notion,0,1,1,0,3,3,0.011229,4,0.270366,0.287632,0
中华(1947),中华,notion,0,2,2,0,2,2,0.032055,4,0.30624,0.341853,2215.722594
中华工商(1947),中华工商,notion,0,1,1,0,1,1,0.017323,4,0.281723,0.306272,0
中华民国(1947),中华民国,notion,0,2,2,0,3,3,0.023257,4,0.28761,0.315414,1169.271875
中华民族(1947),中华民族,notion,0,1,1,0,1,1,0.014081,4,0.275493,0.296238,0
中原(1947),中原,notion,0,2,2,0,3,3,0.027791,4,0.29968,0.332918,2405.290268
《展望》,《展望》,journal,27,0,27,30,0,30,0.027146,3,0.334444,0.336312,9422.732214
中国人民解放军(1947),中国人民解放军,notion,0,1,1,0,2,2,0.013711,4,0.275027,0.295469,0
中国共产党(1947),中国共产党,notion,0,2,2,0,4,4,0.022746,4,0.288631,0.316952,1575.703869
中国共产党中央委员会(1947),中国共产党中央委员会,notion,0,1,1,0,1,1,0.013711,4,0.275027,0.295469,0
中国化(1947),中国化,notion,0,1,1,0,1,1,0.014081,4,0.275493,0.296238,0
中国史(1947),中国史,notion,0,1,1,0,1,1,0.014222,4,0.275404,0.296091,0
中国日报(1947),中国日报,notion,0,1,1,0,1,1,0.014222,4,0.275404,0.296091,0
中国民主促进会(1947),中国民主促进会,notion,0,1,1,0,1,1,0.017323,4,0.281723,0.306272,0
中国民主社会党(1947),中国民主社会党,notion,0,1,1,0,3,3,0.009035,4,0.265075,0.278404,0
中国通史(1947),中国通史,notion,0,1,1,0,2,2,0.014222,4,0.275404,0.296091,0
中坚(1947),中坚,notion,0,1,1,0,1,1,0.003699,4,0.256009,0.261706,0
中外(1947),中外,notion,0,2,2,0,2,2,0.031545,4,0.305336,0.340645,2219.908318
中大(1947),中大,notion,0,3,3,0,4,4,0.042263,4,0.32539,0.365937,6975.425387
中央(1947),中央,notion,0,1,1,0,2,2,0.014222,4,0.275404,0.296091,0
中央大学(1947),中央大学,notion,0,4,4,0,6,6,0.046253,4,0.329091,0.370319,8998.507221
中委(1947),中委,notion,0,1,1,0,1,1,0.017323,4,0.281723,0.306272,0
中学(1947),中学,notion,0,2,2,0,3,3,0.031034,4,0.30613,0.341707,2639.595687
中寒(1947),中寒,notion,0,1,1,0,1,1,0.014732,4,0.276453,0.297813,0
中小学(1947),中小学,notion,0,1,1,0,1,1,0.017323,4,0.281723,0.306272,0
中山(1947),中山,notion,0,3,3,0,4,4,0.045766,4,0.331424,0.372931,7043.04865
中心(1947),中心,notion,0,3,3,0,4,4,0.041865,4,0.321892,0.361762,5813.37408
中心站(1947),中心站,notion,0,1,1,0,1,1,0.014222,4,0.275404,0.296091,0
中所(1947),中所,notion,0,2,2,0,2,2,0.027791,4,0.29968,0.332918,2405.290268
中日(1947),中日,notion,0,2,2,0,2,2,0.022072,4,0.287175,0.314755,862.424175
中暹(1947),中暹,notion,0,1,1,0,1,1,0.013711,4,0.275027,0.295469,0
中来(1947),中来,notion,0,2,2,0,7,7,0.02494,4,0.292941,0.323324,1747.290038
中止(1947),中止,notion,0,1,1,0,1,1,0.017323,4,0.281723,0.306272,0
中的(1947),中的,notion,0,2,2,0,2,2,0.028442,4,0.300022,0.333394,2187.730369
中立(1947),中立,notion,0,2,2,0,3,3,0.01741,4,0.280151,0.303843,1198.480437
中篇(1947),中篇,notion,0,1,1,0,1,1,0.017323,4,0.281723,0.306272,0
中纺(1947),中纺,notion,0,1,1,0,1,1,0.014081,4,0.275493,0.296238,0
中统(1947),中统,notion,0,1,1,0,1,1,0.009035,4,0.265075,0.278404,0
中美(1947),中美,notion,0,2,2,0,2,2,0.028302,4,0.298866,0.331783,1965.8222
中苏(1947),中苏,notion,0,2,2,0,4,4,0.027133,4,0.29671,0.328744,1770.9936
中苏间(1947),中苏间,notion,0,1,1,0,1,1,0.014732,4,0.276453,0.297813,0
中英关系(1947),中英关系,notion,0,1,1,0,1,1,0.017323,4,0.281723,0.306272,0
中西文化(1947),中西文化,notion,0,1,1,0,1,1,0.014732,4,0.276453,0.297813,0
中途岛(1947),中途岛,notion,0,1,1,0,1,1,0.014081,4,0.275493,0.296238,0
中间(1947),中间,notion,0,1,1,0,1,1,0.007422,4,0.26356,0.275695,0
中风(1947),中风,notion,0,1,1,0,1,1,0.014732,4,0.276453,0.297813,0
丰厚(1947),丰厚,notion,0,1,1,0,1,1,0.014732,4,0.276453,0.297813,0
丰沛(1947),丰沛,notion,0,1,1,0,1,1,0.017323,4,0.281723,0.306272,0
临别(1947),临别,notion,0,2,2,0,2,2,0.024745,4,0.295069,0.3264,2684.608967
临时(1947),临时,notion,0,3,3,0,3,3,0.038252,4,0.315992,0.354511,5925.791163
临时政府(1947),临时政府,notion,0,1,1,0,1,1,0.017323,4,0.281723,0.306272,0
临末(1947),临末,notion,0,2,2,0,2,2,0.018829,4,0.280473,0.304355,655.354404
临江仙(1947),临江仙,notion,0,1,1,0,1,1,0.017323,4,0.281723,0.306272,0
临近(1947),临近,notion,0,1,1,0,1,1,0.017323,4,0.281723,0.306272,0
丹麦(1947),丹麦,notion,0,1,1,0,1,1,0.00981,4,0.267191,0.28214,0
为丛(1947),为丛,notion,0,1,1,0,1,1,0.017323,4,0.281723,0.306272,0
为二色(1947),为二色,notion,0,1,1,0,1,1,0.00981,4,0.267191,0.28214,0
为何(1947),为何,notion,0,1,1,0,1,1,0.004749,4,0.257108,0.263793,0
为例(1947),为例,notion,0,1,1,0,1,1,0.014732,4,0.276453,0.297813,0
为止(1947),为止,notion,0,1,1,0,1,1,0.014222,4,0.275404,0.296091,0
为民(1947),为民,notion,0,1,1,0,1,1,0.011229,4,0.270366,0.287632,0
为渊驱鱼(1947),为渊驱鱼,notion,0,1,1,0,1,1,0.017323,4,0.281723,0.306272,0
为鉴(1947),为鉴,notion,0,1,1,0,1,1,0.017323,4,0.281723,0.306272,0
主人翁(1947),主人翁,notion,0,1,1,0,1,1,0.011229,4,0.270366,0.287632,0
主任委员(1947),主任委员,notion,0,1,1,0,1,1,0.003588,4,0.255396,0.260534,0
主力(1947),主力,notion,0,1,1,0,1,1,0.013711,4,0.275027,0.295469,0
主动(1947),主动,notion,0,1,1,0,1,1,0.004749,4,0.257108,0.263793,0
主妇(1947),主妇,notion,0,1,1,0,1,1,0.011229,4,0.270366,0.287632,0
主持(1947),主持,notion,0,1,1,0,1,1,0.009035,4,0.265075,0.278404,0
主持人(1947),主持人,notion,0,1,1,0,1,1,0.017323,4,0.281723,0.306272,0
主权(1947),主权,notion,0,1,1,0,1,1,0.011229,4,0.270366,0.287632,0
主演(1947),主演,notion,0,1,1,0,1,1,0.014732,4,0.276453,0.297813,0
主犯(1947),主犯,notion,0,1,1,0,1,1,0.017323,4,0.281723,0.306272,0
主粤(1947),主粤,notion,0,2,2,0,2,2,0.013784,4,0.270451,0.28784,449.976833
主编(1947),主编,notion,0,2,2,0,2,2,0.028302,4,0.298866,0.331783,1965.8222
主要(1947),主要,notion,0,2,2,0,2,2,0.023521,4,0.291018,0.320504,1911.402908
主要矛盾(1947),主要矛盾,notion,0,3,3,0,4,4,0.023069,4,0.285637,0.312473,1740.724546
举例(1947),举例,notion,0,2,2,0,2,2,0.021132,4,0.288412,0.316623,2574.708611
举办(1947),举办,notion,0,4,4,0,6,6,0.034965,4,0.31005,0.346992,8842.036158
举国(1947),举国,notion,0,1,1,0,1,1,0.003699,4,0.256009,0.261706,0
举手(1947),举手,notion,0,1,1,0,1,1,0.014081,4,0.275493,0.296238,0
举足(1947),举足,notion,0,1,1,0,1,1,0.013711,4,0.275027,0.295469,0
举隅(1947),举隅,notion,0,1,1,0,2,2,0.007422,4,0.26356,0.275695,0
义务(1947),义务,notion,0,2,2,0,2,2,0.028954,4,0.300154,0.333577,2064.821066
义大利(1947),义大利,notion,0,1,1,0,2,2,0.00981,4,0.267191,0.28214,0
之七(1947),之七,notion,0,3,3,0,4,4,0.040041,4,0.320772,0.360407,6754.232663
之下(1947),之下,notion,0,2,2,0,2,2,0.016824,4,0.279052,0.302085,1055.66771
之五(1947),之五,notion,0,4,4,0,4,4,0.053752,4,0.345374,0.388226,13094.543338
之什(1947),之什,notion,0,1,1,0,1,1,0.007422,4,0.26356,0.275695,0
之例(1947),之例,notion,0,1,1,0,1,1,0.014081,4,0.275493,0.296238,0
之八(1947),之八,notion,0,3,3,0,3,3,0.040041,4,0.320772,0.360407,6754.232663
之六(1947),之六,notion,0,4,4,0,4,4,0.053752,4,0.345374,0.388226,13094.543338
之内(1947),之内,notion,0,1,1,0,1,1,0.014081,4,0.275493,0.296238,0
之务(1947),之务,notion,0,1,1,0,1,1,0.011229,4,0.270366,0.287632,0
之势(1947),之势,notion,0,2,2,0,2,2,0.027791,4,0.29968,0.332918,2405.290268
之十(1947),之十,notion,0,2,2,0,2,2,0.025961,4,0.295759,0.327389,2231.848602
之半(1947),之半,notion,0,1,1,0,1,1,0.014222,4,0.275404,0.296091,0
之危(1947),之危,notion,0,1,1,0,1,1,0.013711,4,0.275027,0.295469,0
之后(1947),之后,notion,0,4,4,0,7,7,0.056995,4,0.352143,0.395183,13610.726952
之四(1947),之四,notion,0,6,6,0,6,6,0.080111,4,0.397821,0.436063,30527.963055
之城(1947),之城,notion,0,1,1,0,1,1,0.014732,4,0.276453,0.297813,0
之声(1947),之声,notion,0,1,1,0,1,1,0.013711,4,0.275027,0.295469,0
之外(1947),之外,notion,0,2,2,0,2,2,0.021022,4,0.286837,0.314242,1344.24886
之好(1947),之好,notion,0,1,1,0,1,1,0.009035,4,0.265075,0.278404,0
之家(1947),之家,notion,0,2,2,0,2,2,0.021644,4,0.28732,0.314975,1747.667055
之年(1947),之年,notion,0,1,1,0,1,1,0.014222,4,0.275404,0.296091,0
之役(1947),之役,notion,0,1,1,0,1,1,0.014732,4,0.276453,0.297813,0
之忆(1947),之忆,notion,0,1,1,0,1,1,0.007422,4,0.26356,0.275695,0
之我见(1947),之我见,notion,0,1,1,0,1,1,0.009035,4,0.265075,0.278404,0
之战(1947),之战,notion,0,4,4,0,7,7,0.052073,4,0.342085,0.384747,12532.017523
之捷(1947),之捷,notion,0,1,1,0,2,2,0.013711,4,0.275027,0.295469,0
之旗(1947),之旗,notion,0,1,1,0,1,1,0.00981,4,0.267191,0.28214,0
之时(1947),之时,notion,0,1,1,0,1,1,0.004749,4,0.257108,0.263793,0
之望(1947),之望,notion,0,1,1,0,1,1,0.013711,4,0.275027,0.295469,0
之歌(1947),之歌,notion,0,1,1,0,1,1,0.014081,4,0.275493,0.296238,0
之死(1947),之死,notion,0,1,1,0,1,1,0.013711,4,0.275027,0.295469,0
之流(1947),之流,notion,0,2,2,0,2,2,0.028442,4,0.300022,0.333394,2187.730369
之火(1947),之火,notion,0,2,2,0,2,2,0.024032,4,0.290894,0.320321,1695.498775
之爱(1947),之爱,notion,0,1,1,0,1,1,0.014081,4,0.275493,0.296238,0
之献(1947),之献,notion,0,1,1,0,1,1,0.00981,4,0.267191,0.28214,0
之病(1947),之病,notion,0,1,1,0,1,1,0.009035,4,0.265075,0.278404,0
之祸(1947),之祸,notion,0,1,1,0,1,1,0.014222,4,0.275404,0.296091,0
之範围(1947),之範围,notion,0,1,1,0,1,1,0.014222,4,0.275404,0.296091,0
之累(1947),之累,notion,0,1,1,0,1,1,0.014222,4,0.275404,0.296091,0
之翼(1947),之翼,notion,0,1,1,0,1,1,0.014222,4,0.275404,0.296091,0
之苦(1947),之苦,notion,0,1,1,0,1,1,0.014222,4,0.275404,0.296091,0
之行(1947),之行,notion,0,3,3,0,3,3,0.038362,4,0.317019,0.355793,6233.72889
之见(1947),之见,notion,0,1,1,0,1,1,0.014732,4,0.276453,0.297813,0
之言(1947),之言,notion,0,1,1,0,1,1,0.014081,4,0.275493,0.296238,0
之话(1947),之话,notion,0,1,1,0,4,4,0.007422,4,0.26356,0.275695,0
之谜(1947),之谜,notion,0,3,3,0,3,3,0.037989,4,0.312577,0.35019,4686.279145
之路(1947),之路,notion,0,5,5,0,6,6,0.031004,4,0.301933,0.336214,7100.154015
之路吗(1947),之路吗,notion,0,1,1,0,1,1,0.013711,4,0.275027,0.295469,0
之途(1947),之途,notion,0,1,1,0,1,1,0.002092,4,0.25318,0.25625,0
之道(1947),之道,notion,0,3,3,0,9,9,0.030679,4,0.300048,0.333492,4431.324601
之邦(1947),之邦,notion,0,1,1,0,1,1,0.013711,4,0.275027,0.295469,0
之门(1947),之门,notion,0,2,2,0,2,2,0.016314,4,0.277757,0.299998,853.020505
之间(1947),之间,notion,0,6,6,0,9,9,0.068311,4,0.369326,0.411821,24737.174952
之难(1947),之难,notion,0,1,1,0,1,1,0.009035,4,0.265075,0.278404,0
之页(1947),之页,notion,0,1,1,0,3,3,0.014222,4,0.275404,0.296091,0
之鬥争(1947),之鬥争,notion,0,1,1,0,1,1,0.014222,4,0.275404,0.296091,0
之魂(1947),之魂,notion,0,1,1,0,3,3,0.00981,4,0.267191,0.28214,0
乌克兰(1947),乌克兰,notion,0,1,1,0,1,1,0.00981,4,0.267191,0.28214,0
乌烟瘴气(1947),乌烟瘴气,notion,0,2,2,0,2,2,0.025961,4,0.295759,0.327389,2231.848602
乌瞰(1947),乌瞰,notion,0,1,1,0,1,1,0.014081,4,0.275493,0.296238,0
乐传(1947),乐传,notion,0,1,1,0,1,1,0.014222,4,0.275404,0.296091,0
乐园(1947),乐园,notion,0,3,3,0,3,3,0.034555,4,0.310445,0.347444,6246.60752
乐坛(1947),乐坛,notion,0,1,1,0,1,1,0.014732,4,0.276453,0.297813,0
乐观(1947),乐观,notion,0,2,2,0,3,3,0.028442,4,0.300022,0.333394,2187.730369
乐趣(1947),乐趣,notion,0,1,1,0,1,1,0.014222,4,0.275404,0.296091,0
乔夫(1947),乔夫,notion,0,1,1,0,1,1,0.000869,4,0.251131,0.252222,0
乔治(1947),乔治,notion,0,2,2,0,2,2,0.024032,4,0.290894,0.320321,1695.498775
乘风(1947),乘风,notion,0,1,1,0,1,1,0.014081,4,0.275493,0.296238,0
九一八(1947),九一八,notion,0,3,3,0,5,5,0.045766,4,0.331424,0.372931,7043.04865
九万(1947),九万,notion,0,1,1,0,1,1,0.003699,4,0.256009,0.261706,0
九十九年(1947),九十九年,notion,0,1,1,0,1,1,0.014222,4,0.275404,0.296091,0
九国(1947),九国,notion,0,2,2,0,2,2,0.027133,4,0.29671,0.328744,1770.9936
九神(1947),九神,notion,0,1,1,0,1,1,0.003699,4,0.256009,0.261706,0
乞丐(1947),乞丐,notion,0,1,1,0,1,1,0.004749,4,0.257108,0.263793,0
乞灵(1947),乞灵,notion,0,1,1,0,1,1,0.014732,4,0.276453,0.297813,0
习作(1947),习作,notion,0,1,1,0,1,1,0.011229,4,0.270366,0.287632,0
习惯(1947),习惯,notion,0,1,1,0,1,1,0.007422,4,0.26356,0.275695,0
乡农(1947),乡农,notion,0,1,1,0,1,1,0.007422,4,0.26356,0.275695,0
乡建(1947),乡建,notion,0,1,1,0,1,1,0.007422,4,0.26356,0.275695,0
乡村(1947),乡村,notion,0,5,5,0,6,6,0.051207,4,0.33782,0.380194,17701.235591
书刊(1947),书刊,notion,0,1,1,0,1,1,0.007422,4,0.26356,0.275695,0
书后(1947),书后,notion,0,1,1,0,1,1,0.009035,4,0.265075,0.278404,0
书库(1947),书库,notion,0,1,1,0,1,1,0.007422,4,0.26356,0.275695,0
书店(1947),书店,notion,0,1,1,0,1,1,0.014732,4,0.276453,0.297813,0
书法(1947),书法,notion,0,1,1,0,1,1,0.00981,4,0.267191,0.28214,0
书籍(1947),书籍,notion,0,1,1,0,1,1,0.017323,4,0.281723,0.306272,0
书面声明(1947),书面声明,notion,0,1,1,0,1,1,0.017323,4,0.281723,0.306272,0
买卖(1947),买卖,notion,0,2,2,0,3,3,0.02494,4,0.292941,0.323324,1747.290038
乱舞(1947),乱舞,notion,0,1,1,0,1,1,0.013711,4,0.275027,0.295469,0
乱萌(1947),乱萌,notion,0,1,1,0,1,1,0.011229,4,0.270366,0.287632,0
乾儿子(1947),乾儿子,notion,0,1,1,0,1,1,0.013711,4,0.275027,0.295469,0
乾爸爸(1947),乾爸爸,notion,0,1,1,0,1,1,0.013711,4,0.275027,0.295469,0
了吗(1947),了吗,notion,0,1,1,0,1,1,0.013711,4,0.275027,0.295469,0
了结(1947),了结,notion,0,1,1,0,1,1,0.013711,4,0.275027,0.295469,0
了解(1947),了解,notion,0,3,3,0,5,5,0.020931,4,0.285231,0.31185,3907.097001
予日(1947),予日,notion,0,1,1,0,1,1,0.009035,4,0.265075,0.278404,0
争取和平(1947),争取和平,notion,0,2,2,0,4,4,0.008337,4,0.261721,0.272423,277.124936
争执(1947),争执,notion,0,1,1,0,1,1,0.017323,4,0.281723,0.306272,0
争斗(1947),争斗,notion,0,1,1,0,1,1,0.011229,4,0.270366,0.287632,0
争食(1947),争食,notion,0,2,2,0,2,2,0.023767,4,0.289685,0.318527,1452.186204
事例(1947),事例,notion,0,1,1,0,1,1,0.014222,4,0.275404,0.296091,0
事务(1947),事务,notion,0,1,1,0,2,2,0.007422,4,0.26356,0.275695,0
事务官(1947),事务官,notion,0,1,1,0,1,1,0.014222,4,0.275404,0.296091,0
事变(1947),事变,notion,0,1,1,0,1,1,0.011229,4,0.270366,0.287632,0
事处(1947),事处,notion,0,1,1,0,1,1,0.007422,4,0.26356,0.275695,0
事实(1947),事实,notion,0,2,2,0,2,2,0.028812,4,0.299917,0.333248,2025.61524
事工(1947),事工,notion,0,1,1,0,4,4,0.007422,4,0.26356,0.275695,0
事致(1947),事致,notion,0,1,1,0,1,1,0.009035,4,0.265075,0.278404,0
事项(1947),事项,notion,0,1,1,0,2,2,0.007422,4,0.26356,0.275695,0
二七(1947),二七,notion,0,1,1,0,1,1,0.009035,4,0.265075,0.278404,0
二个(1947),二个,notion,0,1,1,0,1,1,0.011229,4,0.270366,0.287632,0
二中全会(1947),二中全会,notion,0,1,1,0,1,1,0.003588,4,0.255396,0.260534,0
二九(1947),二九,notion,0,1,1,0,1,1,0.009035,4,0.265075,0.278404,0
二二八(1947),二二八,notion,0,1,1,0,1,1,0.009035,4,0.265075,0.278404,0
二五(1947),二五,notion,0,5,5,0,5,5,0.049436,4,0.333366,0.37525,12946.553501
二八(1947),二八,notion,0,2,2,0,2,2,0.022746,4,0.288631,0.316952,1575.703869
二六(1947),二六,notion,0,1,1,0,1,1,0.009035,4,0.265075,0.278404,0
二十(1947),二十,notion,0,1,1,0,1,1,0.009035,4,0.265075,0.278404,0
二十三(1947),二十三,notion,0,1,1,0,2,2,0.00981,4,0.267191,0.28214,0
二十三条(1947),二十三条,notion,0,1,1,0,1,1,0.013711,4,0.275027,0.295469,0
二十九(1947),二十九,notion,0,1,1,0,2,2,0.00981,4,0.267191,0.28214,0
二十元(1947),二十元,notion,0,1,1,0,1,1,0.014732,4,0.276453,0.297813,0
二十八(1947),二十八,notion,0,1,1,0,2,2,0.014081,4,0.275493,0.296238,0
二十六(1947),二十六,notion,0,1,1,0,1,1,0.013711,4,0.275027,0.295469,0
二十大(1947),二十大,notion,0,1,1,0,1,1,0.013711,4,0.275027,0.295469,0
二十天(1947),二十天,notion,0,1,1,0,1,1,0.013711,4,0.275027,0.295469,0
二十年(1947),二十年,notion,0,2,2,0,2,2,0.019415,4,0.284233,0.310251,1126.485279
二十页(1947),二十页,notion,0,1,1,0,1,1,0.014081,4,0.275493,0.296238,0
二卷(1947),二卷,notion,0,1,1,0,1,1,0.014081,4,0.275493,0.296238,0
二周(1947),二周,notion,0,1,1,0,1,1,0.014732,4,0.276453,0.297813,0
二四(1947),二四,notion,0,1,1,0,1,1,0.009035,4,0.265075,0.278404,0
二婶(1947),二婶,notion,0,1,1,0,1,1,0.011229,4,0.270366,0.287632,0
二届(1947),二届,notion,0,1,1,0,1,1,0.014222,4,0.275404,0.296091,0
二年(1947),二年,notion,0,2,2,0,2,2,0.024542,4,0.292264,0.322335,1826.657886
二度(1947),二度,notion,0,1,1,0,1,1,0.009035,4,0.265075,0.278404,0
二次(1947),二次,notion,0,1,1,0,2,2,0.011229,4,0.270366,0.287632,0
二续(1947),二续,notion,0,1,1,0,1,1,0.007422,4,0.26356,0.275695,0
二者(1947),二者,notion,0,1,1,0,1,1,0.014732,4,0.276453,0.297813,0
二至(1947),二至,notion,0,1,1,0,1,1,0.014222,4,0.275404,0.296091,0
二重(1947),二重,notion,0,1,1,0,1,1,0.014732,4,0.276453,0.297813,0
二面(1947),二面,notion,0,1,1,0,1,1,0.009035,4,0.265075,0.278404,0
于斌主(1947),于斌主,notion,0,1,1,0,1,1,0.013711,4,0.275027,0.295469,0
于求(1947),于求,notion,0,1,1,0,1,1,0.007422,4,0.26356,0.275695,0
云和月(1947),云和月,notion,0,1,1,0,2,2,0.003699,4,0.256009,0.261706,0
云霓(1947),云霓,notion,0,1,1,0,1,1,0.013711,4,0.275027,0.295469,0
互助(1947),互助,notion,0,1,1,0,1,1,0.014222,4,0.275404,0.296091,0
互助会(1947),互助会,notion,0,1,1,0,1,1,0.014081,4,0.275493,0.296238,0
互斗(1947),互斗,notion,0,1,1,0,1,1,0.014732,4,0.276453,0.297813,0
五一(1947),五一,notion,0,3,3,0,3,3,0.035354,4,0.312692,0.350337,6765.831022
五一劳动节(1947),五一劳动节,notion,0,1,1,0,1,1,0.00981,4,0.267191,0.28214,0
五一节(1947),五一节,notion,0,1,1,0,2,2,0.014222,4,0.275404,0.296091,0
五个(1947),五个,notion,0,1,1,0,1,1,0.013711,4,0.275027,0.295469,0
五五(1947),五五,notion,0,1,1,0,1,1,0.00981,4,0.267191,0.28214,0
五十万(1947),五十万,notion,0,1,1,0,1,1,0.003588,4,0.255396,0.260534,0
五十五年(1947),五十五年,notion,0,1,1,0,1,1,0.014222,4,0.275404,0.296091,0
五十年(1947),五十年,notion,0,1,1,0,1,1,0.014732,4,0.276453,0.297813,0
五千元(1947),五千元,notion,0,1,1,0,1,1,0.014081,4,0.275493,0.296238,0
五四运动(1947),五四运动,notion,0,4,4,0,6,6,0.042531,4,0.321528,0.361384,8038.176468
五年(1947),五年,notion,0,3,3,0,4,4,0.024738,4,0.29169,0.321554,3998.436141
五年计划(1947),五年计划,notion,0,2,2,0,4,4,0.010679,4,0.267904,0.283446,381.923704
五彩(1947),五彩,notion,0,1,1,0,1,1,0.014732,4,0.276453,0.297813,0
五时作(1947),五时作,notion,0,1,1,0,1,1,0.017323,4,0.281723,0.306272,0
五期(1947),五期,notion,0,1,1,0,1,1,0.014081,4,0.275493,0.296238,0
五校(1947),五校,notion,0,1,1,0,1,1,0.017323,4,0.281723,0.306272,0
五种(1947),五种,notion,0,1,1,0,1,1,0.014081,4,0.275493,0.296238,0
五项(1947),五项,notion,0,2,2,0,2,2,0.024745,4,0.295069,0.3264,2684.608967
五龙(1947),五龙,notion,0,1,1,0,1,1,0.007422,4,0.26356,0.275695,0
亚利明(1947),亚利明,notion,0,1,1,0,1,1,0.017323,4,0.281723,0.306272,0
些什(1947),些什,notion,0,1,1,0,1,1,0.013711,4,0.275027,0.295469,0
亡国(1947),亡国,notion,0,1,1,0,1,1,0.014732,4,0.276453,0.297813,0
交响曲(1947),交响曲,notion,0,1,1,0,1,1,0.017323,4,0.281723,0.306272,0
交换(1947),交换,notion,0,1,1,0,1,1,0.00981,4,0.267191,0.28214,0
交涉(1947),交涉,notion,0,1,1,0,1,1,0.014222,4,0.275404,0.296091,0
交相辉映(1947),交相辉映,notion,0,1,1,0,1,1,0.013711,4,0.275027,0.295469,0
交迫(1947),交迫,notion,0,1,1,0,1,1,0.011229,4,0.270366,0.287632,0
亦非(1947),亦非,notion,0,1,1,0,1,1,0.017323,4,0.281723,0.306272,0
产业(1947),产业,notion,0,2,2,0,2,2,0.031404,4,0.30602,0.34156,2430.025091
亨利(1947),亨利,notion,0,1,1,0,1,1,0.004749,4,0.257108,0.263793,0
京中(1947),京中,notion,0,1,1,0,1,1,0.014222,4,0.275404,0.296091,0
京沪(1947),京沪,notion,0,1,1,0,2,2,0.017323,4,0.281723,0.306272,0
亲任(1947),亲任,notion,0,1,1,0,1,1,0.014222,4,0.275404,0.296091,0
亲友(1947),亲友,notion,0,1,1,0,1,1,0.017323,4,0.281723,0.306272,0
亲子(1947),亲子,notion,0,1,1,0,1,1,0.013711,4,0.275027,0.295469,0
亲帝(1947),亲帝,notion,0,1,1,0,1,1,0.014732,4,0.276453,0.297813,0
亲疏(1947),亲疏,notion,0,1,1,0,1,1,0.013711,4,0.275027,0.295469,0
亲美反(1947),亲美反,notion,0,1,1,0,1,1,0.009035,4,0.265075,0.278404,0
亲苏(1947),亲苏,notion,0,2,2,0,2,2,0.023116,4,0.288412,0.316623,1358.22258
人之狱(1947),人之狱,notion,0,1,1,0,1,1,0.003699,4,0.256009,0.261706,0
人事(1947),人事,notion,0,2,2,0,6,6,0.021644,4,0.28732,0.314975,1747.667055
人事室(1947),人事室,notion,0,1,1,0,1,1,0.014222,4,0.275404,0.296091,0
人事管理(1947),人事管理,notion,0,1,1,0,1,1,0.014222,4,0.275404,0.296091,0
人人自危(1947),人人自危,notion,0,1,1,0,1,1,0.013711,4,0.275027,0.295469,0
人们(1947),人们,notion,0,3,3,0,4,4,0.039671,4,0.318706,0.35788,6166.869009
人伦(1947),人伦,notion,0,1,1,0,1,1,0.014222,4,0.275404,0.296091,0
人口普查(1947),人口普查,notion,0,1,1,0,1,1,0.014222,4,0.275404,0.296091,0
人员(1947),人员,notion,0,2,2,0,3,3,0.028302,4,0.298866,0.331783,1965.8222
人命(1947),人命,notion,0,1,1,0,1,1,0.014081,4,0.275493,0.296238,0
人品(1947),人品,notion,0,1,1,0,1,1,0.014222,4,0.275404,0.296091,0
人士(1947),人士,notion,0,1,1,0,1,1,0.017323,4,0.281723,0.306272,0
人头(1947),人头,notion,0,1,1,0,1,1,0.003699,4,0.256009,0.261706,0
人市(1947),人市,notion,0,1,1,0,1,1,0.014732,4,0.276453,0.297813,0
人心(1947),人心,notion,0,4,4,0,6,6,0.056745,4,0.35084,0.393865,13092.7345
人心惟危(1947),人心惟危,notion,0,1,1,0,1,1,0.013711,4,0.275027,0.295469,0
人心所向(1947),人心所向,notion,0,1,1,0,1,1,0.013711,4,0.275027,0.295469,0
人性(1947),人性,notion,0,3,3,0,10,10,0.030538,4,0.301346,0.335286,5118.229782
人情味(1947),人情味,notion,0,1,1,0,1,1,0.014732,4,0.276453,0.297813,0
人才(1947),人才,notion,0,2,2,0,2,2,0.031404,4,0.30602,0.34156,2430.025091
人文(1947),人文,notion,0,1,1,0,1,1,0.014081,4,0.275493,0.296238,0
人文主义(1947),人文主义,notion,0,1,1,0,1,1,0.011229,4,0.270366,0.287632,0
人格(1947),人格,notion,0,1,1,0,1,1,0.014222,4,0.275404,0.296091,0
人民武装(1947),人民武装,notion,0,2,2,0,8,8,0.02494,4,0.292941,0.323324,1747.290038
人民解放军(1947),人民解放军,notion,0,1,1,0,4,4,0.013711,4,0.275027,0.295469,0
人治(1947),人治,notion,0,1,1,0,1,1,0.014222,4,0.275404,0.296091,0
人海中(1947),人海中,notion,0,1,1,0,1,1,0.014222,4,0.275404,0.296091,0
人物(1947),人物,notion,0,6,6,0,7,7,0.075189,4,0.386077,0.426505,29171.76128
人物画(1947),人物画,notion,0,1,1,0,2,2,0.00981,4,0.267191,0.28214,0
人生(1947),人生,notion,0,4,4,0,5,5,0.040103,4,0.318231,0.357356,9199.112142
人生观(1947),人生观,notion,0,2,2,0,2,2,0.028302,4,0.298866,0.331783,1965.8222
人类(1947),人类,notion,0,4,4,0,4,4,0.055945,4,0.348156,0.391119,12385.920805
人质(1947),人质,notion,0,1,1,0,1,1,0.011229,4,0.270366,0.287632,0
人身自由(1947),人身自由,notion,0,1,1,0,1,1,0.014081,4,0.275493,0.296238,0
人过(1947),人过,notion,0,1,1,0,1,1,0.009035,4,0.265075,0.278404,0
人选(1947),人选,notion,0,1,1,0,1,1,0.014081,4,0.275493,0.296238,0
人造(1947),人造,notion,0,1,1,0,1,1,0.003699,4,0.256009,0.261706,0
人遭(1947),人遭,notion,0,1,1,0,1,1,0.014732,4,0.276453,0.297813,0
人间(1947),人间,notion,0,1,1,0,1,1,0.009035,4,0.265075,0.278404,0
什么样(1947),什么样,notion,0,1,1,0,1,1,0.002092,4,0.25318,0.25625,0
什剧(1947),什剧,notion,0,1,1,0,1,1,0.011229,4,0.270366,0.287632,0
什给(1947),什给,notion,0,1,1,0,1,1,0.011229,4,0.270366,0.287632,0
仁义(1947),仁义,notion,0,1,1,0,1,1,0.014732,4,0.276453,0.297813,0
仁慈(1947),仁慈,notion,0,1,1,0,1,1,0.017323,4,0.281723,0.306272,0
仅见(1947),仅见,notion,0,1,1,0,1,1,0.011229,4,0.270366,0.287632,0
仇恨(1947),仇恨,notion,0,2,2,0,3,3,0.021132,4,0.288412,0.316623,2574.708611
今之丘(1947),今之丘,notion,0,1,1,0,1,1,0.014732,4,0.276453,0.297813,0
今后(1947),今后,notion,0,9,9,0,11,11,0.106503,4,0.456869,0.476857,64029.715723
今天(1947),今天,notion,0,6,6,0,9,9,0.067471,4,0.370208,0.412626,25302.777786
今年(1947),今年,notion,0,5,5,0,7,7,0.058322,4,0.350804,0.393889,18434.549659
今朝(1947),今朝,notion,0,1,1,0,1,1,0.014081,4,0.275493,0.296238,0
仍烈(1947),仍烈,notion,0,1,1,0,1,1,0.017323,4,0.281723,0.306272,0
从严办理(1947),从严办理,notion,0,1,1,0,1,1,0.011229,4,0.270366,0.287632,0
从事(1947),从事,notion,0,1,1,0,1,1,0.017323,4,0.281723,0.306272,0
从北(1947),从北,notion,0,1,1,0,1,1,0.014081,4,0.275493,0.296238,0
从吾乡(1947),从吾乡,notion,0,1,1,0,1,1,0.009035,4,0.265075,0.278404,0
从宽办理(1947),从宽办理,notion,0,1,1,0,1,1,0.011229,4,0.270366,0.287632,0
从此(1947),从此,notion,0,2,2,0,2,2,0.031034,4,0.30613,0.341707,2639.595687
从略(1947),从略,notion,0,1,1,0,1,1,0.017323,4,0.281723,0.306272,0
从而(1947),从而,notion,0,1,1,0,6,6,0.007422,4,0.26356,0.275695,0
从马(1947),从马,notion,0,1,1,0,1,1,0.011229,4,0.270366,0.287632,0
仓库(1947),仓库,notion,0,1,1,0,1,1,0.007422,4,0.26356,0.275695,0
他人(1947),他人,notion,0,1,1,0,1,1,0.013711,4,0.275027,0.295469,0
他山之石(1947),他山之石,notion,0,1,1,0,2,2,0.017323,4,0.281723,0.306272,0
他的(1947),他的,notion,0,1,1,0,1,1,0.011229,4,0.270366,0.287632,0
他见(1947),他见,notion,0,1,1,0,1,1,0.014081,4,0.275493,0.296238,0
付与(1947),付与,notion,0,1,1,0,1,1,0.011229,4,0.270366,0.287632,0
仙方(1947),仙方,notion,0,1,1,0,1,1,0.011229,4,0.270366,0.287632,0
仡佬(1947),仡佬,notion,0,1,1,0,1,1,0.014222,4,0.275404,0.296091,0
代价(1947),代价,notion,0,1,1,0,1,1,0.014732,4,0.276453,0.297813,0
代办(1947),代办,notion,0,1,1,0,1,1,0.007422,4,0.26356,0.275695,0
代替(1947),代替,notion,0,2,2,0,2,2,0.028954,4,0.300154,0.333577,2064.821066
代理(1947),代理,notion,0,1,1,0,1,1,0.014081,4,0.275493,0.296238,0
代表团(1947),代表团,notion,0,1,1,0,1,1,0.013711,4,0.275027,0.295469,0
令人费解(1947),令人费解,notion,0,1,1,0,1,1,0.014081,4,0.275493,0.296238,0
以不变应万变(1947),以不变应万变,notion,0,1,1,0,1,1,0.007422,4,0.26356,0.275695,0
以不广(1947),以不广,notion,0,1,1,0,1,1,0.014732,4,0.276453,0.297813,0
以切(1947),以切,notion,0,1,1,0,1,1,0.014081,4,0.275493,0.296238,0
以前(1947),以前,notion,0,1,1,0,1,1,0.014732,4,0.276453,0.297813,0
以南(1947),以南,notion,0,1,1,0,1,1,0.014732,4,0.276453,0.297813,0
以及(1947),以及,notion,0,1,1,0,1,1,0.007422,4,0.26356,0.275695,0
以后(1947),以后,notion,0,10,10,0,22,22,0.107435,4,0.4597,0.478602,72265.403007
以救(1947),以救,notion,0,1,1,0,1,1,0.009035,4,0.265075,0.278404,0
以来(1947),以来,notion,0,2,2,0,3,3,0.013321,4,0.273004,0.292161,986.216711
以死(1947),以死,notion,0,1,1,0,1,1,0.014222,4,0.275404,0.296091,0
以身作则(1947),以身作则,notion,0,2,2,0,2,2,0.021502,4,0.288388,0.316586,2245.621531
仰光(1947),仰光,notion,0,1,1,0,1,1,0.013711,4,0.275027,0.295469,0
仰慰(1947),仰慰,notion,0,1,1,0,1,1,0.017323,4,0.281723,0.306272,0
价值(1947),价值,notion,0,3,3,0,5,5,0.045626,4,0.330014,0.37132,6615.755609
价格(1947),价格,notion,0,1,1,0,1,1,0.014081,4,0.275493,0.296238,0
任何一方(1947),任何一方,notion,0,1,1,0,1,1,0.009035,4,0.265075,0.278404,0
任命(1947),任命,notion,0,1,1,0,1,1,0.00981,4,0.267191,0.28214,0
任用(1947),任用,notion,0,1,1,0,1,1,0.014222,4,0.275404,0.296091,0
份子(1947),份子,notion,0,3,3,0,5,5,0.036827,4,0.312749,0.35041,5339.216716
企业(1947),企业,notion,0,2,2,0,2,2,0.031404,4,0.30602,0.34156,2430.025091
企图(1947),企图,notion,0,1,1,0,2,2,0.00981,4,0.267191,0.28214,0
企待(1947),企待,notion,0,1,1,0,1,1,0.013711,4,0.275027,0.295469,0
伊凡(1947),伊凡,notion,0,1,1,0,1,1,0.00981,4,0.267191,0.28214,0
伊朗(1947),伊朗,notion,0,1,1,0,1,1,0.00981,4,0.267191,0.28214,0
伊里奇(1947),伊里奇,notion,0,1,1,0,1,1,0.014222,4,0.275404,0.296091,0
伎俩(1947),伎俩,notion,0,1,1,0,1,1,0.013711,4,0.275027,0.295469,0
伐木(1947),伐木,notion,0,1,1,0,1,1,0.00981,4,0.267191,0.28214,0
休姆(1947),休姆,notion,0,1,1,0,1,1,0.014732,4,0.276453,0.297813,0
休息权(1947),休息权,notion,0,1,1,0,1,1,0.00981,4,0.267191,0.28214,0
休曼(1947),休曼,notion,0,1,1,0,1,1,0.017323,4,0.281723,0.306272,0
休谟(1947),休谟,notion,0,1,1,0,1,1,0.014222,4,0.275404,0.296091,0
优待(1947),优待,notion,0,1,1,0,1,1,0.014081,4,0.275493,0.296238,0
优点(1947),优点,notion,0,1,1,0,1,1,0.00981,4,0.267191,0.28214,0
优畜(1947),优畜,notion,0,1,1,0,1,1,0.007422,4,0.26356,0.275695,0
优良(1947),优良,notion,0,1,1,0,1,1,0.014222,4,0.275404,0.296091,0
伙伴(1947),伙伴,notion,0,1,1,0,1,1,0.011229,4,0.270366,0.287632,0
会上(1947),会上,notion,0,2,2,0,2,2,0.012624,4,0.269533,0.286265,548.418626
会员(1947),会员,notion,0,1,1,0,1,1,0.00981,4,0.267191,0.28214,0
会师(1947),会师,notion,0,1,1,0,1,1,0.013711,4,0.275027,0.295469,0
会晤(1947),会晤,notion,0,1,1,0,1,1,0.017323,4,0.281723,0.306272,0
会涨(1947),会涨,notion,0,1,1,0,1,1,0.004749,4,0.257108,0.263793,0
会稽(1947),会稽,notion,0,1,1,0,1,1,0.014732,4,0.276453,0.297813,0
会考(1947),会考,notion,0,1,1,0,2,2,0.017323,4,0.281723,0.306272,0
会见(1947),会见,notion,0,2,2,0,4,4,0.02494,4,0.292941,0.323324,1747.290038
会谈(1947),会谈,notion,0,1,1,0,1,1,0.017323,4,0.281723,0.306272,0
伟业(1947),伟业,notion,0,1,1,0,1,1,0.014222,4,0.275404,0.296091,0
伟人(1947),伟人,notion,0,1,1,0,1,1,0.017323,4,0.281723,0.306272,0
伟大胜利(1947),伟大胜利,notion,0,1,1,0,1,1,0.00981,4,0.267191,0.28214,0
传到(1947),传到,notion,0,1,1,0,1,1,0.013711,4,0.275027,0.295469,0
传单(1947),传单,notion,0,2,2,0,2,2,0.021022,4,0.286837,0.314242,1344.24886
传奇(1947),传奇,notion,0,2,2,0,2,2,0.021039,4,0.286524,0.313766,1874.195629
传记(1947),传记,notion,0,1,1,0,2,2,0.014222,4,0.275404,0.296091,0
伤者(1947),伤者,notion,0,1,1,0,1,1,0.009035,4,0.265075,0.278404,0
伦理(1947),伦理,notion,0,1,1,0,1,1,0.007422,4,0.26356,0.275695,0
伪装(1947),伪装,notion,0,1,1,0,1,1,0.003588,4,0.255396,0.260534,0
估定(1947),估定,notion,0,1,1,0,1,1,0.014732,4,0.276453,0.297813,0
估计(1947),估计,notion,0,2,2,0,2,2,0.023116,4,0.288412,0.316623,1358.22258
伸出(1947),伸出,notion,0,1,1,0,1,1,0.011229,4,0.270366,0.287632,0
似是而非(1947),似是而非,notion,0,1,1,0,1,1,0.017323,4,0.281723,0.306272,0
似的(1947),似的,notion,0,1,1,0,1,1,0.009035,4,0.265075,0.278404,0
但愿(1947),但愿,notion,0,1,1,0,1,1,0.014222,4,0.275404,0.296091,0
但是(1947),但是,notion,0,1,1,0,1,1,0.011229,4,0.270366,0.287632,0
低利(1947),低利,notion,0,1,1,0,1,1,0.003699,4,0.256009,0.261706,0
低气压(1947),低气压,notion,0,2,2,0,2,2,0.028812,4,0.299917,0.333248,2025.61524
低潮(1947),低潮,notion,0,2,2,0,2,2,0.028302,4,0.298866,0.331783,1965.8222
低能(1947),低能,notion,0,2,2,0,2,2,0.021644,4,0.28732,0.314975,1747.667055
低落(1947),低落,notion,0,3,3,0,3,3,0.046277,4,0.33091,0.372345,6500.451978
住吗(1947),住吗,notion,0,1,1,0,1,1,0.013711,4,0.275027,0.295469,0
体育(1947),体育,notion,0,1,1,0,2,2,0.00981,4,0.267191,0.28214,0
体育节(1947),体育节,notion,0,1,1,0,1,1,0.00981,4,0.267191,0.28214,0
何不(1947),何不,notion,0,1,1,0,1,1,0.014732,4,0.276453,0.297813,0
何为(1947),何为,notion,0,2,2,0,2,2,0.01832,4,0.280681,0.304685,795.39908
何以(1947),何以,notion,0,4,4,0,5,5,0.055171,4,0.344572,0.387383,11043.264417
何去何从(1947),何去何从,notion,0,1,1,0,1,1,0.017323,4,0.281723,0.306272,0
何在(1947),何在,notion,0,1,1,0,1,1,0.009035,4,0.265075,0.278404,0
何必(1947),何必,notion,0,2,2,0,2,2,0.027791,4,0.29968,0.332918,2405.290268
何日(1947),何日,notion,0,1,1,0,1,1,0.009035,4,0.265075,0.278404,0
何时(1947),何时,notion,0,1,1,0,1,1,0.004749,4,0.257108,0.263793,0
何永佶(1947),何永佶,notion,0,1,1,0,1,1,0.009035,4,0.265075,0.278404,0
何求(1947),何求,notion,0,1,1,0,1,1,0.017323,4,0.281723,0.306272,0
何种(1947),何种,notion,0,1,1,0,1,1,0.014081,4,0.275493,0.296238,0
何苦乃尔(1947),何苦乃尔,notion,0,1,1,0,1,1,0.017323,4,0.281723,0.306272,0
何香凝(1947),何香凝,notion,0,1,1,0,1,1,0.017323,4,0.281723,0.306272,0
余孽(1947),余孽,notion,0,1,1,0,1,1,0.00981,4,0.267191,0.28214,0
余波(1947),余波,notion,0,1,1,0,1,1,0.011229,4,0.270366,0.287632,0
余音袅袅(1947),余音袅袅,notion,0,1,1,0,1,1,0.011229,4,0.270366,0.287632,0
佛光(1947),佛光,notion,0,1,1,0,1,1,0.014222,4,0.275404,0.296091,0
佛灯(1947),佛灯,notion,0,1,1,0,1,1,0.014222,4,0.275404,0.296091,0
作品(1947),作品,notion,0,1,1,0,2,2,0.014732,4,0.276453,0.297813,0
作战(1947),作战,notion,0,1,1,0,1,1,0.014081,4,0.275493,0.296238,0
作爲(1947),作爲,notion,0,1,1,0,1,1,0.014222,4,0.275404,0.296091,0
作用(1947),作用,notion,0,4,4,0,4,4,0.050884,4,0.335463,0.377533,8857.342035
作箭巴(1947),作箭巴,notion,0,1,1,0,1,1,0.013711,4,0.275027,0.295469,0
作风(1947),作风,notion,0,5,5,0,7,7,0.048348,4,0.329123,0.370416,13222.430828
佳作(1947),佳作,notion,0,1,1,0,5,5,0.014732,4,0.276453,0.297813,0
使用(1947),使用,notion,0,1,1,0,1,1,0.014081,4,0.275493,0.296238,0
使者(1947),使者,notion,0,1,1,0,1,1,0.002092,4,0.25318,0.25625,0
供售(1947),供售,notion,0,1,1,0,1,1,0.007422,4,0.26356,0.275695,0
供应(1947),供应,notion,0,1,1,0,1,1,0.007422,4,0.26356,0.275695,0
供销(1947),供销,notion,0,1,1,0,1,1,0.007422,4,0.26356,0.275695,0
依照(1947),依照,notion,0,1,1,0,1,1,0.00981,4,0.267191,0.28214,0
依靠(1947),依靠,notion,0,1,1,0,1,1,0.013711,4,0.275027,0.295469,0
侧写(1947),侧写,notion,0,2,2,0,4,4,0.025451,4,0.295094,0.326437,2353.768712
侧面(1947),侧面,notion,0,2,2,0,2,2,0.027791,4,0.29968,0.332918,2405.290268
侨眷(1947),侨眷,notion,0,1,1,0,1,1,0.014081,4,0.275493,0.296238,0
侮辱(1947),侮辱,notion,0,1,1,0,1,1,0.017323,4,0.281723,0.306272,0
侵入(1947),侵入,notion,0,1,1,0,1,1,0.00981,4,0.267191,0.28214,0
侵占(1947),侵占,notion,0,1,1,0,1,1,0.013711,4,0.275027,0.295469,0
侵吞(1947),侵吞,notion,0,1,1,0,1,1,0.011229,4,0.270366,0.287632,0
侵犯(1947),侵犯,notion,0,1,1,0,1,1,0.00981,4,0.267191,0.28214,0
侵略(1947),侵略,notion,0,1,1,0,3,3,0.00981,4,0.267191,0.28214,0
侵略者(1947),侵略者,notion,0,1,1,0,1,1,0.00981,4,0.267191,0.28214,0
促成(1947),促成,notion,0,2,2,0,2,2,0.016314,4,0.277757,0.299998,853.020505
促进(1947),促进,notion,0,1,1,0,2,2,0.014222,4,0.275404,0.296091,0
促进会(1947),促进会,notion,0,1,1,0,1,1,0.017323,4,0.281723,0.306272,0
俄国(1947),俄国,notion,0,2,2,0,2,2,0.013398,4,0.271635,0.289854,656.368623
俄文(1947),俄文,notion,0,1,1,0,1,1,0.003699,4,0.256009,0.261706,0
保九(1947),保九,notion,0,1,1,0,1,1,0.011229,4,0.270366,0.287632,0
保养(1947),保养,notion,0,1,1,0,1,1,0.007422,4,0.26356,0.275695,0
保卫(1947),保卫,notion,0,1,1,0,2,2,0.017323,4,0.281723,0.306272,0
保卫和平(1947),保卫和平,notion,0,2,2,0,2,2,0.018459,4,0.281051,0.305271,917.367375
保姆(1947),保姆,notion,0,1,1,0,1,1,0.014222,4,0.275404,0.296091,0
保守党(1947),保守党,notion,0,2,2,0,2,2,0.016314,4,0.277757,0.299998,853.020505
保护(1947),保护,notion,0,1,1,0,1,1,0.014222,4,0.275404,0.296091,0
保田(1947),保田,notion,0,1,1,0,1,1,0.011229,4,0.270366,0.287632,0
保證(1947),保證,notion,0,1,1,0,1,1,0.013711,4,0.275027,0.295469,0
保证(1947),保证,notion,0,1,1,0,1,1,0.007422,4,0.26356,0.275695,0
保送(1947),保送,notion,0,1,1,0,1,1,0.014081,4,0.275493,0.296238,0
保长(1947),保长,notion,0,1,1,0,1,1,0.014081,4,0.275493,0.296238,0
俞平伯(1947),俞平伯,notion,0,1,1,0,1,1,0.014732,4,0.276453,0.297813,0
俞颂华(1947),俞颂华,notion,0,2,2,0,4,4,0.032055,4,0.30624,0.341853,2215.722594
信仰(1947),信仰,notion,0,3,3,0,3,3,0.035724,4,0.311778,0.349165,5959.110786
信心(1947),信心,notion,0,1,1,0,1,1,0.007422,4,0.26356,0.275695,0
信用(1947),信用,notion,0,1,1,0,1,1,0.014081,4,0.275493,0.296238,0
信用合作(1947),信用合作,notion,0,1,1,0,1,1,0.007422,4,0.26356,0.275695,0
信箱(1947),信箱,notion,0,1,1,0,15,15,0.013711,4,0.275027,0.295469,0
俨如(1947),俨如,notion,0,1,1,0,1,1,0.014732,4,0.276453,0.297813,0
俨然(1947),俨然,notion,0,1,1,0,1,1,0.014732,4,0.276453,0.297813,0
修养(1947),修养,notion,0,2,2,0,2,2,0.00829,4,0.264356,0.277184,414.958707
修改(1947),修改,notion,0,1,1,0,1,1,0.011229,4,0.270366,0.287632,0
修正(1947),修正,notion,0,2,2,0,3,3,0.031404,4,0.30602,0.34156,2430.025091
修补(1947),修补,notion,0,1,1,0,1,1,0.00981,4,0.267191,0.28214,0
倒忙(1947),倒忙,notion,0,1,1,0,1,1,0.014222,4,0.275404,0.296091,0
倒行逆施(1947),倒行逆施,notion,0,1,1,0,1,1,0.013711,4,0.275027,0.295469,0
倒退(1947),倒退,notion,0,1,1,0,1,1,0.014732,4,0.276453,0.297813,0
倒闭(1947),倒闭,notion,0,1,1,0,1,1,0.014081,4,0.275493,0.296238,0
倒阁(1947),倒阁,notion,0,1,1,0,1,1,0.003699,4,0.256009,0.261706,0
候选人(1947),候选人,notion,0,1,1,0,3,3,0.014222,4,0.275404,0.296091,0
借书(1947),借书,notion,0,1,1,0,1,1,0.007422,4,0.26356,0.275695,0
借以(1947),借以,notion,0,1,1,0,1,1,0.017323,4,0.281723,0.306272,0
借款(1947),借款,notion,0,3,3,0,3,3,0.028639,4,0.296994,0.329208,3547.635303
债主(1947),债主,notion,0,1,1,0,1,1,0.017323,4,0.281723,0.306272,0
债券(1947),债券,notion,0,1,1,0,1,1,0.014732,4,0.276453,0.297813,0
值得(1947),值得,notion,0,3,3,0,4,4,0.038967,4,0.318528,0.357661,6652.184339
倾向(1947),倾向,notion,0,3,3,0,3,3,0.029009,4,0.300789,0.334517,4968.524281
倾听(1947),倾听,notion,0,1,1,0,1,1,0.014732,4,0.276453,0.297813,0
假使(1947),假使,notion,0,2,2,0,2,2,0.016314,4,0.277757,0.299998,853.020505
假如(1947),假如,notion,0,1,1,0,1,1,0.014081,4,0.275493,0.296238,0
假定(1947),假定,notion,0,1,1,0,1,1,0.014081,4,0.275493,0.296238,0
假面具(1947),假面具,notion,0,1,1,0,1,1,0.014222,4,0.275404,0.296091,0
偏向(1947),偏向,notion,0,1,1,0,1,1,0.013711,4,0.275027,0.295469,0
偏废(1947),偏废,notion,0,1,1,0,1,1,0.002092,4,0.25318,0.25625,0
偏私(1947),偏私,notion,0,1,1,0,1,1,0.014081,4,0.275493,0.296238,0
做些(1947),做些,notion,0,3,3,0,4,4,0.035974,4,0.315262,0.353596,7290.358516
做什(1947),做什,notion,0,1,1,0,1,1,0.013711,4,0.275027,0.295469,0
做出(1947),做出,notion,0,1,1,0,1,1,0.007422,4,0.26356,0.275695,0
做梦(1947),做梦,notion,0,1,1,0,1,1,0.013711,4,0.275027,0.295469,0
做起(1947),做起,notion,0,1,1,0,1,1,0.011229,4,0.270366,0.287632,0
停刊(1947),停刊,notion,0,2,2,0,2,2,0.027133,4,0.29671,0.328744,1770.9936
停学(1947),停学,notion,0,1,1,0,1,1,0.017323,4,0.281723,0.306272,0
停止(1947),停止,notion,0,1,1,0,1,1,0.004749,4,0.257108,0.263793,0
健康(1947),健康,notion,0,1,1,0,1,1,0.014081,4,0.275493,0.296238,0
偶像(1947),偶像,notion,0,1,1,0,1,1,0.002092,4,0.25318,0.25625,0
偶得(1947),偶得,notion,0,1,1,0,1,1,0.003699,4,0.256009,0.261706,0
偶见(1947),偶见,notion,0,1,1,0,1,1,0.014732,4,0.276453,0.297813,0
偶语(1947),偶语,notion,0,2,2,0,2,2,0.025961,4,0.295759,0.327389,2231.848602
傀儡(1947),傀儡,notion,0,1,1,0,1,1,0.017323,4,0.281723,0.306272,0
傅作义(1947),傅作义,notion,0,3,3,0,3,3,0.046277,4,0.33091,0.372345,6500.451978
傅斯年(1947),傅斯年,notion,0,2,2,0,3,3,0.012734,4,0.270087,0.287217,736.032122
储蓄(1947),储蓄,notion,0,1,1,0,1,1,0.014732,4,0.276453,0.297813,0
催粮(1947),催粮,notion,0,1,1,0,1,1,0.000869,4,0.251131,0.252222,0
催马(1947),催马,notion,0,1,1,0,1,1,0.004749,4,0.257108,0.263793,0
僵尸(1947),僵尸,notion,0,1,1,0,1,1,0.00981,4,0.267191,0.28214,0
僵持(1947),僵持,notion,0,1,1,0,1,1,0.017323,4,0.281723,0.306272,0
儒学(1947),儒学,notion,0,1,1,0,1,1,0.014222,4,0.275404,0.296091,0
儒家思想(1947),儒家思想,notion,0,1,1,0,1,1,0.014732,4,0.276453,0.297813,0
儒林外史(1947),儒林外史,notion,0,1,1,0,1,1,0.009035,4,0.265075,0.278404,0
儒述(1947),儒述,notion,0,1,1,0,1,1,0.014732,4,0.276453,0.297813,0
儿女(1947),儿女,notion,0,1,1,0,1,1,0.011229,4,0.270366,0.287632,0
儿童乐园(1947),儿童乐园,notion,0,1,1,0,1,1,0.00981,4,0.267191,0.28214,0
儿童教育(1947),儿童教育,notion,0,2,2,0,2,2,0.021644,4,0.28732,0.314975,1747.667055
儿童玩具(1947),儿童玩具,notion,0,1,1,0,1,1,0.014222,4,0.275404,0.296091,0
允许(1947),允许,notion,0,1,1,0,1,1,0.004749,4,0.257108,0.263793,0
元帅(1947),元帅,notion,0,1,1,0,1,1,0.003699,4,0.256009,0.261706,0
充实(1947),充实,notion,0,2,2,0,2,2,0.02494,4,0.292941,0.323324,1747.290038
充当(1947),充当,notion,0,1,1,0,1,1,0.014732,4,0.276453,0.297813,0
充斥(1947),充斥,notion,0,1,1,0,2,2,0.014732,4,0.276453,0.297813,0
兇手(1947),兇手,notion,0,1,1,0,1,1,0.013711,4,0.275027,0.295469,0
先于(1947),先于,notion,0,1,1,0,1,1,0.009035,4,0.265075,0.278404,0
先决(1947),先决,notion,0,2,2,0,2,2,0.01948,4,0.281468,0.30593,668.20053
先决条件(1947),先决条件,notion,0,1,1,0,1,1,0.007422,4,0.26356,0.275695,0
先君(1947),先君,notion,0,1,1,0,1,1,0.014081,4,0.275493,0.296238,0
先声(1947),先声,notion,0,1,1,0,1,1,0.014081,4,0.275493,0.296238,0
先天(1947),先天,notion,0,1,1,0,1,1,0.007422,4,0.26356,0.275695,0
先得(1947),先得,notion,0,1,1,0,7,7,0.007422,4,0.26356,0.275695,0
先查(1947),先查,notion,0,1,1,0,1,1,0.014222,4,0.275404,0.296091,0
先烈(1947),先烈,notion,0,1,1,0,1,1,0.003588,4,0.255396,0.260534,0
先秦(1947),先秦,notion,0,1,1,0,1,1,0.014732,4,0.276453,0.297813,0
先讲好(1947),先讲好,notion,0,1,1,0,1,1,0.014732,4,0.276453,0.297813,0
先贤(1947),先贤,notion,0,1,1,0,1,1,0.004749,4,0.257108,0.263793,0
光度(1947),光度,notion,0,1,1,0,1,1,0.014081,4,0.275493,0.296238,0
光建(1947),光建,notion,0,1,1,0,1,1,0.014081,4,0.275493,0.296238,0
光明(1947),光明,notion,0,1,1,0,1,1,0.017323,4,0.281723,0.306272,0
光明面(1947),光明面,notion,0,1,1,0,1,1,0.014222,4,0.275404,0.296091,0
光是(1947),光是,notion,0,1,1,0,1,1,0.003588,4,0.255396,0.260534,0
光滑(1947),光滑,notion,0,1,1,0,1,1,0.014732,4,0.276453,0.297813,0
光辉(1947),光辉,notion,0,2,2,0,2,2,0.021039,4,0.286524,0.313766,1874.195629
克利(1947),克利,notion,0,1,1,0,1,1,0.017323,4,0.281723,0.306272,0
克利夫兰(1947),克利夫兰,notion,0,1,1,0,1,1,0.017323,4,0.281723,0.306272,0
克劳馥(1947),克劳馥,notion,0,1,1,0,1,1,0.014732,4,0.276453,0.297813,0
克服(1947),克服,notion,0,2,2,0,2,2,0.021644,4,0.28732,0.314975,1747.667055
克里(1947),克里,notion,0,1,1,0,1,1,0.017323,4,0.281723,0.306272,0
克里姆林宫(1947),克里姆林宫,notion,0,1,1,0,1,1,0.00981,4,0.267191,0.28214,0
免开尊口(1947),免开尊口,notion,0,1,1,0,1,1,0.014081,4,0.275493,0.296238,0
免於(1947),免於,notion,0,1,1,0,1,1,0.014081,4,0.275493,0.296238,0
党争(1947),党争,notion,0,1,1,0,2,2,0.017323,4,0.281723,0.306272,0
党内(1947),党内,notion,0,1,1,0,1,1,0.014222,4,0.275404,0.296091,0
党务(1947),党务,notion,0,1,1,0,1,1,0.014222,4,0.275404,0.296091,0
党务工作(1947),党务工作,notion,0,1,1,0,1,1,0.014222,4,0.275404,0.296091,0
党化(1947),党化,notion,0,1,1,0,1,1,0.014732,4,0.276453,0.297813,0
党员(1947),党员,notion,0,1,1,0,1,1,0.017323,4,0.281723,0.306272,0
党团(1947),党团,notion,0,2,2,0,4,4,0.028954,4,0.300154,0.333577,2064.821066
党报(1947),党报,notion,0,1,1,0,1,1,0.014081,4,0.275493,0.296238,0
党政(1947),党政,notion,0,1,1,0,1,1,0.009035,4,0.265075,0.278404,0
党政军(1947),党政军,notion,0,1,1,0,1,1,0.014081,4,0.275493,0.296238,0
党的路线(1947),党的路线,notion,0,1,1,0,1,1,0.009035,4,0.265075,0.278404,0
党章(1947),党章,notion,0,1,1,0,1,1,0.011229,4,0.270366,0.287632,0
入夏(1947),入夏,notion,0,1,1,0,1,1,0.011229,4,0.270366,0.287632,0
入学(1947),入学,notion,0,2,2,0,2,2,0.028812,4,0.299917,0.333248,2025.61524
入室弟子(1947),入室弟子,notion,0,1,1,0,1,1,0.014732,4,0.276453,0.297813,0
入川(1947),入川,notion,0,1,1,0,1,1,0.014081,4,0.275493,0.296238,0
入甲缝(1947),入甲缝,notion,0,1,1,0,1,1,0.014222,4,0.275404,0.296091,0
全世界(1947),全世界,notion,0,3,3,0,6,6,0.030721,4,0.30063,0.334298,3225.341612
全人类(1947),全人类,notion,0,1,1,0,1,1,0.014732,4,0.276453,0.297813,0
全国代表大会(1947),全国代表大会,notion,0,1,1,0,1,1,0.013711,4,0.275027,0.295469,0
全国学联(1947),全国学联,notion,0,1,1,0,1,1,0.017323,4,0.281723,0.306272,0
全图(1947),全图,notion,0,1,1,0,1,1,0.003699,4,0.256009,0.261706,0
全局(1947),全局,notion,0,2,2,0,3,3,0.02494,4,0.292941,0.323324,1747.290038
全文(1947),全文,notion,0,1,1,0,1,1,0.013711,4,0.275027,0.295469,0
全景(1947),全景,notion,0,1,1,0,1,1,0.00981,4,0.267191,0.28214,0
全权(1947),全权,notion,0,1,1,0,1,1,0.014081,4,0.275493,0.296238,0
全貌(1947),全貌,notion,0,3,3,0,3,3,0.035771,4,0.311949,0.349385,5932.702117
全集(1947),全集,notion,0,1,1,0,1,1,0.014732,4,0.276453,0.297813,0
全面(1947),全面,notion,0,4,4,0,5,5,0.049218,4,0.334018,0.375922,10883.827782
八九个(1947),八九个,notion,0,1,1,0,1,1,0.014732,4,0.276453,0.297813,0
八千里(1947),八千里,notion,0,1,1,0,2,2,0.003699,4,0.256009,0.261706,0
八宝(1947),八宝,notion,0,1,1,0,1,1,0.011229,4,0.270366,0.287632,0
八年(1947),八年,notion,0,1,1,0,1,1,0.014222,4,0.275404,0.296091,0
八方(1947),八方,notion,0,1,1,0,1,1,0.017323,4,0.281723,0.306272,0
八日下午(1947),八日下午,notion,0,1,1,0,1,1,0.017323,4,0.281723,0.306272,0
八桂(1947),八桂,notion,0,1,1,0,1,1,0.011229,4,0.270366,0.287632,0
八百(1947),八百,notion,0,1,1,0,1,1,0.00981,4,0.267191,0.28214,0
八路(1947),八路,notion,0,1,1,0,1,1,0.014081,4,0.275493,0.296238,0
八面山(1947),八面山,notion,0,1,1,0,1,1,0.013711,4,0.275027,0.295469,0
公主(1947),公主,notion,0,1,1,0,1,1,0.014081,4,0.275493,0.296238,0
公享(1947),公享,notion,0,1,1,0,1,1,0.014222,4,0.275404,0.296091,0
公佈(1947),公佈,notion,0,2,2,0,2,2,0.027932,4,0.299811,0.333101,2443.455357
公债(1947),公债,notion,0,3,3,0,3,3,0.025788,4,0.292715,0.323056,3546.742116
公共事业(1947),公共事业,notion,0,1,1,0,1,1,0.014081,4,0.275493,0.296238,0
公务人员(1947),公务人员,notion,0,2,2,0,2,2,0.028302,4,0.298866,0.331783,1965.8222
公务员(1947),公务员,notion,0,4,4,0,5,5,0.059846,4,0.358316,0.401299,13903.979248
公司(1947),公司,notion,0,2,2,0,3,3,0.021502,4,0.288388,0.316586,2245.621531
公审(1947),公审,notion,0,1,1,0,1,1,0.014732,4,0.276453,0.297813,0
公布(1947),公布,notion,0,2,2,0,2,2,0.021022,4,0.286837,0.314242,1344.24886
公开(1947),公开,notion,0,2,2,0,2,2,0.031034,4,0.30613,0.341707,2639.595687
公式(1947),公式,notion,0,1,1,0,1,1,0.013711,4,0.275027,0.295469,0
公意(1947),公意,notion,0,1,1,0,1,1,0.014732,4,0.276453,0.297813,0
公报(1947),公报,notion,0,1,1,0,1,1,0.017323,4,0.281723,0.306272,0
公教人员(1947),公教人员,notion,0,3,3,0,3,3,0.043284,4,0.326791,0.367585,7036.110858
公文(1947),公文,notion,0,1,1,0,1,1,0.014732,4,0.276453,0.297813,0
公映(1947),公映,notion,0,1,1,0,1,1,0.007422,4,0.26356,0.275695,0
公有(1947),公有,notion,0,1,1,0,1,1,0.014222,4,0.275404,0.296091,0
公樸(1947),公樸,notion,0,1,1,0,2,2,0.003588,4,0.255396,0.260534,0
公民投票(1947),公民投票,notion,0,1,1,0,1,1,0.017323,4,0.281723,0.306272,0
公民自由(1947),公民自由,notion,0,1,1,0,1,1,0.009035,4,0.265075,0.278404,0
公然(1947),公然,notion,0,1,1,0,1,1,0.014081,4,0.275493,0.296238,0
公祭(1947),公祭,notion,0,1,1,0,1,1,0.017323,4,0.281723,0.306272,0
公费(1947),公费,notion,0,2,2,0,3,3,0.028812,4,0.299917,0.333248,2025.61524
公道(1947),公道,notion,0,1,1,0,1,1,0.014081,4,0.275493,0.296238,0
六一(1947),六一,notion,0,4,4,0,6,6,0.056995,4,0.352143,0.395183,13610.726952
六个(1947),六个,notion,0,1,1,0,1,1,0.013711,4,0.275027,0.295469,0
六二(1947),六二,notion,0,3,3,0,5,5,0.040041,4,0.320772,0.360407,6754.232663
六十(1947),六十,notion,0,1,1,0,1,1,0.00981,4,0.267191,0.28214,0
六十岁(1947),六十岁,notion,0,1,1,0,1,1,0.014732,4,0.276453,0.297813,0
六千元(1947),六千元,notion,0,1,1,0,1,1,0.014081,4,0.275493,0.296238,0
六周年(1947),六周年,notion,0,1,1,0,1,1,0.017323,4,0.281723,0.306272,0
六大(1947),六大,notion,0,1,1,0,1,1,0.00981,4,0.267191,0.28214,0
六年(1947),六年,notion,0,1,1,0,1,1,0.003699,4,0.256009,0.261706,0
六邑(1947),六邑,notion,0,1,1,0,3,3,0.011229,4,0.270366,0.287632,0
兰州(1947),兰州,notion,0,1,1,0,1,1,0.014081,4,0.275493,0.296238,0
兰德(1947),兰德,notion,0,1,1,0,1,1,0.014732,4,0.276453,0.297813,0
共产(1947),共产,notion,0,1,1,0,1,1,0.014222,4,0.275404,0.296091,0
共产主义(1947),共产主义,notion,0,3,3,0,3,3,0.033067,4,0.303059,0.33763,3948.173354
共产党员(1947),共产党员,notion,0,1,1,0,1,1,0.011229,4,0.270366,0.287632,0
共产国际(1947),共产国际,notion,0,4,4,0,5,5,0.055312,4,0.343947,0.386724,10683.402766
共偿(1947),共偿,notion,0,1,1,0,1,1,0.014081,4,0.275493,0.296238,0
共匪(1947),共匪,notion,0,1,1,0,2,2,0.014222,4,0.275404,0.296091,0
共同(1947),共同,notion,0,1,1,0,1,1,0.014081,4,0.275493,0.296238,0
共和党(1947),共和党,notion,0,3,3,0,3,3,0.036827,4,0.312749,0.35041,5339.216716
共渡(1947),共渡,notion,0,1,1,0,1,1,0.003699,4,0.256009,0.261706,0
共鸣(1947),共鸣,notion,0,1,1,0,1,1,0.014222,4,0.275404,0.296091,0
关口(1947),关口,notion,0,1,1,0,1,1,0.011229,4,0.270366,0.287632,0
关头(1947),关头,notion,0,3,3,0,4,4,0.036294,4,0.310219,0.347151,3739.543386
关怀(1947),关怀,notion,0,1,1,0,1,1,0.017323,4,0.281723,0.306272,0
关於(1947),关於,notion,0,2,2,0,3,3,0.028302,4,0.298866,0.331783,1965.8222
关联(1947),关联,notion,0,1,1,0,1,1,0.014222,4,0.275404,0.296091,0
兴学(1947),兴学,notion,0,1,1,0,1,1,0.014081,4,0.275493,0.296238,0
兴工(1947),兴工,notion,0,1,1,0,1,1,0.014222,4,0.275404,0.296091,0
兴起(1947),兴起,notion,0,1,1,0,1,1,0.002092,4,0.25318,0.25625,0
兵役(1947),兵役,notion,0,1,1,0,1,1,0.003699,4,0.256009,0.261706,0
兵祸(1947),兵祸,notion,0,1,1,0,1,1,0.014732,4,0.276453,0.297813,0
其中(1947),其中,notion,0,1,1,0,1,1,0.003588,4,0.255396,0.260534,0
其事(1947),其事,notion,0,1,1,0,1,1,0.017323,4,0.281723,0.306272,0
其他(1947),其他,notion,0,1,1,0,1,1,0.014222,4,0.275404,0.296091,0
其声(1947),其声,notion,0,1,1,0,1,1,0.014732,4,0.276453,0.297813,0
其时(1947),其时,notion,0,1,1,0,1,1,0.017323,4,0.281723,0.306272,0
具体(1947),具体,notion,0,1,1,0,1,1,0.007422,4,0.26356,0.275695,0
具体办法(1947),具体办法,notion,0,1,1,0,1,1,0.014222,4,0.275404,0.296091,0
具有(1947),具有,notion,0,1,1,0,1,1,0.017323,4,0.281723,0.306272,0
具状(1947),具状,notion,0,1,1,0,1,1,0.017323,4,0.281723,0.306272,0
典型(1947),典型,notion,0,2,2,0,2,2,0.022746,4,0.288631,0.316952,1575.703869
典型性(1947),典型性,notion,0,1,1,0,1,1,0.007422,4,0.26356,0.275695,0
养士(1947),养士,notion,0,1,1,0,1,1,0.014081,4,0.275493,0.296238,0
养成(1947),养成,notion,0,1,1,0,1,1,0.009035,4,0.265075,0.278404,0
养民(1947),养民,notion,0,1,1,0,1,1,0.014732,4,0.276453,0.297813,0
兼及(1947),兼及,notion,0,1,1,0,1,1,0.014081,4,0.275493,0.296238,0
兼失(1947),兼失,notion,0,1,1,0,1,1,0.014732,4,0.276453,0.297813,0
兼答(1947),兼答,notion,0,1,1,0,1,1,0.014732,4,0.276453,0.297813,0
兼致(1947),兼致,notion,0,1,1,0,1,1,0.004749,4,0.257108,0.263793,0
兼评(1947),兼评,notion,0,2,2,0,2,2,0.01832,4,0.280681,0.304685,795.39908
兼谈(1947),兼谈,notion,0,1,1,0,1,1,0.007422,4,0.26356,0.275695,0
兼述(1947),兼述,notion,0,1,1,0,1,1,0.007422,4,0.26356,0.275695,0
兽行(1947),兽行,notion,0,1,1,0,1,1,0.00981,4,0.267191,0.28214,0
冀热(1947),冀热,notion,0,1,1,0,1,1,0.011229,4,0.270366,0.287632,0
内乱(1947),内乱,notion,0,1,1,0,1,1,0.002092,4,0.25318,0.25625,0
内争(1947),内争,notion,0,2,2,0,2,2,0.031404,4,0.30602,0.34156,2430.025091
内哄(1947),内哄,notion,0,1,1,0,1,1,0.004749,4,0.257108,0.263793,0
内地(1947),内地,notion,0,2,2,0,2,2,0.02494,4,0.292941,0.323324,1747.290038
内外(1947),内外,notion,0,1,1,0,1,1,0.014222,4,0.275404,0.296091,0
内外夹攻(1947),内外夹攻,notion,0,1,1,0,1,1,0.011229,4,0.270366,0.287632,0
内外线(1947),内外线,notion,0,1,1,0,1,1,0.013711,4,0.275027,0.295469,0
内容(1947),内容,notion,0,3,3,0,5,5,0.032873,4,0.307536,0.343636,6118.645654
内情(1947),内情,notion,0,2,2,0,2,2,0.032055,4,0.30624,0.341853,2215.722594
内政(1947),内政,notion,0,2,2,0,4,4,0.016314,4,0.277757,0.299998,853.020505
内有(1947),内有,notion,0,1,1,0,1,1,0.017323,4,0.281723,0.306272,0
内蒙(1947),内蒙,notion,0,1,1,0,1,1,0.014081,4,0.275493,0.296238,0
内蒙古(1947),内蒙古,notion,0,1,1,0,1,1,0.013711,4,0.275027,0.295469,0
内说(1947),内说,notion,0,1,1,0,1,1,0.017323,4,0.281723,0.306272,0
内阁(1947),内阁,notion,0,5,5,0,6,6,0.067316,4,0.371133,0.413408,20841.954844
再忆(1947),再忆,notion,0,1,1,0,1,1,0.011229,4,0.270366,0.287632,0
再斥(1947),再斥,notion,0,1,1,0,1,1,0.017323,4,0.281723,0.306272,0
再来(1947),再来,notion,0,1,1,0,1,1,0.011229,4,0.270366,0.287632,0
再演(1947),再演,notion,0,1,1,0,1,1,0.017323,4,0.281723,0.306272,0
再版(1947),再版,notion,0,1,1,0,1,1,0.017323,4,0.281723,0.306272,0
再谈(1947),再谈,notion,0,4,4,0,4,4,0.041287,4,0.319841,0.359333,8960.583993
再责美(1947),再责美,notion,0,1,1,0,1,1,0.017323,4,0.281723,0.306272,0
再进一步(1947),再进一步,notion,0,1,1,0,1,1,0.011229,4,0.270366,0.287632,0
冒险(1947),冒险,notion,0,1,1,0,1,1,0.014732,4,0.276453,0.297813,0
冒险家(1947),冒险家,notion,0,2,2,0,2,2,0.024745,4,0.295069,0.3264,2684.608967
写作(1947),写作,notion,0,1,1,0,1,1,0.014222,4,0.275404,0.296091,0
写在(1947),写在,notion,0,1,1,0,3,3,0.014081,4,0.275493,0.296238,0
写实主义(1947),写实主义,notion,0,1,1,0,1,1,0.014222,4,0.275404,0.296091,0
写景(1947),写景,notion,0,1,1,0,1,1,0.014222,4,0.275404,0.296091,0
写生(1947),写生,notion,0,1,1,0,1,1,0.014081,4,0.275493,0.296238,0
写给(1947),写给,notion,0,3,3,0,3,3,0.03254,4,0.304682,0.339827,3978.012047
写赠(1947),写赠,notion,0,1,1,0,1,1,0.017323,4,0.281723,0.306272,0
军事化(1947),军事化,notion,0,1,1,0,1,1,0.00981,4,0.267191,0.28214,0
军事科学(1947),军事科学,notion,0,1,1,0,1,1,0.00981,4,0.267191,0.28214,0
军人(1947),军人,notion,0,3,3,0,3,3,0.034992,4,0.309853,0.346675,4099.284513
军力(1947),军力,notion,0,1,1,0,1,1,0.003588,4,0.255396,0.260534,0
军国主义(1947),军国主义,notion,0,2,2,0,3,3,0.013509,4,0.272459,0.291246,1005.901195
军士(1947),军士,notion,0,1,1,0,1,1,0.013711,4,0.275027,0.295469,0
军备(1947),军备,notion,0,2,2,0,2,2,0.026359,4,0.294788,0.325997,1561.492709
军官(1947),军官,notion,0,1,1,0,3,3,0.011229,4,0.270366,0.287632,0
军官团(1947),军官团,notion,0,1,1,0,1,1,0.011229,4,0.270366,0.287632,0
军政人员(1947),军政人员,notion,0,1,1,0,1,1,0.017323,4,0.281723,0.306272,0
军民一家(1947),军民一家,notion,0,1,1,0,1,1,0.011229,4,0.270366,0.287632,0
军民合作(1947),军民合作,notion,0,1,1,0,1,1,0.014222,4,0.275404,0.296091,0
军火(1947),军火,notion,0,2,2,0,2,2,0.020912,4,0.285589,0.312338,797.979389
军的(1947),军的,notion,0,1,1,0,1,1,0.011229,4,0.270366,0.287632,0
军训(1947),军训,notion,0,2,2,0,2,2,0.031545,4,0.305336,0.340645,2219.908318
军费(1947),军费,notion,0,1,1,0,1,1,0.014732,4,0.276453,0.297813,0
军队(1947),军队,notion,0,6,6,0,9,9,0.072597,4,0.379341,0.420756,27905.152833
农会(1947),农会,notion,0,1,1,0,1,1,0.013711,4,0.275027,0.295469,0
农工(1947),农工,notion,0,1,1,0,2,2,0.014222,4,0.275404,0.296091,0
农工民主党(1947),农工民主党,notion,0,1,1,0,2,2,0.017323,4,0.281723,0.306272,0
农民节(1947),农民节,notion,0,1,1,0,4,4,0.014222,4,0.275404,0.296091,0
冤旧(1947),冤旧,notion,0,2,2,0,2,2,0.01948,4,0.281468,0.30593,668.20053
冬夜(1947),冬夜,notion,0,1,1,0,1,1,0.014732,4,0.276453,0.297813,0
冬天(1947),冬天,notion,0,2,2,0,3,3,0.027791,4,0.29968,0.332918,2405.290268
冬季(1947),冬季,notion,0,1,1,0,1,1,0.013711,4,0.275027,0.295469,0
冬学(1947),冬学,notion,0,1,1,0,1,1,0.014222,4,0.275404,0.296091,0
冬春(1947),冬春,notion,0,1,1,0,1,1,0.00981,4,0.267191,0.28214,0
冬藏(1947),冬藏,notion,0,1,1,0,1,1,0.014732,4,0.276453,0.297813,0
冯至讲(1947),冯至讲,notion,0,1,1,0,1,1,0.014732,4,0.276453,0.297813,0
冲出去(1947),冲出去,notion,0,1,1,0,1,1,0.003588,4,0.255396,0.260534,0
冲开(1947),冲开,notion,0,1,1,0,1,1,0.011229,4,0.270366,0.287632,0
冲破(1947),冲破,notion,0,1,1,0,1,1,0.003588,4,0.255396,0.260534,0
冲突(1947),冲突,notion,0,1,1,0,2,2,0.014732,4,0.276453,0.297813,0
决不(1947),决不,notion,0,1,1,0,1,1,0.011229,4,0.270366,0.287632,0
决定(1947),决定,notion,0,2,2,0,3,3,0.025451,4,0.295094,0.326437,2353.768712
决定性(1947),决定性,notion,0,1,1,0,1,1,0.00981,4,0.267191,0.28214,0
决心(1947),决心,notion,0,3,3,0,3,3,0.035974,4,0.315262,0.353596,7290.358516
决策(1947),决策,notion,0,1,1,0,1,1,0.014222,4,0.275404,0.296091,0
决绝(1947),决绝,notion,0,1,1,0,1,1,0.014081,4,0.275493,0.296238,0
决裂(1947),决裂,notion,0,1,1,0,1,1,0.014222,4,0.275404,0.296091,0
冻结(1947),冻结,notion,0,2,2,0,2,2,0.01741,4,0.280151,0.303843,1198.480437
冼星海(1947),冼星海,notion,0,1,1,0,1,1,0.013711,4,0.275027,0.295469,0
凄风苦雨(1947),凄风苦雨,notion,0,1,1,0,1,1,0.017323,4,0.281723,0.306272,0
准其(1947),准其,notion,0,1,1,0,1,1,0.014081,4,0.275493,0.296238,0
准备(1947),准备,notion,0,1,1,0,2,2,0.011229,4,0.270366,0.287632,0
减租(1947),减租,notion,0,4,4,0,5,5,0.0404,4,0.320562,0.360212,8486.860702
减租减息(1947),减租减息,notion,0,1,1,0,2,2,0.011229,4,0.270366,0.287632,0
几件事(1947),几件事,notion,0,2,2,0,2,2,0.028552,4,0.301506,0.335445,2588.539662
几千年(1947),几千年,notion,0,1,1,0,1,1,0.013711,4,0.275027,0.295469,0
几及(1947),几及,notion,0,1,1,0,1,1,0.011229,4,0.270366,0.287632,0
几句(1947),几句,notion,0,1,1,0,1,1,0.014222,4,0.275404,0.296091,0
几句话(1947),几句话,notion,0,2,2,0,2,2,0.028954,4,0.300154,0.333577,2064.821066
几天(1947),几天,notion,0,1,1,0,1,1,0.017323,4,0.281723,0.306272,0
几封信(1947),几封信,notion,0,1,1,0,1,1,0.003699,4,0.256009,0.261706,0
几拜(1947),几拜,notion,0,1,1,0,1,1,0.014732,4,0.276453,0.297813,0
几条(1947),几条,notion,0,1,1,0,1,1,0.007422,4,0.26356,0.275695,0
几段(1947),几段,notion,0,1,1,0,1,1,0.014732,4,0.276453,0.297813,0
几点(1947),几点,notion,0,5,5,0,8,8,0.057273,4,0.353456,0.396563,21159.923317
几笔(1947),几笔,notion,0,1,1,0,1,1,0.007422,4,0.26356,0.275695,0
几篇(1947),几篇,notion,0,1,1,0,1,1,0.011229,4,0.270366,0.287632,0
凤虚凰(1947),凤虚凰,notion,0,1,1,0,1,1,0.014732,4,0.276453,0.297813,0
凭据(1947),凭据,notion,0,1,1,0,1,1,0.003699,4,0.256009,0.261706,0
凭籍(1947),凭籍,notion,0,1,1,0,1,1,0.007422,4,0.26356,0.275695,0
凶年(1947),凶年,notion,0,1,1,0,1,1,0.014081,4,0.275493,0.296238,0
凶手(1947),凶手,notion,0,1,1,0,1,1,0.003588,4,0.255396,0.260534,0
出任(1947),出任,notion,0,2,2,0,2,2,0.009904,4,0.265797,0.279747,320.267021
出卖(1947),出卖,notion,0,5,5,0,8,8,0.050799,4,0.336289,0.378509,14649.957313
出卖灵魂(1947),出卖灵魂,notion,0,1,1,0,1,1,0.014222,4,0.275404,0.296091,0
出发(1947),出发,notion,0,1,1,0,1,1,0.011229,4,0.270366,0.287632,0
出售(1947),出售,notion,0,1,1,0,1,1,0.002092,4,0.25318,0.25625,0
出国(1947),出国,notion,0,1,1,0,1,1,0.013711,4,0.275027,0.295469,0
出处(1947),出处,notion,0,1,1,0,1,1,0.014732,4,0.276453,0.297813,0
出巡(1947),出巡,notion,0,1,1,0,1,1,0.011229,4,0.270366,0.287632,0
出殡(1947),出殡,notion,0,1,1,0,1,1,0.013711,4,0.275027,0.295469,0
出洋(1947),出洋,notion,0,1,1,0,1,1,0.014081,4,0.275493,0.296238,0
出渔(1947),出渔,notion,0,1,1,0,1,1,0.007422,4,0.26356,0.275695,0
出火(1947),出火,notion,0,1,1,0,1,1,0.003699,4,0.256009,0.261706,0
出版事业(1947),出版事业,notion,0,1,1,0,1,1,0.014222,4,0.275404,0.296091,0
出版法(1947),出版法,notion,0,1,1,0,2,2,0.014081,4,0.275493,0.296238,0
出版界(1947),出版界,notion,0,1,1,0,1,1,0.014222,4,0.275404,0.296091,0
出版社(1947),出版社,notion,0,1,1,0,1,1,0.00981,4,0.267191,0.28214,0
出狱(1947),出狱,notion,0,1,1,0,1,1,0.014732,4,0.276453,0.297813,0
出现(1947),出现,notion,0,2,2,0,3,3,0.031545,4,0.305336,0.340645,2219.908318
出的门(1947),出的门,notion,0,1,1,0,1,1,0.014081,4,0.275493,0.296238,0
出笼(1947),出笼,notion,0,1,1,0,1,1,0.017323,4,0.281723,0.306272,0
出路(1947),出路,notion,0,5,5,0,14,14,0.064595,4,0.363119,0.405974,17007.325734
击溃(1947),击溃,notion,0,1,1,0,1,1,0.00981,4,0.267191,0.28214,0
击荡坑(1947),击荡坑,notion,0,1,1,0,1,1,0.011229,4,0.270366,0.287632,0
函件(1947),函件,notion,0,1,1,0,1,1,0.014081,4,0.275493,0.296238,0
函市(1947),函市,notion,0,1,1,0,1,1,0.017323,4,0.281723,0.306272,0
函授学校(1947),函授学校,notion,0,1,1,0,1,1,0.007422,4,0.26356,0.275695,0
分化(1947),分化,notion,0,1,1,0,1,1,0.00981,4,0.267191,0.28214,0
分合(1947),分合,notion,0,1,1,0,1,1,0.014732,4,0.276453,0.297813,0
分工(1947),分工,notion,0,1,1,0,1,1,0.011229,4,0.270366,0.287632,0
分校(1947),分校,notion,0,2,2,0,3,3,0.01948,4,0.281468,0.30593,668.20053
分歧(1947),分歧,notion,0,1,1,0,1,1,0.00981,4,0.267191,0.28214,0
分水岭(1947),分水岭,notion,0,1,1,0,1,1,0.00981,4,0.267191,0.28214,0
分治(1947),分治,notion,0,3,3,0,4,4,0.041214,4,0.322074,0.361982,6317.925086
分立(1947),分立,notion,0,1,1,0,1,1,0.014222,4,0.275404,0.296091,0
分类(1947),分类,notion,0,2,2,0,2,2,0.024745,4,0.295069,0.3264,2684.608967
分配(1947),分配,notion,0,1,1,0,1,1,0.007422,4,0.26356,0.275695,0
分野(1947),分野,notion,0,1,1,0,1,1,0.011229,4,0.270366,0.287632,0
切勿(1947),切勿,notion,0,1,1,0,1,1,0.014732,4,0.276453,0.297813,0
切实(1947),切实,notion,0,1,1,0,1,1,0.007422,4,0.26356,0.275695,0
刊出(1947),刊出,notion,0,1,1,0,1,1,0.014081,4,0.275493,0.296238,0
刊物(1947),刊物,notion,0,1,1,0,1,1,0.014732,4,0.276453,0.297813,0
刊载(1947),刊载,notion,0,1,1,0,1,1,0.014081,4,0.275493,0.296238,0
刍议(1947),刍议,notion,0,4,4,0,5,5,0.042086,4,0.315233,0.35362,6255.858785
刑事管辖(1947),刑事管辖,notion,0,1,1,0,1,1,0.014081,4,0.275493,0.296238,0
划时代(1947),划时代,notion,0,1,1,0,1,1,0.013711,4,0.275027,0.295469,0
列入(1947),列入,notion,0,1,1,0,1,1,0.014222,4,0.275404,0.296091,0
列宁七七诞辰(1947),列宁七七诞辰,notion,0,1,1,0,1,1,0.00981,4,0.267191,0.28214,0
列强(1947),列强,notion,0,1,1,0,1,1,0.017323,4,0.281723,0.306272,0
列车(1947),列车,notion,0,1,1,0,1,1,0.017323,4,0.281723,0.306272,0
列队(1947),列队,notion,0,1,1,0,1,1,0.017323,4,0.281723,0.306272,0
刘伯承(1947),刘伯承,notion,0,2,2,0,3,3,0.027791,4,0.29968,0.332918,2405.290268
刘少奇(1947),刘少奇,notion,0,1,1,0,1,1,0.011229,4,0.270366,0.287632,0
刘野礁(1947),刘野礁,notion,0,1,1,0,1,1,0.013711,4,0.275027,0.295469,0
刚刚(1947),刚刚,notion,0,1,1,0,1,1,0.014222,4,0.275404,0.296091,0
创业(1947),创业,notion,0,1,1,0,1,1,0.007422,4,0.26356,0.275695,0
创作(1947),创作,notion,0,2,2,0,3,3,0.025961,4,0.295759,0.327389,2231.848602
创刊(1947),创刊,notion,0,2,2,0,2,2,0.022072,4,0.287175,0.314755,862.424175
创制(1947),创制,notion,0,1,1,0,1,1,0.014222,4,0.275404,0.296091,0
创办(1947),创办,notion,0,1,1,0,1,1,0.014081,4,0.275493,0.296238,0
创建(1947),创建,notion,0,2,2,0,2,2,0.014928,4,0.275516,0.296336,1118.339317
创立(1947),创立,notion,0,2,2,0,3,3,0.023521,4,0.291018,0.320504,1911.402908
创造(1947),创造,notion,0,6,6,0,7,7,0.060333,4,0.358166,0.401274,22260.806994
初会(1947),初会,notion,0,1,1,0,1,1,0.00981,4,0.267191,0.28214,0
初冬(1947),初冬,notion,0,1,1,0,1,1,0.014081,4,0.275493,0.296238,0
初夏(1947),初夏,notion,0,1,1,0,1,1,0.013711,4,0.275027,0.295469,0
初旅(1947),初旅,notion,0,1,1,0,1,1,0.007422,4,0.26356,0.275695,0
初步(1947),初步,notion,0,3,3,0,3,3,0.03475,4,0.309488,0.346199,5532.888574
初民(1947),初民,notion,0,1,1,0,1,1,0.014222,4,0.275404,0.296091,0
判决(1947),判决,notion,0,1,1,0,1,1,0.017323,4,0.281723,0.306272,0
判罪(1947),判罪,notion,0,1,1,0,1,1,0.014732,4,0.276453,0.297813,0
利与义(1947),利与义,notion,0,1,1,0,1,1,0.009035,4,0.265075,0.278404,0
利害(1947),利害,notion,0,1,1,0,1,1,0.014081,4,0.275493,0.296238,0
利害关系(1947),利害关系,notion,0,1,1,0,1,1,0.014732,4,0.276453,0.297813,0
利弊(1947),利弊,notion,0,2,2,0,2,2,0.023116,4,0.288412,0.316623,1358.22258
利得税(1947),利得税,notion,0,1,1,0,1,1,0.009035,4,0.265075,0.278404,0
利用(1947),利用,notion,0,1,1,0,6,6,0.007422,4,0.26356,0.275695,0
利莎(1947),利莎,notion,0,1,1,0,1,1,0.014081,4,0.275493,0.296238,0
别有用心(1947),别有用心,notion,0,1,1,0,1,1,0.011229,4,0.270366,0.287632,0
别说(1947),别说,notion,0,1,1,0,1,1,0.011229,4,0.270366,0.287632,0
到任(1947),到任,notion,0,1,1,0,1,1,0.014732,4,0.276453,0.297813,0
到处(1947),到处,notion,0,2,2,0,2,2,0.031404,4,0.30602,0.34156,2430.025091
到来(1947),到来,notion,0,4,4,0,4,4,0.041764,4,0.321649,0.36153,9422.018371
到鲁西(1947),到鲁西,notion,0,1,1,0,1,1,0.013711,4,0.275027,0.295469,0
制定(1947),制定,notion,0,2,2,0,2,2,0.027932,4,0.299811,0.333101,2443.455357
制宪会议(1947),制宪会议,notion,0,1,1,0,1,1,0.009035,4,0.265075,0.278404,0
制是(1947),制是,notion,0,1,1,0,1,1,0.017323,4,0.281723,0.306272,0
制止(1947),制止,notion,0,3,3,0,3,3,0.040069,4,0.319541,0.358906,5776.792264
制裁(1947),制裁,notion,0,1,1,0,1,1,0.017323,4,0.281723,0.306272,0
制造(1947),制造,notion,0,2,2,0,2,2,0.022153,4,0.289808,0.31871,2534.094371
制造商(1947),制造商,notion,0,1,1,0,1,1,0.011229,4,0.270366,0.287632,0
制造者(1947),制造者,notion,0,1,1,0,1,1,0.014732,4,0.276453,0.297813,0
制造舆论(1947),制造舆论,notion,0,1,1,0,1,1,0.00981,4,0.267191,0.28214,0
刷新(1947),刷新,notion,0,1,1,0,1,1,0.014732,4,0.276453,0.297813,0
刺刀(1947),刺刀,notion,0,1,1,0,1,1,0.014732,4,0.276453,0.297813,0
刺激(1947),刺激,notion,0,1,1,0,1,1,0.017323,4,0.281723,0.306272,0
刽子手(1947),刽子手,notion,0,1,1,0,1,1,0.013711,4,0.275027,0.295469,0
剃掉(1947),剃掉,notion,0,1,1,0,1,1,0.013711,4,0.275027,0.295469,0
前前后后(1947),前前后后,notion,0,1,1,0,1,1,0.013711,4,0.275027,0.295469,0
前后(1947),前后,notion,0,5,5,0,11,11,0.061685,4,0.361964,0.404875,21683.237486
前夕(1947),前夕,notion,0,5,5,0,8,8,0.052266,4,0.338356,0.38078,15419.514992
前夜(1947),前夜,notion,0,3,3,0,3,3,0.028898,4,0.299443,0.33265,4066.935665
前尘影事(1947),前尘影事,notion,0,1,1,0,1,1,0.017323,4,0.281723,0.306272,0
前提(1947),前提,notion,0,2,2,0,2,2,0.018459,4,0.281051,0.305271,917.367375
前方(1947),前方,notion,0,1,1,0,1,1,0.014222,4,0.275404,0.296091,0
前的(1947),前的,notion,0,1,1,0,1,1,0.007422,4,0.26356,0.275695,0
前瞻(1947),前瞻,notion,0,3,3,0,4,4,0.026392,4,0.29254,0.322799,3263.580799
前进(1947),前进,notion,0,6,6,0,9,9,0.068311,4,0.369326,0.411821,24737.174952
前面(1947),前面,notion,0,2,2,0,2,2,0.027791,4,0.29968,0.332918,2405.290268
剖析(1947),剖析,notion,0,2,2,0,2,2,0.028954,4,0.300154,0.333577,2064.821066
剖视(1947),剖视,notion,0,5,5,0,5,5,0.041702,4,0.318231,0.357417,8910.469238
剥削(1947),剥削,notion,0,1,1,0,1,1,0.007422,4,0.26356,0.275695,0
剧变(1947),剧变,notion,0,1,1,0,1,1,0.014732,4,0.276453,0.297813,0
剧坛(1947),剧坛,notion,0,1,1,0,1,1,0.003699,4,0.256009,0.261706,0
剧评(1947),剧评,notion,0,1,1,0,1,1,0.014081,4,0.275493,0.296238,0
剪影(1947),剪影,notion,0,1,1,0,1,1,0.007422,4,0.26356,0.275695,0
剷除(1947),剷除,notion,0,1,1,0,1,1,0.014081,4,0.275493,0.296238,0
剿匪(1947),剿匪,notion,0,3,3,0,5,5,0.039162,4,0.318825,0.358027,6544.514107
剿民(1947),剿民,notion,0,1,1,0,1,1,0.011229,4,0.270366,0.287632,0
力三(1947),力三,notion,0,1,1,0,1,1,0.017323,4,0.281723,0.306272,0
力求(1947),力求,notion,0,1,1,0,1,1,0.014081,4,0.275493,0.296238,0
力能济乎(1947),力能济乎,notion,0,1,1,0,1,1,0.014222,4,0.275404,0.296091,0
劝工(1947),劝工,notion,0,1,1,0,1,1,0.003699,4,0.256009,0.261706,0
办报(1947),办报,notion,0,1,1,0,1,1,0.009035,4,0.265075,0.278404,0
功用(1947),功用,notion,0,1,1,0,1,1,0.014732,4,0.276453,0.297813,0
加上(1947),加上,notion,0,1,1,0,1,1,0.013711,4,0.275027,0.295469,0
加倍(1947),加倍,notion,0,1,1,0,1,1,0.003588,4,0.255396,0.260534,0
加倍努力(1947),加倍努力,notion,0,1,1,0,1,1,0.013711,4,0.275027,0.295469,0
加强(1947),加强,notion,0,2,2,0,2,2,0.02531,4,0.2954,0.326876,2496.768821
加惠(1947),加惠,notion,0,1,1,0,1,1,0.009035,4,0.265075,0.278404,0
加拿大(1947),加拿大,notion,0,1,1,0,3,3,0.00981,4,0.267191,0.28214,0
加深(1947),加深,notion,0,2,2,0,2,2,0.02494,4,0.292941,0.323324,1747.290038
加紧(1947),加紧,notion,0,2,2,0,2,2,0.02494,4,0.292941,0.323324,1747.290038
加鞭(1947),加鞭,notion,0,1,1,0,1,1,0.004749,4,0.257108,0.263793,0
务请(1947),务请,notion,0,1,1,0,1,1,0.014081,4,0.275493,0.296238,0
动乱(1947),动乱,notion,0,5,5,0,6,6,0.067175,4,0.372145,0.414323,21577.273519
动员令(1947),动员令,notion,0,1,1,0,1,1,0.014732,4,0.276453,0.297813,0
动态(1947),动态,notion,0,5,5,0,12,12,0.049152,4,0.330782,0.372321,11787.581641
动手(1947),动手,notion,0,1,1,0,1,1,0.013711,4,0.275027,0.295469,0
动摇(1947),动摇,notion,0,2,2,0,2,2,0.018651,4,0.283055,0.30842,2017.209887
动机(1947),动机,notion,0,3,3,0,4,4,0.032731,4,0.308565,0.34499,6759.60024
动物(1947),动物,notion,0,1,1,0,1,1,0.014222,4,0.275404,0.296091,0
动盪(1947),动盪,notion,0,1,1,0,1,1,0.014081,4,0.275493,0.296238,0
动荡(1947),动荡,notion,0,6,6,0,8,8,0.064424,4,0.356408,0.399553,18102.223193
动荡不安(1947),动荡不安,notion,0,1,1,0,1,1,0.017323,4,0.281723,0.306272,0
动运(1947),动运,notion,0,1,1,0,1,1,0.013711,4,0.275027,0.295469,0
助人(1947),助人,notion,0,1,1,0,1,1,0.014222,4,0.275404,0.296091,0
助学(1947),助学,notion,0,3,3,0,8,8,0.039671,4,0.318706,0.35788,6166.869009
助德乎(1947),助德乎,notion,0,1,1,0,1,1,0.009035,4,0.265075,0.278404,0
助法乎(1947),助法乎,notion,0,1,1,0,1,1,0.009035,4,0.265075,0.278404,0
助读(1947),助读,notion,0,1,1,0,1,1,0.007422,4,0.26356,0.275695,0
努里(1947),努里,notion,0,1,1,0,1,1,0.00981,4,0.267191,0.28214,0
劫收(1947),劫收,notion,0,1,1,0,1,1,0.011229,4,0.270366,0.287632,0
劳伦斯(1947),劳伦斯,notion,0,1,1,0,1,1,0.00981,4,0.267191,0.28214,0
劳动(1947),劳动,notion,0,2,2,0,2,2,0.017232,4,0.279944,0.303513,1791.004954
劳动者(1947),劳动者,notion,0,3,3,0,5,5,0.026124,4,0.293243,0.323825,3284.612705
劳动节(1947),劳动节,notion,0,3,3,0,8,8,0.032873,4,0.307536,0.343636,6118.645654
劳协(1947),劳协,notion,0,2,2,0,2,2,0.017299,4,0.278915,0.301865,688.562525
劳工(1947),劳工,notion,0,6,6,0,10,10,0.072739,4,0.378542,0.42006,27229.165316
劳文(1947),劳文,notion,0,1,1,0,4,4,0.002092,4,0.25318,0.25625,0
劳文群(1947),劳文群,notion,0,1,1,0,1,1,0.002092,4,0.25318,0.25625,0
劳资(1947),劳资,notion,0,1,1,0,1,1,0.003699,4,0.256009,0.261706,0
势不两立(1947),势不两立,notion,0,1,1,0,1,1,0.011229,4,0.270366,0.287632,0
勇敢(1947),勇敢,notion,0,3,3,0,3,3,0.042523,4,0.324801,0.365241,6618.635877
勇气(1947),勇气,notion,0,1,1,0,1,1,0.013711,4,0.275027,0.295469,0
勋章(1947),勋章,notion,0,1,1,0,1,1,0.00981,4,0.267191,0.28214,0
勒令(1947),勒令,notion,0,1,1,0,1,1,0.017323,4,0.281723,0.306272,0
勒斯(1947),勒斯,notion,0,1,1,0,1,1,0.00981,4,0.267191,0.28214,0
勘乱(1947),勘乱,notion,0,2,2,0,2,2,0.028442,4,0.300022,0.333394,2187.730369
勾结(1947),勾结,notion,0,2,2,0,2,2,0.027133,4,0.29671,0.328744,1770.9936
勿忘(1947),勿忘,notion,0,1,1,0,1,1,0.013711,4,0.275027,0.295469,0
包围(1947),包围,notion,0,1,1,0,1,1,0.017323,4,0.281723,0.306272,0
包头(1947),包头,notion,0,1,1,0,1,1,0.014732,4,0.276453,0.297813,0
匈牙利(1947),匈牙利,notion,0,3,3,0,6,6,0.037742,4,0.315787,0.354255,6050.35704
化外(1947),化外,notion,0,1,1,0,1,1,0.004749,4,0.257108,0.263793,0
化工(1947),化工,notion,0,1,1,0,1,1,0.014081,4,0.275493,0.296238,0
北京大学(1947),北京大学,notion,0,1,1,0,2,2,0.014732,4,0.276453,0.297813,0
北国风光(1947),北国风光,notion,0,1,1,0,1,1,0.014732,4,0.276453,0.297813,0
北巡(1947),北巡,notion,0,1,1,0,1,1,0.014732,4,0.276453,0.297813,0
北平市(1947),北平市,notion,0,1,1,0,1,1,0.014732,4,0.276453,0.297813,0
北方(1947),北方,notion,0,3,3,0,6,6,0.045114,4,0.331456,0.372968,7474.911045
北极(1947),北极,notion,0,1,1,0,1,1,0.014222,4,0.275404,0.296091,0
北欧(1947),北欧,notion,0,1,1,0,1,1,0.00981,4,0.267191,0.28214,0
北疆(1947),北疆,notion,0,1,1,0,1,1,0.017323,4,0.281723,0.306272,0
北票(1947),北票,notion,0,1,1,0,1,1,0.014081,4,0.275493,0.296238,0
北美(1947),北美,notion,0,1,1,0,1,1,0.014732,4,0.276453,0.297813,0
北返(1947),北返,notion,0,1,1,0,1,1,0.013711,4,0.275027,0.295469,0
北部(1947),北部,notion,0,1,1,0,1,1,0.00981,4,0.267191,0.28214,0
北韩(1947),北韩,notion,0,1,1,0,1,1,0.014222,4,0.275404,0.296091,0
北风(1947),北风,notion,0,1,1,0,1,1,0.014732,4,0.276453,0.297813,0
匡时(1947),匡时,notion,0,1,1,0,1,1,0.014222,4,0.275404,0.296091,0
匪患(1947),匪患,notion,0,2,2,0,2,2,0.032055,4,0.30624,0.341853,2215.722594
匪情(1947),匪情,notion,0,1,1,0,1,1,0.014222,4,0.275404,0.296091,0
匪氛(1947),匪氛,notion,0,1,1,0,1,1,0.017323,4,0.281723,0.306272,0
十一(1947),十一,notion,0,5,5,0,6,6,0.05457,4,0.341811,0.384515,16687.80374
十七(1947),十七,notion,0,2,2,0,2,2,0.023257,4,0.28761,0.315414,1169.271875
十万(1947),十万,notion,0,1,1,0,1,1,0.017323,4,0.281723,0.306272,0
十万元(1947),十万元,notion,0,1,1,0,1,1,0.014732,4,0.276453,0.297813,0
十三(1947),十三,notion,0,2,2,0,2,2,0.021644,4,0.28732,0.314975,1747.667055
十九(1947),十九,notion,0,1,1,0,1,1,0.011229,4,0.270366,0.287632,0
十二(1947),十二,notion,0,4,4,0,4,4,0.04476,4,0.324462,0.364899,10000.990912
十五(1947),十五,notion,0,3,3,0,3,3,0.037989,4,0.312577,0.35019,4686.279145
十八(1947),十八,notion,0,2,2,0,2,2,0.023257,4,0.28761,0.315414,1169.271875
十八世纪(1947),十八世纪,notion,0,1,1,0,1,1,0.00981,4,0.267191,0.28214,0
十六年(1947),十六年,notion,0,1,1,0,1,1,0.017323,4,0.281723,0.306272,0
十周年(1947),十周年,notion,0,1,1,0,1,1,0.00981,4,0.267191,0.28214,0
十四(1947),十四,notion,0,3,3,0,4,4,0.030679,4,0.300048,0.333492,4431.324601
十四个(1947),十四个,notion,0,1,1,0,1,1,0.009035,4,0.265075,0.278404,0
十大(1947),十大,notion,0,2,2,0,2,2,0.024032,4,0.290894,0.320321,1695.498775
十字军(1947),十字军,notion,0,1,1,0,1,1,0.009035,4,0.265075,0.278404,0
十届(1947),十届,notion,0,1,1,0,1,1,0.009035,4,0.265075,0.278404,0
十年(1947),十年,notion,0,7,7,0,12,12,0.081193,4,0.395378,0.434183,34999.23538
十年间(1947),十年间,notion,0,1,1,0,1,1,0.014732,4,0.276453,0.297813,0
十族(1947),十族,notion,0,1,1,0,1,1,0.011229,4,0.270366,0.287632,0
十时(1947),十时,notion,0,1,1,0,1,1,0.013711,4,0.275027,0.295469,0
十月革命(1947),十月革命,notion,0,4,4,0,7,7,0.044432,4,0.325235,0.365815,8464.902731
十週年(1947),十週年,notion,0,1,1,0,1,1,0.013711,4,0.275027,0.295469,0
十项(1947),十项,notion,0,1,1,0,1,1,0.007422,4,0.26356,0.275695,0
千万个(1947),千万个,notion,0,1,1,0,1,1,0.011229,4,0.270366,0.287632,0
千人(1947),千人,notion,0,1,1,0,1,1,0.017323,4,0.281723,0.306272,0
千学(1947),千学,notion,0,1,1,0,1,1,0.017323,4,0.281723,0.306272,0
千教(1947),千教,notion,0,1,1,0,1,1,0.017323,4,0.281723,0.306272,0
千百万(1947),千百万,notion,0,1,1,0,1,1,0.011229,4,0.270366,0.287632,0
千百个(1947),千百个,notion,0,1,1,0,1,1,0.003588,4,0.255396,0.260534,0
千面人(1947),千面人,notion,0,1,1,0,1,1,0.00981,4,0.267191,0.28214,0
卅部(1947),卅部,notion,0,1,1,0,1,1,0.014222,4,0.275404,0.296091,0
升图(1947),升图,notion,0,1,1,0,1,1,0.017323,4,0.281723,0.306272,0
升学(1947),升学,notion,0,3,3,0,3,3,0.035213,4,0.313266,0.351069,7225.62041
半个(1947),半个,notion,0,2,2,0,2,2,0.028442,4,0.300022,0.333394,2187.730369
半升米(1947),半升米,notion,0,1,1,0,1,1,0.013711,4,0.275027,0.295469,0
半封建(1947),半封建,notion,0,1,1,0,1,1,0.009035,4,0.265075,0.278404,0
半年(1947),半年,notion,0,4,4,0,5,5,0.047463,4,0.335166,0.377203,13551.158453
半月刊(1947),半月刊,notion,0,1,1,0,1,1,0.003699,4,0.256009,0.261706,0
半殖民地(1947),半殖民地,notion,0,2,2,0,2,2,0.020265,4,0.284375,0.310471,1611.931322
华北(1947),华北,notion,0,3,3,0,4,4,0.046135,4,0.331006,0.372455,6671.362925
华南(1947),华南,notion,0,3,3,0,3,3,0.043284,4,0.326791,0.367585,7036.110858
华商报(1947),华商报,notion,0,1,1,0,1,1,0.013711,4,0.275027,0.295469,0
华外人(1947),华外人,notion,0,1,1,0,1,1,0.017323,4,0.281723,0.306272,0
华女(1947),华女,notion,0,1,1,0,1,1,0.014732,4,0.276453,0.297813,0
华尔街(1947),华尔街,notion,0,2,2,0,3,3,0.027133,4,0.29671,0.328744,1770.9936
华德侨(1947),华德侨,notion,0,1,1,0,1,1,0.014081,4,0.275493,0.296238,0
华盛顿(1947),华盛顿,notion,0,5,5,0,5,5,0.062255,4,0.358354,0.401396,16759.616536
华罗庚(1947),华罗庚,notion,0,2,2,0,2,2,0.01948,4,0.281468,0.30593,668.20053
华脱(1947),华脱,notion,0,1,1,0,1,1,0.014732,4,0.276453,0.297813,0
协会(1947),协会,notion,0,1,1,0,1,1,0.011229,4,0.270366,0.287632,0
协助(1947),协助,notion,0,1,1,0,1,1,0.017323,4,0.281723,0.306272,0
协定(1947),协定,notion,0,1,1,0,1,1,0.011229,4,0.270366,0.287632,0
协调(1947),协调,notion,0,1,1,0,1,1,0.014222,4,0.275404,0.296091,0
单位(1947),单位,notion,0,1,1,0,1,1,0.011229,4,0.270366,0.287632,0
单方面(1947),单方面,notion,0,1,1,0,1,1,0.00981,4,0.267191,0.28214,0
单独(1947),单独,notion,0,1,1,0,1,1,0.007422,4,0.26356,0.275695,0
单行本(1947),单行本,notion,0,1,1,0,1,1,0.014732,4,0.276453,0.297813,0
卖国(1947),卖国,notion,0,1,1,0,1,1,0.014222,4,0.275404,0.296091,0
卖新丝(1947),卖新丝,notion,0,1,1,0,1,1,0.017323,4,0.281723,0.306272,0
南下(1947),南下,notion,0,2,2,0,3,3,0.028302,4,0.298866,0.331783,1965.8222
南乌(1947),南乌,notion,0,1,1,0,1,1,0.017323,4,0.281723,0.306272,0
南亚(1947),南亚,notion,0,1,1,0,1,1,0.017323,4,0.281723,0.306272,0
南京市(1947),南京市,notion,0,1,1,0,1,1,0.014222,4,0.275404,0.296091,0
南北(1947),南北,notion,0,2,2,0,2,2,0.023521,4,0.291018,0.320504,1911.402908
南北朝(1947),南北朝,notion,0,1,1,0,1,1,0.014732,4,0.276453,0.297813,0
南区(1947),南区,notion,0,1,1,0,1,1,0.017323,4,0.281723,0.306272,0
南宁(1947),南宁,notion,0,1,1,0,2,2,0.013711,4,0.275027,0.295469,0
南岸(1947),南岸,notion,0,1,1,0,1,1,0.013711,4,0.275027,0.295469,0
南征(1947),南征,notion,0,1,1,0,2,2,0.013711,4,0.275027,0.295469,0
南方(1947),南方,notion,0,2,2,0,2,2,0.020912,4,0.285589,0.312338,797.979389
南朝鲜(1947),南朝鲜,notion,0,3,3,0,6,6,0.036169,4,0.309685,0.346455,4415.889012
南汇(1947),南汇,notion,0,1,1,0,2,2,0.007422,4,0.26356,0.275695,0
南洋(1947),南洋,notion,0,1,1,0,2,2,0.017323,4,0.281723,0.306272,0
南渡(1947),南渡,notion,0,1,1,0,1,1,0.014081,4,0.275493,0.296238,0
南疆(1947),南疆,notion,0,1,1,0,1,1,0.014081,4,0.275493,0.296238,0
南菲(1947),南菲,notion,0,1,1,0,1,1,0.00981,4,0.267191,0.28214,0
南行(1947),南行,notion,0,1,1,0,1,1,0.014732,4,0.276453,0.297813,0
南路(1947),南路,notion,0,4,4,0,6,6,0.053752,4,0.345374,0.388226,13094.543338
南部(1947),南部,notion,0,3,3,0,3,3,0.030942,4,0.304518,0.339607,6277.116472
南面(1947),南面,notion,0,1,1,0,1,1,0.013711,4,0.275027,0.295469,0
博士(1947),博士,notion,0,2,2,0,2,2,0.021022,4,0.286837,0.314242,1344.24886
博大(1947),博大,notion,0,1,1,0,1,1,0.007422,4,0.26356,0.275695,0
博爱(1947),博爱,notion,0,1,1,0,1,1,0.014081,4,0.275493,0.296238,0
占领(1947),占领,notion,0,3,3,0,4,4,0.032556,4,0.304112,0.339058,4570.509479
占领区(1947),占领区,notion,0,1,1,0,6,6,0.00981,4,0.267191,0.28214,0
卡尔逊(1947),卡尔逊,notion,0,1,1,0,1,1,0.017323,4,0.281723,0.306272,0
卡迭尔(1947),卡迭尔,notion,0,1,1,0,1,1,0.017323,4,0.281723,0.306272,0
卡通(1947),卡通,notion,0,1,1,0,1,1,0.014732,4,0.276453,0.297813,0
卫州(1947),卫州,notion,0,1,1,0,1,1,0.007422,4,0.26356,0.275695,0
卫生(1947),卫生,notion,0,1,1,0,1,1,0.007422,4,0.26356,0.275695,0
印刷(1947),印刷,notion,0,1,1,0,1,1,0.00981,4,0.267191,0.28214,0
印刷所(1947),印刷所,notion,0,1,1,0,1,1,0.007422,4,0.26356,0.275695,0
印度尼西亚(1947),印度尼西亚,notion,0,1,1,0,2,2,0.00981,4,0.267191,0.28214,0
印荷(1947),印荷,notion,0,3,3,0,3,3,0.042263,4,0.32539,0.365937,6975.425387
印象(1947),印象,notion,0,3,3,0,3,3,0.045256,4,0.33136,0.372858,7302.959362
危亡(1947),危亡,notion,0,1,1,0,1,1,0.009035,4,0.265075,0.278404,0
危局(1947),危局,notion,0,2,2,0,2,2,0.028954,4,0.300154,0.333577,2064.821066
即到(1947),即到,notion,0,1,1,0,1,1,0.014732,4,0.276453,0.297813,0
即刻(1947),即刻,notion,0,1,1,0,1,1,0.003699,4,0.256009,0.261706,0
即将(1947),即将,notion,0,1,1,0,1,1,0.017323,4,0.281723,0.306272,0
卷起(1947),卷起,notion,0,1,1,0,1,1,0.014081,4,0.275493,0.296238,0
卸下来(1947),卸下来,notion,0,1,1,0,1,1,0.003588,4,0.255396,0.260534,0
卿汝楫(1947),卿汝楫,notion,0,1,1,0,1,1,0.014222,4,0.275404,0.296091,0
厂商(1947),厂商,notion,0,1,1,0,1,1,0.017323,4,0.281723,0.306272,0
厄运(1947),厄运,notion,0,2,2,0,4,4,0.028442,4,0.300022,0.333394,2187.730369
历史使命(1947),历史使命,notion,0,1,1,0,1,1,0.002092,4,0.25318,0.25625,0
历史剧(1947),历史剧,notion,0,1,1,0,1,1,0.014732,4,0.276453,0.297813,0
历史性(1947),历史性,notion,0,2,2,0,5,5,0.027133,4,0.29671,0.328744,1770.9936
历史背景(1947),历史背景,notion,0,2,2,0,2,2,0.018829,4,0.280473,0.304355,655.354404
压不住(1947),压不住,notion,0,1,1,0,2,2,0.013711,4,0.275027,0.295469,0
压制(1947),压制,notion,0,1,1,0,1,1,0.014732,4,0.276453,0.297813,0
压死(1947),压死,notion,0,1,1,0,1,1,0.014732,4,0.276453,0.297813,0
压迫(1947),压迫,notion,0,4,4,0,4,4,0.055436,4,0.346989,0.38991,12199.154379
厕所(1947),厕所,notion,0,1,1,0,1,1,0.014081,4,0.275493,0.296238,0
原价(1947),原价,notion,0,1,1,0,1,1,0.014081,4,0.275493,0.296238,0
原作者(1947),原作者,notion,0,1,1,0,1,1,0.014081,4,0.275493,0.296238,0
原则(1947),原则,notion,0,3,3,0,3,3,0.025201,4,0.293773,0.324594,4709.228526
原判(1947),原判,notion,0,1,1,0,1,1,0.017323,4,0.281723,0.306272,0
原因(1947),原因,notion,0,5,5,0,9,9,0.055221,4,0.342979,0.38576,16878.990561
原图(1947),原图,notion,0,1,1,0,1,1,0.00981,4,0.267191,0.28214,0
原子(1947),原子,notion,0,2,2,0,2,2,0.031545,4,0.305336,0.340645,2219.908318
原子弹(1947),原子弹,notion,0,2,2,0,3,3,0.01832,4,0.280681,0.304685,795.39908
原故(1947),原故,notion,0,1,1,0,1,1,0.013711,4,0.275027,0.295469,0
原文(1947),原文,notion,0,2,2,0,2,2,0.01781,4,0.279738,0.303183,818.538823
原来(1947),原来,notion,0,2,2,0,2,2,0.032055,4,0.30624,0.341853,2215.722594
原着(1947),原着,notion,0,1,1,0,1,1,0.014081,4,0.275493,0.296238,0
原载(1947),原载,notion,0,1,1,0,2,2,0.014222,4,0.275404,0.296091,0
原野(1947),原野,notion,0,1,1,0,1,1,0.007422,4,0.26356,0.275695,0
原题(1947),原题,notion,0,2,2,0,2,2,0.018431,4,0.28119,0.30549,1040.874592
去了(1947),去了,notion,0,1,1,0,1,1,0.013711,4,0.275027,0.295469,0
去去(1947),去去,notion,0,1,1,0,1,1,0.013711,4,0.275027,0.295469,0
去年(1947),去年,notion,0,2,2,0,2,2,0.023257,4,0.28761,0.315414,1169.271875
去蔽(1947),去蔽,notion,0,1,1,0,1,1,0.014081,4,0.275493,0.296238,0
县城(1947),县城,notion,0,1,1,0,1,1,0.011229,4,0.270366,0.287632,0
县政(1947),县政,notion,0,1,1,0,1,1,0.017323,4,0.281723,0.306272,0
县联社(1947),县联社,notion,0,1,1,0,2,2,0.007422,4,0.26356,0.275695,0
参事(1947),参事,notion,0,1,1,0,1,1,0.014081,4,0.275493,0.296238,0
参军(1947),参军,notion,0,2,2,0,2,2,0.025451,4,0.295094,0.326437,2353.768712
参府(1947),参府,notion,0,1,1,0,1,1,0.014732,4,0.276453,0.297813,0
参政(1947),参政,notion,0,1,1,0,1,1,0.009035,4,0.265075,0.278404,0
参政会(1947),参政会,notion,0,5,5,0,7,7,0.065106,4,0.361351,0.404289,15765.104512
参议(1947),参议,notion,0,1,1,0,1,1,0.011229,4,0.270366,0.287632,0
参议会(1947),参议会,notion,0,2,2,0,3,3,0.014818,4,0.274563,0.294761,698.886811
参议员(1947),参议员,notion,0,1,1,0,1,1,0.014222,4,0.275404,0.296091,0
参议院(1947),参议院,notion,0,1,1,0,1,1,0.014222,4,0.275404,0.296091,0
参驻(1947),参驻,notion,0,1,1,0,1,1,0.017323,4,0.281723,0.306272,0
又动(1947),又动,notion,0,1,1,0,1,1,0.011229,4,0.270366,0.287632,0
又爱又怕(1947),又爱又怕,notion,0,1,1,0,1,1,0.014081,4,0.275493,0.296238,0
友声(1947),友声,notion,0,2,2,0,31,31,0.027932,4,0.299811,0.333101,2443.455357
友好(1947),友好,notion,0,1,1,0,1,1,0.00981,4,0.267191,0.28214,0
友情(1947),友情,notion,0,1,1,0,1,1,0.014222,4,0.275404,0.296091,0
友谊(1947),友谊,notion,0,4,4,0,5,5,0.046185,4,0.329727,0.371051,11659.744108
友邦(1947),友邦,notion,0,1,1,0,1,1,0.004749,4,0.257108,0.263793,0
双喜临门(1947),双喜临门,notion,0,1,1,0,3,3,0.011229,4,0.270366,0.287632,0
双手(1947),双手,notion,0,1,1,0,1,1,0.014732,4,0.276453,0.297813,0
双方(1947),双方,notion,0,1,1,0,1,1,0.017323,4,0.281723,0.306272,0
双簧(1947),双簧,notion,0,1,1,0,1,1,0.013711,4,0.275027,0.295469,0
反共(1947),反共,notion,0,3,3,0,3,3,0.041865,4,0.321892,0.361762,5813.37408
反击(1947),反击,notion,0,2,2,0,3,3,0.028552,4,0.301506,0.335445,2588.539662
反动(1947),反动,notion,0,5,5,0,9,9,0.059275,4,0.353054,0.39616,17141.608128
反动势力(1947),反动势力,notion,0,2,2,0,2,2,0.027133,4,0.29671,0.328744,1770.9936
反动派(1947),反动派,notion,0,2,2,0,7,7,0.023521,4,0.291018,0.320504,1911.402908
反响(1947),反响,notion,0,3,3,0,3,3,0.046277,4,0.33091,0.372345,6500.451978
反对党(1947),反对党,notion,0,1,1,0,1,1,0.004749,4,0.257108,0.263793,0
反对派(1947),反对派,notion,0,2,2,0,2,2,0.022072,4,0.287175,0.314755,862.424175
反帝(1947),反帝,notion,0,2,2,0,2,2,0.023891,4,0.292014,0.321969,2116.906395
反应(1947),反应,notion,0,3,3,0,4,4,0.036152,4,0.310784,0.347883,3947.803671
反悔(1947),反悔,notion,0,1,1,0,1,1,0.013711,4,0.275027,0.295469,0
反战(1947),反战,notion,0,1,1,0,1,1,0.014732,4,0.276453,0.297813,0
反抗(1947),反抗,notion,0,3,3,0,4,4,0.03475,4,0.309488,0.346199,5532.888574
反映(1947),反映,notion,0,1,1,0,1,1,0.017323,4,0.281723,0.306272,0
反法西斯(1947),反法西斯,notion,0,2,2,0,2,2,0.027133,4,0.29671,0.328744,1770.9936
反法西斯战争(1947),反法西斯战争,notion,0,1,1,0,1,1,0.011229,4,0.270366,0.287632,0
反省(1947),反省,notion,0,2,2,0,4,4,0.025451,4,0.295094,0.326437,2353.768712
反美(1947),反美,notion,0,1,1,0,1,1,0.017323,4,0.281723,0.306272,0
反美乎(1947),反美乎,notion,0,1,1,0,1,1,0.009035,4,0.265075,0.278404,0
反美潮(1947),反美潮,notion,0,1,1,0,1,1,0.00981,4,0.267191,0.28214,0
反苏(1947),反苏,notion,0,3,3,0,3,3,0.035754,4,0.311068,0.34825,4600.846046
反面(1947),反面,notion,0,1,1,0,1,1,0.003588,4,0.255396,0.260534,0
发出(1947),发出,notion,0,2,2,0,2,2,0.021022,4,0.286837,0.314242,1344.24886
发扬(1947),发扬,notion,0,1,1,0,1,1,0.014222,4,0.275404,0.296091,0
发挥(1947),发挥,notion,0,1,1,0,1,1,0.017323,4,0.281723,0.306272,0
发现(1947),发现,notion,0,2,2,0,2,2,0.028302,4,0.298866,0.331783,1965.8222
发生(1947),发生,notion,0,2,2,0,2,2,0.014818,4,0.274563,0.294761,698.886811
发行(1947),发行,notion,0,5,5,0,6,6,0.04183,4,0.319541,0.359028,12929.692487
发表演说(1947),发表演说,notion,0,1,1,0,1,1,0.017323,4,0.281723,0.306272,0
发言(1947),发言,notion,0,1,1,0,1,1,0.009035,4,0.265075,0.278404,0
发言人(1947),发言人,notion,0,2,2,0,3,3,0.022746,4,0.288631,0.316952,1575.703869
叔孙通(1947),叔孙通,notion,0,2,2,0,2,2,0.01832,4,0.280681,0.304685,795.39908
取暖(1947),取暖,notion,0,1,1,0,1,1,0.014732,4,0.276453,0.297813,0
取材(1947),取材,notion,0,1,1,0,1,1,0.014222,4,0.275404,0.296091,0
取消(1947),取消,notion,0,3,3,0,3,3,0.033496,4,0.308621,0.345064,4530.343632
取缔(1947),取缔,notion,0,3,3,0,3,3,0.046135,4,0.331006,0.372455,6671.362925
受到(1947),受到,notion,0,1,1,0,1,1,0.011229,4,0.270366,0.287632,0
受阻(1947),受阻,notion,0,1,1,0,1,1,0.014732,4,0.276453,0.297813,0
受难(1947),受难,notion,0,1,1,0,2,2,0.013711,4,0.275027,0.295469,0
变乱(1947),变乱,notion,0,1,1,0,1,1,0.017323,4,0.281723,0.306272,0
变则通(1947),变则通,notion,0,1,1,0,1,1,0.014081,4,0.275493,0.296238,0
变动(1947),变动,notion,0,4,4,0,4,4,0.039745,4,0.314391,0.352558,7311.315475
变化(1947),变化,notion,0,5,5,0,5,5,0.056831,4,0.349046,0.392095,16489.663588
变天(1947),变天,notion,0,1,1,0,1,1,0.013711,4,0.275027,0.295469,0
变好(1947),变好,notion,0,1,1,0,1,1,0.003699,4,0.256009,0.261706,0
变戏法(1947),变戏法,notion,0,1,1,0,1,1,0.014732,4,0.276453,0.297813,0
变成(1947),变成,notion,0,1,1,0,1,1,0.00981,4,0.267191,0.28214,0
变更(1947),变更,notion,0,2,2,0,2,2,0.028954,4,0.300154,0.333577,2064.821066
变猪(1947),变猪,notion,0,1,1,0,1,1,0.011229,4,0.270366,0.287632,0
变蛋(1947),变蛋,notion,0,1,1,0,1,1,0.014732,4,0.276453,0.297813,0
变革(1947),变革,notion,0,1,1,0,1,1,0.014732,4,0.276453,0.297813,0
叙餐(1947),叙餐,notion,0,1,1,0,1,1,0.003588,4,0.255396,0.260534,0
叛乱(1947),叛乱,notion,0,1,1,0,1,1,0.017323,4,0.281723,0.306272,0
叛徒(1947),叛徒,notion,0,1,1,0,3,3,0.013711,4,0.275027,0.295469,0
叛逆(1947),叛逆,notion,0,1,1,0,1,1,0.011229,4,0.270366,0.287632,0
口中(1947),口中,notion,0,1,1,0,1,1,0.013711,4,0.275027,0.295469,0
古城(1947),古城,notion,0,2,2,0,3,3,0.01741,4,0.280151,0.303843,1198.480437
古寺(1947),古寺,notion,0,1,1,0,1,1,0.014222,4,0.275404,0.296091,0
古文(1947),古文,notion,0,1,1,0,1,1,0.013711,4,0.275027,0.295469,0
古蹟(1947),古蹟,notion,0,1,1,0,1,1,0.014081,4,0.275493,0.296238,0
只怕(1947),只怕,notion,0,1,1,0,1,1,0.014732,4,0.276453,0.297813,0
只是(1947),只是,notion,0,1,1,0,1,1,0.013711,4,0.275027,0.295469,0
只有(1947),只有,notion,0,2,2,0,3,3,0.021039,4,0.286524,0.313766,1874.195629
叫做(1947),叫做,notion,0,2,2,0,2,2,0.018459,4,0.281051,0.305271,917.367375
叫喊(1947),叫喊,notion,0,1,1,0,1,1,0.013711,4,0.275027,0.295469,0
叫嚣(1947),叫嚣,notion,0,2,2,0,2,2,0.027133,4,0.29671,0.328744,1770.9936
叫声(1947),叫声,notion,0,1,1,0,1,1,0.014222,4,0.275404,0.296091,0
可充(1947),可充,notion,0,1,1,0,1,1,0.014081,4,0.275493,0.296238,0
可办(1947),可办,notion,0,1,1,0,1,1,0.014732,4,0.276453,0.297813,0
可否(1947),可否,notion,0,1,1,0,1,1,0.003699,4,0.256009,0.261706,0
可怕(1947),可怕,notion,0,3,3,0,5,5,0.045114,4,0.331456,0.372968,7474.911045
可怜(1947),可怜,notion,0,2,2,0,2,2,0.028954,4,0.300154,0.333577,2064.821066
可悲(1947),可悲,notion,0,1,1,0,1,1,0.014222,4,0.275404,0.296091,0
可有(1947),可有,notion,0,1,1,0,1,1,0.013711,4,0.275027,0.295469,0
可望(1947),可望,notion,0,1,1,0,1,1,0.014222,4,0.275404,0.296091,0
可畏(1947),可畏,notion,0,2,2,0,2,2,0.031545,4,0.305336,0.340645,2219.908318
可笑(1947),可笑,notion,0,1,1,0,1,1,0.013711,4,0.275027,0.295469,0
可耻(1947),可耻,notion,0,1,1,0,1,1,0.014732,4,0.276453,0.297813,0
可能(1947),可能,notion,0,5,5,0,5,5,0.067779,4,0.372958,0.415055,22133.906433
可言(1947),可言,notion,0,1,1,0,1,1,0.014732,4,0.276453,0.297813,0
可贵(1947),可贵,notion,0,1,1,0,1,1,0.014732,4,0.276453,0.297813,0
可赦乎(1947),可赦乎,notion,0,1,1,0,1,1,0.014222,4,0.275404,0.296091,0
可闻(1947),可闻,notion,0,1,1,0,1,1,0.014222,4,0.275404,0.296091,0
可靠(1947),可靠,notion,0,1,1,0,1,1,0.003699,4,0.256009,0.261706,0
台北(1947),台北,notion,0,2,2,0,2,2,0.028442,4,0.300022,0.333394,2187.730369
台山(1947),台山,notion,0,1,1,0,2,2,0.011229,4,0.270366,0.287632,0
台湾人(1947),台湾人,notion,0,1,1,0,1,1,0.014081,4,0.275493,0.296238,0
台胞(1947),台胞,notion,0,1,1,0,1,1,0.013711,4,0.275027,0.295469,0
史地(1947),史地,notion,0,1,1,0,1,1,0.014732,4,0.276453,0.297813,0
史塔森(1947),史塔森,notion,0,1,1,0,1,1,0.009035,4,0.265075,0.278404,0
史大林宪法(1947),史大林宪法,notion,0,1,1,0,1,1,0.00981,4,0.267191,0.28214,0
史学家(1947),史学家,notion,0,1,1,0,1,1,0.014081,4,0.275493,0.296238,0
史学方法(1947),史学方法,notion,0,1,1,0,1,1,0.014222,4,0.275404,0.296091,0
史料(1947),史料,notion,0,1,1,0,1,1,0.014081,4,0.275493,0.296238,0
史特朗(1947),史特朗,notion,0,1,1,0,1,1,0.017323,4,0.281723,0.306272,0
史略(1947),史略,notion,0,1,1,0,1,1,0.009035,4,0.265075,0.278404,0
史考(1947),史考,notion,0,1,1,0,1,1,0.017323,4,0.281723,0.306272,0
史记(1947),史记,notion,0,1,1,0,1,1,0.017323,4,0.281723,0.306272,0
史诗(1947),史诗,notion,0,1,1,0,1,1,0.017323,4,0.281723,0.306272,0
史达林(1947),史达林,notion,0,1,1,0,1,1,0.003699,4,0.256009,0.261706,0
史迹(1947),史迹,notion,0,1,1,0,1,1,0.011229,4,0.270366,0.287632,0
史靖(1947),史靖,notion,0,1,1,0,1,1,0.014732,4,0.276453,0.297813,0
史靖着(1947),史靖着,notion,0,1,1,0,1,1,0.014081,4,0.275493,0.296238,0
叶子(1947),叶子,notion,0,1,1,0,1,1,0.013711,4,0.275027,0.295469,0
叶楚伧(1947),叶楚伧,notion,0,1,1,0,1,1,0.014222,4,0.275404,0.296091,0
司坦(1947),司坦,notion,0,1,1,0,1,1,0.014732,4,0.276453,0.297813,0
司徒雷登(1947),司徒雷登,notion,0,2,2,0,2,2,0.013321,4,0.273004,0.292161,986.216711
司披(1947),司披,notion,0,1,1,0,1,1,0.009035,4,0.265075,0.278404,0
司机(1947),司机,notion,0,1,1,0,1,1,0.007422,4,0.26356,0.275695,0
司法(1947),司法,notion,0,1,1,0,1,1,0.014081,4,0.275493,0.296238,0
司马迁(1947),司马迁,notion,0,1,1,0,1,1,0.017323,4,0.281723,0.306272,0
吃人(1947),吃人,notion,0,1,1,0,1,1,0.013711,4,0.275027,0.295469,0
吃光(1947),吃光,notion,0,1,1,0,2,2,0.013711,4,0.275027,0.295469,0
各业(1947),各业,notion,0,1,1,0,1,1,0.009035,4,0.265075,0.278404,0
各个(1947),各个,notion,0,1,1,0,1,1,0.007422,4,0.26356,0.275695,0
各党(1947),各党,notion,0,1,1,0,1,1,0.003588,4,0.255396,0.260534,0
各党派(1947),各党派,notion,0,1,1,0,1,1,0.014732,4,0.276453,0.297813,0
各地(1947),各地,notion,0,1,1,0,2,2,0.011229,4,0.270366,0.287632,0
各尽其(1947),各尽其,notion,0,1,1,0,1,1,0.007422,4,0.26356,0.275695,0
各报(1947),各报,notion,0,1,1,0,1,1,0.017323,4,0.281723,0.306272,0
各方(1947),各方,notion,0,2,2,0,2,2,0.031545,4,0.305336,0.340645,2219.908318
各方对(1947),各方对,notion,0,1,1,0,1,1,0.014732,4,0.276453,0.297813,0
各校(1947),各校,notion,0,1,1,0,1,1,0.017323,4,0.281723,0.306272,0
各派(1947),各派,notion,0,1,1,0,1,1,0.003588,4,0.255396,0.260534,0
合作社(1947),合作社,notion,0,1,1,0,1,1,0.00981,4,0.267191,0.28214,0
合并(1947),合并,notion,0,2,2,0,2,2,0.032055,4,0.30624,0.341853,2215.722594
合法化(1947),合法化,notion,0,1,1,0,1,1,0.00981,4,0.267191,0.28214,0
合理(1947),合理,notion,0,1,1,0,1,1,0.014081,4,0.275493,0.296238,0
合立(1947),合立,notion,0,1,1,0,1,1,0.011229,4,0.270366,0.287632,0
合肥(1947),合肥,notion,0,2,2,0,2,2,0.028954,4,0.300154,0.333577,2064.821066
吊胃口(1947),吊胃口,notion,0,1,1,0,1,1,0.014732,4,0.276453,0.297813,0
同事(1947),同事,notion,0,1,1,0,1,1,0.013711,4,0.275027,0.295469,0
同人(1947),同人,notion,0,1,1,0,1,1,0.017323,4,0.281723,0.306272,0
同仁(1947),同仁,notion,0,1,1,0,1,1,0.007422,4,0.26356,0.275695,0
同命(1947),同命,notion,0,1,1,0,1,1,0.014222,4,0.275404,0.296091,0
同声(1947),同声,notion,0,1,1,0,1,1,0.017323,4,0.281723,0.306272,0
同好(1947),同好,notion,0,1,1,0,1,1,0.014732,4,0.276453,0.297813,0
同工(1947),同工,notion,0,1,1,0,1,1,0.017323,4,0.281723,0.306272,0
同志会(1947),同志会,notion,0,1,1,0,1,1,0.017323,4,0.281723,0.306272,0
同情(1947),同情,notion,0,3,3,0,4,4,0.043284,4,0.326791,0.367585,7036.110858
同情心(1947),同情心,notion,0,1,1,0,1,1,0.007422,4,0.26356,0.275695,0
同意(1947),同意,notion,0,1,1,0,1,1,0.014732,4,0.276453,0.297813,0
同是(1947),同是,notion,0,1,1,0,1,1,0.004749,4,0.257108,0.263793,0
同盟(1947),同盟,notion,0,1,1,0,1,1,0.017323,4,0.281723,0.306272,0
同盟条约(1947),同盟条约,notion,0,1,1,0,1,1,0.00981,4,0.267191,0.28214,0
同胞(1947),同胞,notion,0,2,2,0,2,2,0.031034,4,0.30613,0.341707,2639.595687
名人(1947),名人,notion,0,1,1,0,2,2,0.014222,4,0.275404,0.296091,0
名作家(1947),名作家,notion,0,1,1,0,1,1,0.017323,4,0.281723,0.306272,0
名字(1947),名字,notion,0,1,1,0,1,1,0.004749,4,0.257108,0.263793,0
名流(1947),名流,notion,0,1,1,0,1,1,0.017323,4,0.281723,0.306272,0
后之(1947),后之,notion,0,1,1,0,1,1,0.014732,4,0.276453,0.297813,0
后台(1947),后台,notion,0,1,1,0,1,1,0.017323,4,0.281723,0.306272,0
后的(1947),后的,notion,0,1,1,0,1,1,0.014222,4,0.275404,0.296091,0
后记(1947),后记,notion,0,2,2,0,2,2,0.023116,4,0.288412,0.316623,1358.22258
后面(1947),后面,notion,0,1,1,0,1,1,0.014081,4,0.275493,0.296238,0
吏夜(1947),吏夜,notion,0,1,1,0,1,1,0.014732,4,0.276453,0.297813,0
向前(1947),向前,notion,0,1,1,0,1,1,0.014081,4,0.275493,0.296238,0
吕正操(1947),吕正操,notion,0,1,1,0,1,1,0.013711,4,0.275027,0.295469,0
吕运亨(1947),吕运亨,notion,0,1,1,0,1,1,0.017323,4,0.281723,0.306272,0
君病(1947),君病,notion,0,1,1,0,1,1,0.009035,4,0.265075,0.278404,0
否乎(1947),否乎,notion,0,1,1,0,1,1,0.003699,4,0.256009,0.261706,0
否决权(1947),否决权,notion,0,1,1,0,1,1,0.014732,4,0.276453,0.297813,0
听不懂(1947),听不懂,notion,0,1,1,0,2,2,0.011229,4,0.270366,0.287632,0
吴国桢(1947),吴国桢,notion,0,1,1,0,1,1,0.009035,4,0.265075,0.278404,0
吴天(1947),吴天,notion,0,1,1,0,1,1,0.017323,4,0.281723,0.306272,0
吴恩裕(1947),吴恩裕,notion,0,2,2,0,2,2,0.028302,4,0.298866,0.331783,1965.8222
吴景超(1947),吴景超,notion,0,1,1,0,1,1,0.014081,4,0.275493,0.296238,0
吸入(1947),吸入,notion,0,1,1,0,1,1,0.014081,4,0.275493,0.296238,0
吾人(1947),吾人,notion,0,1,1,0,1,1,0.009035,4,0.265075,0.278404,0
吾国(1947),吾国,notion,0,3,3,0,3,3,0.028006,4,0.292339,0.322506,2276.459601
告一段落(1947),告一段落,notion,0,1,1,0,1,1,0.014222,4,0.275404,0.296091,0
告别(1947),告别,notion,0,2,2,0,2,2,0.021502,4,0.288388,0.316586,2245.621531
告捷(1947),告捷,notion,0,1,1,0,1,1,0.011229,4,0.270366,0.287632,0
告状(1947),告状,notion,0,1,1,0,1,1,0.014081,4,0.275493,0.296238,0
告警(1947),告警,notion,0,1,1,0,1,1,0.017323,4,0.281723,0.306272,0
呐喊(1947),呐喊,notion,0,1,1,0,1,1,0.017323,4,0.281723,0.306272,0
周刊(1947),周刊,notion,0,3,3,0,3,3,0.032542,4,0.30441,0.339461,3678.75897
周年纪念(1947),周年纪念,notion,0,3,3,0,5,5,0.038362,4,0.317019,0.355793,6233.72889
周报(1947),周报,notion,0,1,1,0,1,1,0.00981,4,0.267191,0.28214,0
周朝(1947),周朝,notion,0,1,1,0,1,1,0.014222,4,0.275404,0.296091,0
周段(1947),周段,notion,0,1,1,0,1,1,0.007422,4,0.26356,0.275695,0
周浦(1947),周浦,notion,0,1,1,0,1,1,0.007422,4,0.26356,0.275695,0
周谷城(1947),周谷城,notion,0,1,1,0,1,1,0.014222,4,0.275404,0.296091,0
周鲸文(1947),周鲸文,notion,0,1,1,0,1,1,0.017323,4,0.281723,0.306272,0
呼吸(1947),呼吸,notion,0,1,1,0,1,1,0.014732,4,0.276453,0.297813,0
呼啸(1947),呼啸,notion,0,1,1,0,1,1,0.011229,4,0.270366,0.287632,0
呼声(1947),呼声,notion,0,3,3,0,5,5,0.04058,4,0.317727,0.356672,4950.672902
呼籲(1947),呼籲,notion,0,1,1,0,3,3,0.014081,4,0.275493,0.296238,0
命令(1947),命令,notion,0,1,1,0,1,1,0.00981,4,0.267191,0.28214,0
命吗(1947),命吗,notion,0,1,1,0,1,1,0.013711,4,0.275027,0.295469,0
命脉(1947),命脉,notion,0,1,1,0,1,1,0.014222,4,0.275404,0.296091,0
命运(1947),命运,notion,0,5,5,0,6,6,0.055257,4,0.343774,0.386602,15333.551823
和尚(1947),和尚,notion,0,1,1,0,1,1,0.009035,4,0.265075,0.278404,0
和平攻势(1947),和平攻势,notion,0,1,1,0,1,1,0.003699,4,0.256009,0.261706,0
和平解决(1947),和平解决,notion,0,1,1,0,1,1,0.014081,4,0.275493,0.296238,0
和文(1947),和文,notion,0,1,1,0,1,1,0.014081,4,0.275493,0.296238,0
和民说(1947),和民说,notion,0,1,1,0,1,1,0.017323,4,0.281723,0.306272,0
和谈(1947),和谈,notion,0,5,5,0,6,6,0.065106,4,0.361351,0.404289,15765.104512
哀尸吟(1947),哀尸吟,notion,0,1,1,0,1,1,0.017323,4,0.281723,0.306272,0
哀情(1947),哀情,notion,0,1,1,0,1,1,0.014081,4,0.275493,0.296238,0
哀鸣(1947),哀鸣,notion,0,1,1,0,2,2,0.013711,4,0.275027,0.295469,0
哈勒(1947),哈勒,notion,0,1,1,0,1,1,0.00981,4,0.267191,0.28214,0
哈密(1947),哈密,notion,0,1,1,0,1,1,0.014081,4,0.275493,0.296238,0
哈尔滨(1947),哈尔滨,notion,0,1,1,0,1,1,0.013711,4,0.275027,0.295469,0
哈泰(1947),哈泰,notion,0,1,1,0,1,1,0.017323,4,0.281723,0.306272,0
哈达(1947),哈达,notion,0,1,1,0,1,1,0.017323,4,0.281723,0.306272,0
响应(1947),响应,notion,0,4,4,0,5,5,0.047207,4,0.33428,0.376215,10788.494528
哥尔基(1947),哥尔基,notion,0,1,1,0,1,1,0.00981,4,0.267191,0.28214,0
哪里(1947),哪里,notion,0,1,1,0,1,1,0.013711,4,0.275027,0.295469,0
哭忆(1947),哭忆,notion,0,1,1,0,1,1,0.003588,4,0.255396,0.260534,0
哭灵(1947),哭灵,notion,0,1,1,0,1,1,0.014732,4,0.276453,0.297813,0
哲学史(1947),哲学史,notion,0,1,1,0,1,1,0.007422,4,0.26356,0.275695,0
哲学家(1947),哲学家,notion,0,2,2,0,2,2,0.023767,4,0.289685,0.318527,1452.186204
售价(1947),售价,notion,0,1,1,0,1,1,0.014081,4,0.275493,0.296238,0
唯一(1947),唯一,notion,0,1,1,0,1,1,0.013711,4,0.275027,0.295469,0
唯恐(1947),唯恐,notion,0,1,1,0,1,1,0.013711,4,0.275027,0.295469,0
商业(1947),商业,notion,0,2,2,0,2,2,0.027932,4,0.299811,0.333101,2443.455357
商业银行(1947),商业银行,notion,0,1,1,0,1,1,0.014081,4,0.275493,0.296238,0
商兑(1947),商兑,notion,0,1,1,0,1,1,0.007422,4,0.26356,0.275695,0
商家(1947),商家,notion,0,1,1,0,1,1,0.011229,4,0.270366,0.287632,0
商店(1947),商店,notion,0,1,1,0,1,1,0.014732,4,0.276453,0.297813,0
商讨(1947),商讨,notion,0,2,2,0,2,2,0.031545,4,0.305336,0.340645,2219.908318
商运(1947),商运,notion,0,1,1,0,1,1,0.007422,4,0.26356,0.275695,0
商量(1947),商量,notion,0,2,2,0,2,2,0.02494,4,0.292941,0.323324,1747.290038
善后(1947),善后,notion,0,1,1,0,1,1,0.014732,4,0.276453,0.297813,0
善邻(1947),善邻,notion,0,1,1,0,1,1,0.00981,4,0.267191,0.28214,0
喊声(1947),喊声,notion,0,1,1,0,1,1,0.011229,4,0.270366,0.287632,0
喜鹊(1947),喜鹊,notion,0,1,1,0,1,1,0.014732,4,0.276453,0.297813,0
嘉定(1947),嘉定,notion,0,1,1,0,1,1,0.014222,4,0.275404,0.296091,0
嘉工曲(1947),嘉工曲,notion,0,1,1,0,1,1,0.014732,4,0.276453,0.297813,0
嘉木(1947),嘉木,notion,0,1,1,0,1,1,0.014081,4,0.275493,0.296238,0
嘴墟(1947),嘴墟,notion,0,1,1,0,1,1,0.011229,4,0.270366,0.287632,0
嘴脸(1947),嘴脸,notion,0,2,2,0,2,2,0.01741,4,0.280151,0.303843,1198.480437
噤若寒蝉(1947),噤若寒蝉,notion,0,1,1,0,1,1,0.00981,4,0.267191,0.28214,0
囚徒(1947),囚徒,notion,0,1,1,0,1,1,0.013711,4,0.275027,0.295469,0
囚笼(1947),囚笼,notion,0,1,1,0,1,1,0.011229,4,0.270366,0.287632,0
四个(1947),四个,notion,0,1,1,0,1,1,0.00981,4,0.267191,0.28214,0
四位(1947),四位,notion,0,1,1,0,1,1,0.013711,4,0.275027,0.295469,0
四八(1947),四八,notion,0,2,2,0,2,2,0.02494,4,0.292941,0.323324,1747.290038
四千元(1947),四千元,notion,0,1,1,0,1,1,0.014081,4,0.275493,0.296238,0
四周(1947),四周,notion,0,1,1,0,1,1,0.00981,4,0.267191,0.28214,0
四大(1947),四大,notion,0,3,3,0,3,3,0.046277,4,0.33091,0.372345,6500.451978
四川(1947),四川,notion,0,3,3,0,4,4,0.045766,4,0.331424,0.372931,7043.04865
四川省(1947),四川省,notion,0,1,1,0,1,1,0.014222,4,0.275404,0.296091,0
四幅(1947),四幅,notion,0,4,4,0,6,6,0.047271,4,0.329473,0.370758,8859.558187
四平(1947),四平,notion,0,1,1,0,1,1,0.014081,4,0.275493,0.296238,0
四法(1947),四法,notion,0,1,1,0,1,1,0.004749,4,0.257108,0.263793,0
四种(1947),四种,notion,0,1,1,0,1,1,0.014732,4,0.276453,0.297813,0
四章(1947),四章,notion,0,1,1,0,1,1,0.003699,4,0.256009,0.261706,0
四篇(1947),四篇,notion,0,1,1,0,1,1,0.003699,4,0.256009,0.261706,0
四面楚歌(1947),四面楚歌,notion,0,1,1,0,1,1,0.013711,4,0.275027,0.295469,0
四首(1947),四首,notion,0,1,1,0,1,1,0.017323,4,0.281723,0.306272,0
四鸟(1947),四鸟,notion,0,1,1,0,1,1,0.014732,4,0.276453,0.297813,0
回乡(1947),回乡,notion,0,2,2,0,2,2,0.02531,4,0.2954,0.326876,2496.768821
回击(1947),回击,notion,0,1,1,0,1,1,0.017323,4,0.281723,0.306272,0
回到(1947),回到,notion,0,1,1,0,2,2,0.007422,4,0.26356,0.275695,0
回国(1947),回国,notion,0,5,5,0,5,5,0.038543,4,0.309629,0.346504,7927.975155
回声(1947),回声,notion,0,1,1,0,1,1,0.011229,4,0.270366,0.287632,0
回头是岸(1947),回头是岸,notion,0,1,1,0,1,1,0.011229,4,0.270366,0.287632,0
回家(1947),回家,notion,0,1,1,0,2,2,0.014081,4,0.275493,0.296238,0
回忆(1947),回忆,notion,0,2,2,0,7,7,0.018651,4,0.283055,0.30842,2017.209887
回来(1947),回来,notion,0,1,1,0,1,1,0.000869,4,0.251131,0.252222,0
回溯(1947),回溯,notion,0,1,1,0,3,3,0.007422,4,0.26356,0.275695,0
回顾(1947),回顾,notion,0,4,4,0,4,4,0.035662,4,0.310926,0.348128,9308.723851
回首(1947),回首,notion,0,1,1,0,1,1,0.007422,4,0.26356,0.275695,0
因地制宜(1947),因地制宜,notion,0,1,1,0,1,1,0.014081,4,0.275493,0.296238,0
因果(1947),因果,notion,0,1,1,0,1,1,0.014081,4,0.275493,0.296238,0
因素(1947),因素,notion,0,2,2,0,3,3,0.028552,4,0.301506,0.335445,2588.539662
团圆(1947),团圆,notion,0,1,1,0,1,1,0.013711,4,0.275027,0.295469,0
团结(1947),团结,notion,0,5,5,0,8,8,0.064101,4,0.361504,0.404436,18070.725801
园中(1947),园中,notion,0,1,1,0,1,1,0.014081,4,0.275493,0.296238,0
园地(1947),园地,notion,0,1,1,0,1,1,0.007422,4,0.26356,0.275695,0
困厄(1947),困厄,notion,0,1,1,0,1,1,0.007422,4,0.26356,0.275695,0
困死(1947),困死,notion,0,1,1,0,1,1,0.013711,4,0.275027,0.295469,0
困苦(1947),困苦,notion,0,3,3,0,3,3,0.025771,4,0.292239,0.32236,2659.732536
困难(1947),困难,notion,0,5,5,0,6,6,0.067779,4,0.372958,0.415055,22133.906433
围攻(1947),围攻,notion,0,1,1,0,1,1,0.013711,4,0.275027,0.295469,0
围绕(1947),围绕,notion,0,2,2,0,2,2,0.021039,4,0.286524,0.313766,1874.195629
围追(1947),围追,notion,0,1,1,0,1,1,0.014081,4,0.275493,0.296238,0
固执(1947),固执,notion,0,2,2,0,2,2,0.01948,4,0.281468,0.30593,668.20053
国事(1947),国事,notion,0,2,2,0,2,2,0.031545,4,0.305336,0.340645,2219.908318
国产(1947),国产,notion,0,1,1,0,1,1,0.017323,4,0.281723,0.306272,0
国人(1947),国人,notion,0,1,1,0,1,1,0.002092,4,0.25318,0.25625,0
国代选举(1947),国代选举,notion,0,2,2,0,3,3,0.028442,4,0.300022,0.333394,2187.730369
国会(1947),国会,notion,0,2,2,0,2,2,0.018845,4,0.280243,0.303989,1083.402703
国共两党(1947),国共两党,notion,0,1,1,0,1,1,0.014081,4,0.275493,0.296238,0
国内(1947),国内,notion,0,5,5,0,5,5,0.061064,4,0.359297,0.402312,18845.398922
国务会议(1947),国务会议,notion,0,1,1,0,1,1,0.017323,4,0.281723,0.306272,0
国务卿(1947),国务卿,notion,0,3,3,0,4,4,0.019714,4,0.280889,0.305075,1785.593428
国吊(1947),国吊,notion,0,1,1,0,1,1,0.017323,4,0.281723,0.306272,0
国土(1947),国土,notion,0,1,1,0,1,1,0.014081,4,0.275493,0.296238,0
国境(1947),国境,notion,0,2,2,0,2,2,0.024032,4,0.290894,0.320321,1695.498775
国大(1947),国大,notion,0,2,2,0,3,3,0.031545,4,0.305336,0.340645,2219.908318
国家化(1947),国家化,notion,0,2,2,0,2,2,0.023116,4,0.288412,0.316623,1358.22258
国家计划(1947),国家计划,notion,0,1,1,0,1,1,0.00981,4,0.267191,0.28214,0
国庆(1947),国庆,notion,0,2,2,0,2,2,0.025451,4,0.295094,0.326437,2353.768712
国府(1947),国府,notion,0,2,2,0,2,2,0.028954,4,0.300154,0.333577,2064.821066
国度(1947),国度,notion,0,1,1,0,1,1,0.004749,4,0.257108,0.263793,0
国情(1947),国情,notion,0,1,1,0,1,1,0.004749,4,0.257108,0.263793,0
国文(1947),国文,notion,0,1,1,0,1,1,0.014081,4,0.275493,0.296238,0
国是(1947),国是,notion,0,2,2,0,2,2,0.021022,4,0.286837,0.314242,1344.24886
国权(1947),国权,notion,0,1,1,0,1,1,0.014081,4,0.275493,0.296238,0
国格(1947),国格,notion,0,1,1,0,1,1,0.017323,4,0.281723,0.306272,0
国民(1947),国民,notion,0,3,3,0,3,3,0.033702,4,0.304763,0.339937,3390.232489
国民党员(1947),国民党员,notion,0,1,1,0,1,1,0.003699,4,0.256009,0.261706,0
国民大会(1947),国民大会,notion,0,1,1,0,1,1,0.014222,4,0.275404,0.296091,0
国民教育(1947),国民教育,notion,0,1,1,0,1,1,0.00981,4,0.267191,0.28214,0
国民经济(1947),国民经济,notion,0,2,2,0,2,2,0.024032,4,0.290894,0.320321,1695.498775
国父(1947),国父,notion,0,2,2,0,3,3,0.024745,4,0.295069,0.3264,2684.608967
国病(1947),国病,notion,0,1,1,0,1,1,0.004749,4,0.257108,0.263793,0
国立(1947),国立,notion,0,1,1,0,2,2,0.014222,4,0.275404,0.296091,0
国立大学(1947),国立大学,notion,0,1,1,0,1,1,0.017323,4,0.281723,0.306272,0
国策(1947),国策,notion,0,2,2,0,2,2,0.023257,4,0.28761,0.315414,1169.271875
国营(1947),国营,notion,0,1,1,0,1,1,0.014081,4,0.275493,0.296238,0
国营事业(1947),国营事业,notion,0,2,2,0,3,3,0.016824,4,0.279052,0.302085,1055.66771
国营农场(1947),国营农场,notion,0,1,1,0,1,1,0.00981,4,0.267191,0.28214,0
国葬(1947),国葬,notion,0,1,1,0,1,1,0.014081,4,0.275493,0.296238,0
国讯(1947),国讯,notion,0,2,2,0,5,5,0.031545,4,0.305336,0.340645,2219.908318
国货(1947),国货,notion,0,3,3,0,3,3,0.031631,4,0.304954,0.340193,4897.877694
国运(1947),国运,notion,0,1,1,0,1,1,0.014222,4,0.275404,0.296091,0
国选(1947),国选,notion,0,1,1,0,1,1,0.011229,4,0.270366,0.287632,0
国防(1947),国防,notion,0,1,1,0,1,1,0.014222,4,0.275404,0.296091,0
国际公法(1947),国际公法,notion,0,1,1,0,1,1,0.014081,4,0.275493,0.296238,0
国际法(1947),国际法,notion,0,2,2,0,2,2,0.023116,4,0.288412,0.316623,1358.22258
国际背景(1947),国际背景,notion,0,1,1,0,1,1,0.017323,4,0.281723,0.306272,0
国难(1947),国难,notion,0,1,1,0,1,1,0.014222,4,0.275404,0.296091,0
图书(1947),图书,notion,0,1,1,0,2,2,0.007422,4,0.26356,0.275695,0
图书馆(1947),图书馆,notion,0,3,3,0,3,3,0.038455,4,0.320381,0.359931,7898.913264
图卷(1947),图卷,notion,0,1,1,0,1,1,0.017323,4,0.281723,0.306272,0
图录(1947),图录,notion,0,1,1,0,1,1,0.013711,4,0.275027,0.295469,0
图绘(1947),图绘,notion,0,1,1,0,1,1,0.000869,4,0.251131,0.252222,0
圈套(1947),圈套,notion,0,1,1,0,1,1,0.013711,4,0.275027,0.295469,0
圈里(1947),圈里,notion,0,1,1,0,1,1,0.011229,4,0.270366,0.287632,0
土匪(1947),土匪,notion,0,2,2,0,2,2,0.028442,4,0.300022,0.333394,2187.730369
土地改革(1947),土地改革,notion,0,4,4,0,10,10,0.04883,4,0.336322,0.378485,12551.854058
土地法(1947),土地法,notion,0,1,1,0,5,5,0.013711,4,0.275027,0.295469,0
土耳其(1947),土耳其,notion,0,3,3,0,6,6,0.033067,4,0.303059,0.33763,3948.173354
土邦(1947),土邦,notion,0,1,1,0,1,1,0.017323,4,0.281723,0.306272,0
土霸(1947),土霸,notion,0,1,1,0,1,1,0.011229,4,0.270366,0.287632,0
圣约翰(1947),圣约翰,notion,0,1,1,0,1,1,0.013711,4,0.275027,0.295469,0
圣诞夜(1947),圣诞夜,notion,0,1,1,0,1,1,0.014081,4,0.275493,0.296238,0
在世界上(1947),在世界上,notion,0,3,3,0,3,3,0.03475,4,0.309488,0.346199,5532.888574
在天之灵(1947),在天之灵,notion,0,1,1,0,1,1,0.017323,4,0.281723,0.306272,0
在政治上(1947),在政治上,notion,0,3,3,0,3,3,0.046135,4,0.331006,0.372455,6671.362925
地上(1947),地上,notion,0,1,1,0,1,1,0.014732,4,0.276453,0.297813,0
地下(1947),地下,notion,0,3,3,0,3,3,0.035754,4,0.311068,0.34825,4600.846046
地位(1947),地位,notion,0,6,6,0,8,8,0.054868,4,0.342807,0.385638,19462.782321
地区(1947),地区,notion,0,1,1,0,1,1,0.014222,4,0.275404,0.296091,0
地去(1947),地去,notion,0,1,1,0,1,1,0.004749,4,0.257108,0.263793,0
地图(1947),地图,notion,0,1,1,0,1,1,0.013711,4,0.275027,0.295469,0
地址(1947),地址,notion,0,1,1,0,1,1,0.014081,4,0.275493,0.296238,0
地挺(1947),地挺,notion,0,1,1,0,1,1,0.011229,4,0.270366,0.287632,0
地来(1947),地来,notion,0,1,1,0,1,1,0.009035,4,0.265075,0.278404,0
地理(1947),地理,notion,0,1,1,0,5,5,0.00981,4,0.267191,0.28214,0
地缘(1947),地缘,notion,0,1,1,0,1,1,0.014081,4,0.275493,0.296238,0
场区(1947),场区,notion,0,1,1,0,1,1,0.007422,4,0.26356,0.275695,0
均势(1947),均势,notion,0,1,1,0,1,1,0.009035,4,0.265075,0.278404,0
均衡(1947),均衡,notion,0,1,1,0,1,1,0.014222,4,0.275404,0.296091,0
坏的(1947),坏的,notion,0,1,1,0,1,1,0.013711,4,0.275027,0.295469,0
坐牢(1947),坐牢,notion,0,1,1,0,1,1,0.013711,4,0.275027,0.295469,0
坐视(1947),坐视,notion,0,1,1,0,1,1,0.011229,4,0.270366,0.287632,0
坚主(1947),坚主,notion,0,1,1,0,1,1,0.017323,4,0.281723,0.306272,0
坚决(1947),坚决,notion,0,2,2,0,3,3,0.023521,4,0.291018,0.320504,1911.402908
坚决执行(1947),坚决执行,notion,0,1,1,0,1,1,0.011229,4,0.270366,0.287632,0
坚壁清野(1947),坚壁清野,notion,0,1,1,0,1,1,0.013711,4,0.275027,0.295469,0
坚强(1947),坚强,notion,0,2,2,0,2,2,0.022153,4,0.289808,0.31871,2534.094371
坚韧(1947),坚韧,notion,0,1,1,0,1,1,0.007422,4,0.26356,0.275695,0
坦途(1947),坦途,notion,0,1,1,0,1,1,0.002092,4,0.25318,0.25625,0
垂死(1947),垂死,notion,0,1,1,0,1,1,0.013711,4,0.275027,0.295469,0
垦区(1947),垦区,notion,0,1,1,0,1,1,0.014222,4,0.275404,0.296091,0
垦殖(1947),垦殖,notion,0,1,1,0,1,1,0.014222,4,0.275404,0.296091,0
垦荒(1947),垦荒,notion,0,1,1,0,1,1,0.014222,4,0.275404,0.296091,0
垫脚石(1947),垫脚石,notion,0,1,1,0,1,1,0.004749,4,0.257108,0.263793,0
垮台(1947),垮台,notion,0,1,1,0,1,1,0.013711,4,0.275027,0.295469,0
埃及(1947),埃及,notion,0,1,1,0,1,1,0.017323,4,0.281723,0.306272,0
城乡(1947),城乡,notion,0,1,1,0,1,1,0.014732,4,0.276453,0.297813,0
城市(1947),城市,notion,0,3,3,0,4,4,0.033975,4,0.307038,0.342976,4934.925229
培养(1947),培养,notion,0,1,1,0,1,1,0.007422,4,0.26356,0.275695,0
基地(1947),基地,notion,0,3,3,0,3,3,0.038967,4,0.318528,0.357661,6652.184339
基本纲领(1947),基本纲领,notion,0,1,1,0,1,1,0.007422,4,0.26356,0.275695,0
基础(1947),基础,notion,0,2,2,0,3,3,0.017232,4,0.279944,0.303513,1791.004954
堕落(1947),堕落,notion,0,1,1,0,1,1,0.014732,4,0.276453,0.297813,0
堡垒(1947),堡垒,notion,0,2,2,0,2,2,0.023521,4,0.291018,0.320504,1911.402908
堤岸(1947),堤岸,notion,0,1,1,0,1,1,0.017323,4,0.281723,0.306272,0
堵口(1947),堵口,notion,0,2,2,0,2,2,0.027932,4,0.299811,0.333101,2443.455357
塔山(1947),塔山,notion,0,4,4,0,5,5,0.047783,4,0.328426,0.36955,8037.024334
塞上(1947),塞上,notion,0,1,1,0,1,1,0.014732,4,0.276453,0.297813,0
塞北(1947),塞北,notion,0,1,1,0,1,1,0.013711,4,0.275027,0.295469,0
墓碑(1947),墓碑,notion,0,1,1,0,1,1,0.014732,4,0.276453,0.297813,0
增城(1947),增城,notion,0,1,1,0,1,1,0.013711,4,0.275027,0.295469,0
增辟(1947),增辟,notion,0,1,1,0,1,1,0.014732,4,0.276453,0.297813,0
增进(1947),增进,notion,0,1,1,0,1,1,0.014222,4,0.275404,0.296091,0
增长(1947),增长,notion,0,2,2,0,2,2,0.027133,4,0.29671,0.328744,1770.9936
墨家(1947),墨家,notion,0,1,1,0,1,1,0.014222,4,0.275404,0.296091,0
士大夫(1947),士大夫,notion,0,1,1,0,1,1,0.014081,4,0.275493,0.296238,0
士宦(1947),士宦,notion,0,1,1,0,1,1,0.014732,4,0.276453,0.297813,0
壬言万语(1947),壬言万语,notion,0,1,1,0,1,1,0.014081,4,0.275493,0.296238,0
壮丁(1947),壮丁,notion,0,3,3,0,3,3,0.042523,4,0.324801,0.365241,6618.635877
壮大(1947),壮大,notion,0,4,4,0,5,5,0.045784,4,0.331424,0.372992,12726.552698
声中(1947),声中,notion,0,1,1,0,1,1,0.009035,4,0.265075,0.278404,0
声势浩大(1947),声势浩大,notion,0,1,1,0,1,1,0.011229,4,0.270366,0.287632,0
声浪(1947),声浪,notion,0,1,1,0,1,1,0.009035,4,0.265075,0.278404,0
声音(1947),声音,notion,0,1,1,0,2,2,0.014081,4,0.275493,0.296238,0
处世(1947),处世,notion,0,1,1,0,1,1,0.014222,4,0.275404,0.296091,0
处判(1947),处判,notion,0,1,1,0,1,1,0.017323,4,0.281723,0.306272,0
处在(1947),处在,notion,0,2,2,0,2,2,0.026359,4,0.294788,0.325997,1561.492709
处处(1947),处处,notion,0,1,1,0,1,1,0.011229,4,0.270366,0.287632,0
处女作(1947),处女作,notion,0,1,1,0,1,1,0.014222,4,0.275404,0.296091,0
备忘录(1947),备忘录,notion,0,1,1,0,1,1,0.017323,4,0.281723,0.306272,0
复仇(1947),复仇,notion,0,1,1,0,1,1,0.013711,4,0.275027,0.295469,0
复刊(1947),复刊,notion,0,1,1,0,1,1,0.017323,4,0.281723,0.306272,0
复员(1947),复员,notion,0,2,2,0,2,2,0.031545,4,0.305336,0.340645,2219.908318
复堤(1947),复堤,notion,0,1,1,0,1,1,0.014222,4,0.275404,0.296091,0
复撰(1947),复撰,notion,0,1,1,0,1,1,0.017323,4,0.281723,0.306272,0
复活节(1947),复活节,notion,0,1,1,0,1,1,0.014222,4,0.275404,0.296091,0
复紧(1947),复紧,notion,0,1,1,0,1,1,0.017323,4,0.281723,0.306272,0
复课(1947),复课,notion,0,1,1,0,1,1,0.017323,4,0.281723,0.306272,0
复辟(1947),复辟,notion,0,1,1,0,1,1,0.009035,4,0.265075,0.278404,0
夏伯阳(1947),夏伯阳,notion,0,1,1,0,1,1,0.014732,4,0.276453,0.297813,0
夏利(1947),夏利,notion,0,1,1,0,1,1,0.017323,4,0.281723,0.306272,0
夏天(1947),夏天,notion,0,2,2,0,2,2,0.023116,4,0.288412,0.316623,1358.22258
夏日(1947),夏日,notion,0,1,1,0,1,1,0.014222,4,0.275404,0.296091,0
夏耘(1947),夏耘,notion,0,1,1,0,1,1,0.014732,4,0.276453,0.297813,0
夏都(1947),夏都,notion,0,1,1,0,1,1,0.003588,4,0.255396,0.260534,0
外交部(1947),外交部,notion,0,2,2,0,3,3,0.028812,4,0.299917,0.333248,2025.61524
外交部长(1947),外交部长,notion,0,1,1,0,1,1,0.014081,4,0.275493,0.296238,0
外件(1947),外件,notion,0,1,1,0,1,1,0.002092,4,0.25318,0.25625,0
外军(1947),外军,notion,0,1,1,0,1,1,0.017323,4,0.281723,0.306272,0
外向(1947),外向,notion,0,1,1,0,5,5,0.007422,4,0.26356,0.275695,0
外国(1947),外国,notion,0,3,3,0,5,5,0.041214,4,0.322074,0.361982,6317.925086
外报(1947),外报,notion,0,1,1,0,1,1,0.017323,4,0.281723,0.306272,0
外援(1947),外援,notion,0,1,1,0,1,1,0.00981,4,0.267191,0.28214,0
外汇(1947),外汇,notion,0,2,2,0,5,5,0.013784,4,0.270451,0.28784,449.976833
外汇管制(1947),外汇管制,notion,0,1,1,0,1,1,0.004749,4,0.257108,0.263793,0
外涨(1947),外涨,notion,0,1,1,0,1,1,0.014081,4,0.275493,0.296238,0
外相(1947),外相,notion,0,1,1,0,1,1,0.014222,4,0.275404,0.296091,0
外科医生(1947),外科医生,notion,0,1,1,0,1,1,0.014732,4,0.276453,0.297813,0
外蒙(1947),外蒙,notion,0,1,1,0,1,1,0.017323,4,0.281723,0.306272,0
外部(1947),外部,notion,0,1,1,0,1,1,0.014222,4,0.275404,0.296091,0
外销(1947),外销,notion,0,1,1,0,1,1,0.017323,4,0.281723,0.306272,0
多久(1947),多久,notion,0,1,1,0,1,1,0.014732,4,0.276453,0.297813,0
多少(1947),多少,notion,0,1,1,0,1,1,0.013711,4,0.275027,0.295469,0
多来(1947),多来,notion,0,1,1,0,1,1,0.013711,4,0.275027,0.295469,0
多此一举(1947),多此一举,notion,0,1,1,0,1,1,0.014732,4,0.276453,0.297813,0
多首(1947),多首,notion,0,1,1,0,1,1,0.014222,4,0.275404,0.296091,0
夜不闭户(1947),夜不闭户,notion,0,1,1,0,1,1,0.017323,4,0.281723,0.306272,0
夜校(1947),夜校,notion,0,1,1,0,2,2,0.007422,4,0.26356,0.275695,0
夜航(1947),夜航,notion,0,1,1,0,1,1,0.007422,4,0.26356,0.275695,0
夜袭(1947),夜袭,notion,0,1,1,0,1,1,0.011229,4,0.270366,0.287632,0
夜读(1947),夜读,notion,0,1,1,0,1,1,0.014732,4,0.276453,0.297813,0
大一统(1947),大一统,notion,0,1,1,0,1,1,0.014222,4,0.275404,0.296091,0
大举(1947),大举,notion,0,2,2,0,2,2,0.022746,4,0.288631,0.316952,1575.703869
大人(1947),大人,notion,0,1,1,0,1,1,0.014732,4,0.276453,0.297813,0
大众(1947),大众,notion,0,1,1,0,1,1,0.014732,4,0.276453,0.297813,0
大传(1947),大传,notion,0,1,1,0,1,1,0.014222,4,0.275404,0.296091,0
大佛(1947),大佛,notion,0,1,1,0,1,1,0.014732,4,0.276453,0.297813,0
大使(1947),大使,notion,0,2,2,0,2,2,0.031545,4,0.305336,0.340645,2219.908318
大别山(1947),大别山,notion,0,4,4,0,5,5,0.056745,4,0.35084,0.393865,13092.7345
大别山区(1947),大别山区,notion,0,2,2,0,2,2,0.02494,4,0.292941,0.323324,1747.290038
大势(1947),大势,notion,0,3,3,0,3,3,0.035724,4,0.311778,0.349165,5959.110786
大卫(1947),大卫,notion,0,2,2,0,2,2,0.024542,4,0.292264,0.322335,1826.657886
大同(1947),大同,notion,0,2,2,0,2,2,0.031404,4,0.30602,0.34156,2430.025091
大员(1947),大员,notion,0,1,1,0,1,1,0.014732,4,0.276453,0.297813,0
大团圆(1947),大团圆,notion,0,1,1,0,1,1,0.011229,4,0.270366,0.287632,0
大团结(1947),大团结,notion,0,1,1,0,1,1,0.013711,4,0.275027,0.295469,0
大地(1947),大地,notion,0,2,2,0,2,2,0.023116,4,0.288412,0.316623,1358.22258
大埔(1947),大埔,notion,0,1,1,0,3,3,0.011229,4,0.270366,0.287632,0
大夏(1947),大夏,notion,0,2,2,0,2,2,0.022746,4,0.288631,0.316952,1575.703869
大学(1947),大学,notion,0,6,6,0,21,21,0.070529,4,0.369686,0.41215,21996.229063
大学教授(1947),大学教授,notion,0,1,1,0,2,2,0.014732,4,0.276453,0.297813,0
大屠杀(1947),大屠杀,notion,0,1,1,0,1,1,0.003588,4,0.255396,0.260534,0
大巴山(1947),大巴山,notion,0,1,1,0,1,1,0.017323,4,0.281723,0.306272,0
大师(1947),大师,notion,0,1,1,0,1,1,0.00981,4,0.267191,0.28214,0
大总统(1947),大总统,notion,0,1,1,0,1,1,0.009035,4,0.265075,0.278404,0
大患(1947),大患,notion,0,1,1,0,1,1,0.017323,4,0.281723,0.306272,0
大捷(1947),大捷,notion,0,1,1,0,1,1,0.013711,4,0.275027,0.295469,0
大旱(1947),大旱,notion,0,1,1,0,1,1,0.013711,4,0.275027,0.295469,0
大本营(1947),大本营,notion,0,1,1,0,1,1,0.014732,4,0.276453,0.297813,0
大树(1947),大树,notion,0,2,2,0,2,2,0.02494,4,0.292941,0.323324,1747.290038
大楼(1947),大楼,notion,0,1,1,0,1,1,0.003699,4,0.256009,0.261706,0
大江(1947),大江,notion,0,1,1,0,1,1,0.007422,4,0.26356,0.275695,0
大洞(1947),大洞,notion,0,1,1,0,1,1,0.013711,4,0.275027,0.295469,0
大王(1947),大王,notion,0,1,1,0,1,1,0.011229,4,0.270366,0.287632,0
大理石(1947),大理石,notion,0,1,1,0,1,1,0.00981,4,0.267191,0.28214,0
大病(1947),大病,notion,0,1,1,0,1,1,0.009035,4,0.265075,0.278404,0
大笑(1947),大笑,notion,0,1,1,0,1,1,0.014081,4,0.275493,0.296238,0
大美(1947),大美,notion,0,1,1,0,1,1,0.017323,4,0.281723,0.306272,0
大臣(1947),大臣,notion,0,2,2,0,2,2,0.031034,4,0.30613,0.341707,2639.595687
大自然(1947),大自然,notion,0,1,1,0,1,1,0.00981,4,0.267191,0.28214,0
大英帝国(1947),大英帝国,notion,0,1,1,0,1,1,0.00981,4,0.267191,0.28214,0
大衆(1947),大衆,notion,0,2,2,0,2,2,0.027791,4,0.29968,0.332918,2405.290268
大街(1947),大街,notion,0,1,1,0,1,1,0.014222,4,0.275404,0.296091,0
大规模(1947),大规模,notion,0,1,1,0,1,1,0.017323,4,0.281723,0.306272,0
大谬(1947),大谬,notion,0,1,1,0,1,1,0.014081,4,0.275493,0.296238,0
大赦(1947),大赦,notion,0,2,2,0,2,2,0.025961,4,0.295759,0.327389,2231.848602
大都市(1947),大都市,notion,0,1,1,0,1,1,0.000869,4,0.251131,0.252222,0
大钞(1947),大钞,notion,0,5,5,0,5,5,0.068881,4,0.373284,0.415348,19851.584609
大闹天宫(1947),大闹天宫,notion,0,1,1,0,1,1,0.003699,4,0.256009,0.261706,0
大队(1947),大队,notion,0,1,1,0,1,1,0.011229,4,0.270366,0.287632,0
大难(1947),大难,notion,0,1,1,0,1,1,0.013711,4,0.275027,0.295469,0
大革命(1947),大革命,notion,0,1,1,0,1,1,0.003588,4,0.255396,0.260534,0
大鬥争(1947),大鬥争,notion,0,1,1,0,1,1,0.013711,4,0.275027,0.295469,0
天下一家(1947),天下一家,notion,0,1,1,0,1,1,0.00981,4,0.267191,0.28214,0
天下太平(1947),天下太平,notion,0,1,1,0,1,1,0.013711,4,0.275027,0.295469,0
天下第一(1947),天下第一,notion,0,1,1,0,2,2,0.014081,4,0.275493,0.296238,0
天兵神将(1947),天兵神将,notion,0,1,1,0,1,1,0.011229,4,0.270366,0.287632,0
天堂(1947),天堂,notion,0,2,2,0,2,2,0.021022,4,0.286837,0.314242,1344.24886
天府之国(1947),天府之国,notion,0,1,1,0,1,1,0.013711,4,0.275027,0.295469,0
天快(1947),天快,notion,0,1,1,0,1,1,0.017323,4,0.281723,0.306272,0
天才(1947),天才,notion,0,2,2,0,2,2,0.023521,4,0.291018,0.320504,1911.402908
天明(1947),天明,notion,0,1,1,0,1,1,0.013711,4,0.275027,0.295469,0
天桥(1947),天桥,notion,0,1,1,0,1,1,0.014732,4,0.276453,0.297813,0
天皇(1947),天皇,notion,0,1,1,0,1,1,0.013711,4,0.275027,0.295469,0
天真(1947),天真,notion,0,1,1,0,1,1,0.014732,4,0.276453,0.297813,0
天罗地网(1947),天罗地网,notion,0,1,1,0,1,1,0.013711,4,0.275027,0.295469,0
天高(1947),天高,notion,0,1,1,0,1,1,0.009035,4,0.265075,0.278404,0
太大(1947),太大,notion,0,1,1,0,1,1,0.014081,4,0.275493,0.296238,0
太少(1947),太少,notion,0,1,1,0,1,1,0.017323,4,0.281723,0.306272,0
太平(1947),太平,notion,0,2,2,0,2,2,0.028302,4,0.298866,0.331783,1965.8222
太平洋战(1947),太平洋战,notion,0,1,1,0,1,1,0.009035,4,0.265075,0.278404,0
太迟(1947),太迟,notion,0,1,1,0,1,1,0.017323,4,0.281723,0.306272,0
太阳(1947),太阳,notion,0,1,1,0,1,1,0.014081,4,0.275493,0.296238,0
太阳旗(1947),太阳旗,notion,0,1,1,0,1,1,0.004749,4,0.257108,0.263793,0
夭折(1947),夭折,notion,0,1,1,0,1,1,0.007422,4,0.26356,0.275695,0
央行(1947),央行,notion,0,1,1,0,2,2,0.011229,4,0.270366,0.287632,0
失业(1947),失业,notion,0,2,2,0,2,2,0.031404,4,0.30602,0.34156,2430.025091
失业问题(1947),失业问题,notion,0,1,1,0,1,1,0.007422,4,0.26356,0.275695,0
失学(1947),失学,notion,0,1,1,0,1,1,0.014222,4,0.275404,0.296091,0
失守(1947),失守,notion,0,1,1,0,1,1,0.014732,4,0.276453,0.297813,0
失火(1947),失火,notion,0,1,1,0,1,1,0.014222,4,0.275404,0.296091,0
失落(1947),失落,notion,0,1,1,0,1,1,0.014732,4,0.276453,0.297813,0
失败(1947),失败,notion,0,6,6,0,10,10,0.081027,4,0.40081,0.438406,31771.429203
头上(1947),头上,notion,0,1,1,0,1,1,0.011229,4,0.270366,0.287632,0
头脸(1947),头脸,notion,0,1,1,0,1,1,0.014732,4,0.276453,0.297813,0
夹击(1947),夹击,notion,0,1,1,0,1,1,0.00981,4,0.267191,0.28214,0
夹缝(1947),夹缝,notion,0,3,3,0,3,3,0.030168,4,0.30212,0.336348,5664.79815
夺取(1947),夺取,notion,0,2,2,0,2,2,0.023521,4,0.291018,0.320504,1911.402908
奇拥(1947),奇拥,notion,0,1,1,0,1,1,0.014081,4,0.275493,0.296238,0
奉送(1947),奉送,notion,0,1,1,0,1,1,0.014732,4,0.276453,0.297813,0
奋韬(1947),奋韬,notion,0,1,1,0,1,1,0.014732,4,0.276453,0.297813,0
奖金(1947),奖金,notion,0,1,1,0,1,1,0.00981,4,0.267191,0.28214,0
套取(1947),套取,notion,0,1,1,0,1,1,0.017323,4,0.281723,0.306272,0
奥国(1947),奥国,notion,0,1,1,0,1,1,0.00981,4,0.267191,0.28214,0
奥地利(1947),奥地利,notion,0,1,1,0,2,2,0.00981,4,0.267191,0.28214,0
奥尔尼(1947),奥尔尼,notion,0,1,1,0,1,1,0.014222,4,0.275404,0.296091,0
女作家(1947),女作家,notion,0,1,1,0,1,1,0.017323,4,0.281723,0.306272,0
女士(1947),女士,notion,0,1,1,0,2,2,0.017323,4,0.281723,0.306272,0
女子(1947),女子,notion,0,1,1,0,1,1,0.013711,4,0.275027,0.295469,0
女将(1947),女将,notion,0,1,1,0,1,1,0.013711,4,0.275027,0.295469,0
女工(1947),女工,notion,0,1,1,0,1,1,0.011229,4,0.270366,0.287632,0
女性(1947),女性,notion,0,1,1,0,1,1,0.011229,4,0.270366,0.287632,0
女权(1947),女权,notion,0,1,1,0,1,1,0.014081,4,0.275493,0.296238,0
女杰(1947),女杰,notion,0,1,1,0,1,1,0.011229,4,0.270366,0.287632,0
女生(1947),女生,notion,0,1,1,0,1,1,0.009035,4,0.265075,0.278404,0
奴隶(1947),奴隶,notion,0,1,1,0,1,1,0.014732,4,0.276453,0.297813,0
奸匪(1947),奸匪,notion,0,1,1,0,1,1,0.017323,4,0.281723,0.306272,0
好书(1947),好书,notion,0,1,1,0,1,1,0.011229,4,0.270366,0.287632,0
好像(1947),好像,notion,0,1,1,0,1,1,0.014732,4,0.276453,0.297813,0
好坏(1947),好坏,notion,0,1,1,0,1,1,0.011229,4,0.270366,0.287632,0
好好(1947),好好,notion,0,1,1,0,1,1,0.014732,4,0.276453,0.297813,0
好戏(1947),好戏,notion,0,1,1,0,1,1,0.013711,4,0.275027,0.295469,0
好战(1947),好战,notion,0,1,1,0,1,1,0.017323,4,0.281723,0.306272,0
好榜样(1947),好榜样,notion,0,1,1,0,1,1,0.009035,4,0.265075,0.278404,0
好汉不吃眼前亏(1947),好汉不吃眼前亏,notion,0,1,1,0,1,1,0.014081,4,0.275493,0.296238,0
好莱坞(1947),好莱坞,notion,0,2,2,0,3,3,0.018431,4,0.28119,0.30549,1040.874592
好闹勐(1947),好闹勐,notion,0,1,1,0,1,1,0.007422,4,0.26356,0.275695,0
如归(1947),如归,notion,0,1,1,0,1,1,0.007422,4,0.26356,0.275695,0
如斯(1947),如斯,notion,0,1,1,0,1,1,0.014081,4,0.275493,0.296238,0
如是(1947),如是,notion,0,2,2,0,2,2,0.023116,4,0.288412,0.316623,1358.22258
如是我闻(1947),如是我闻,notion,0,1,1,0,1,1,0.009035,4,0.265075,0.278404,0
如机(1947),如机,notion,0,1,1,0,1,1,0.014222,4,0.275404,0.296091,0
如火(1947),如火,notion,0,2,2,0,2,2,0.018829,4,0.280473,0.304355,655.354404
如芒刺背(1947),如芒刺背,notion,0,1,1,0,1,1,0.003699,4,0.256009,0.261706,0
如蕾(1947),如蕾,notion,0,1,1,0,1,1,0.007422,4,0.26356,0.275695,0
妇女节(1947),妇女节,notion,0,1,1,0,4,4,0.007422,4,0.26356,0.275695,0
妇女解放(1947),妇女解放,notion,0,1,1,0,1,1,0.013711,4,0.275027,0.295469,0
妇联(1947),妇联,notion,0,2,2,0,3,3,0.021132,4,0.288412,0.316623,2574.708611
妇联会(1947),妇联会,notion,0,1,1,0,1,1,0.017323,4,0.281723,0.306272,0
妖孽(1947),妖孽,notion,0,1,1,0,1,1,0.013711,4,0.275027,0.295469,0
妙计(1947),妙计,notion,0,1,1,0,2,2,0.013711,4,0.275027,0.295469,0
妥协(1947),妥协,notion,0,1,1,0,1,1,0.013711,4,0.275027,0.295469,0
姓名(1947),姓名,notion,0,1,1,0,1,1,0.014081,4,0.275493,0.296238,0
委会(1947),委会,notion,0,1,1,0,1,1,0.017323,4,0.281723,0.306272,0
姦死(1947),姦死,notion,0,1,1,0,1,1,0.013711,4,0.275027,0.295469,0
姿态(1947),姿态,notion,0,2,2,0,2,2,0.032055,4,0.30624,0.341853,2215.722594
威信(1947),威信,notion,0,2,2,0,2,2,0.024542,4,0.292264,0.322335,1826.657886
威尔逊(1947),威尔逊,notion,0,1,1,0,1,1,0.007422,4,0.26356,0.275695,0
威廉(1947),威廉,notion,0,1,1,0,1,1,0.00981,4,0.267191,0.28214,0
威武不屈(1947),威武不屈,notion,0,1,1,0,1,1,0.011229,4,0.270366,0.287632,0
威胁(1947),威胁,notion,0,5,5,0,9,9,0.053564,4,0.340109,0.382684,12886.870444
娱乐(1947),娱乐,notion,0,1,1,0,1,1,0.014081,4,0.275493,0.296238,0
娼妓(1947),娼妓,notion,0,1,1,0,1,1,0.014732,4,0.276453,0.297813,0
婚姻(1947),婚姻,notion,0,1,1,0,4,4,0.014222,4,0.275404,0.296091,0
婚礼(1947),婚礼,notion,0,1,1,0,1,1,0.014081,4,0.275493,0.296238,0
媚外(1947),媚外,notion,0,1,1,0,1,1,0.003588,4,0.255396,0.260534,0
媲美(1947),媲美,notion,0,1,1,0,1,1,0.014222,4,0.275404,0.296091,0
嫡庶(1947),嫡庶,notion,0,1,1,0,1,1,0.013711,4,0.275027,0.295469,0
子书(1947),子书,notion,0,1,1,0,1,1,0.009035,4,0.265075,0.278404,0
子孙(1947),子孙,notion,0,2,2,0,2,2,0.023257,4,0.28761,0.315414,1169.271875
子弹(1947),子弹,notion,0,1,1,0,1,1,0.011229,4,0.270366,0.287632,0
子来了(1947),子来了,notion,0,1,1,0,1,1,0.013711,4,0.275027,0.295469,0
孔夫子(1947),孔夫子,notion,0,1,1,0,1,1,0.013711,4,0.275027,0.295469,0
孔子(1947),孔子,notion,0,1,1,0,1,1,0.014222,4,0.275404,0.296091,0
孔家店(1947),孔家店,notion,0,1,1,0,1,1,0.014081,4,0.275493,0.296238,0
孔手治术(1947),孔手治术,notion,0,1,1,0,1,1,0.014222,4,0.275404,0.296091,0
字典(1947),字典,notion,0,1,1,0,1,1,0.00981,4,0.267191,0.28214,0
字母(1947),字母,notion,0,1,1,0,1,1,0.014222,4,0.275404,0.296091,0
字诀(1947),字诀,notion,0,1,1,0,1,1,0.009035,4,0.265075,0.278404,0
存在(1947),存在,notion,0,1,1,0,2,2,0.007422,4,0.26356,0.275695,0
存在主义(1947),存在主义,notion,0,1,1,0,1,1,0.00981,4,0.267191,0.28214,0
存款(1947),存款,notion,0,1,1,0,1,1,0.014732,4,0.276453,0.297813,0
存粮(1947),存粮,notion,0,1,1,0,1,1,0.011229,4,0.270366,0.287632,0
孙副(1947),孙副,notion,0,1,1,0,1,1,0.014732,4,0.276453,0.297813,0
孙殿英(1947),孙殿英,notion,0,1,1,0,1,1,0.013711,4,0.275027,0.295469,0
孙院长(1947),孙院长,notion,0,1,1,0,1,1,0.014732,4,0.276453,0.297813,0
孟宪功(1947),孟宪功,notion,0,1,1,0,1,1,0.014081,4,0.275493,0.296238,0
季世(1947),季世,notion,0,1,1,0,1,1,0.014732,4,0.276453,0.297813,0
孤儿(1947),孤儿,notion,0,1,1,0,1,1,0.00981,4,0.267191,0.28214,0
孤岛(1947),孤岛,notion,0,1,1,0,1,1,0.017323,4,0.281723,0.306272,0
孤立(1947),孤立,notion,0,1,1,0,1,1,0.014732,4,0.276453,0.297813,0
学习团(1947),学习团,notion,0,1,1,0,1,1,0.007422,4,0.26356,0.275695,0
学习态度(1947),学习态度,notion,0,1,1,0,1,1,0.011229,4,0.270366,0.287632,0
学习班(1947),学习班,notion,0,1,1,0,1,1,0.011229,4,0.270366,0.287632,0
学会(1947),学会,notion,0,1,1,0,1,1,0.013711,4,0.275027,0.295469,0
学做(1947),学做,notion,0,1,1,0,1,1,0.017323,4,0.281723,0.306272,0
学历(1947),学历,notion,0,1,1,0,1,1,0.014732,4,0.276453,0.297813,0
学场(1947),学场,notion,0,1,1,0,1,1,0.014732,4,0.276453,0.297813,0
学宫(1947),学宫,notion,0,1,1,0,3,3,0.014222,4,0.275404,0.296091,0
学府(1947),学府,notion,0,1,1,0,1,1,0.013711,4,0.275027,0.295469,0
学期(1947),学期,notion,0,1,1,0,1,1,0.007422,4,0.26356,0.275695,0
学术(1947),学术,notion,0,5,5,0,10,10,0.054936,4,0.343774,0.386602,15313.936464
学术思想(1947),学术思想,notion,0,1,1,0,1,1,0.002092,4,0.25318,0.25625,0
学海(1947),学海,notion,0,1,1,0,1,1,0.009035,4,0.265075,0.278404,0
学然后知不足(1947),学然后知不足,notion,0,1,1,0,1,1,0.009035,4,0.265075,0.278404,0
学生家长(1947),学生家长,notion,0,1,1,0,1,1,0.017323,4,0.281723,0.306272,0
学界(1947),学界,notion,0,1,1,0,1,1,0.014081,4,0.275493,0.296238,0
学问(1947),学问,notion,0,1,1,0,1,1,0.014222,4,0.275404,0.296091,0
学风(1947),学风,notion,0,1,1,0,1,1,0.014222,4,0.275404,0.296091,0
孩子(1947),孩子,notion,0,6,6,0,9,9,0.065035,4,0.36726,0.409917,24993.393019
孬种(1947),孬种,notion,0,1,1,0,1,1,0.014081,4,0.275493,0.296238,0
守信(1947),守信,notion,0,1,1,0,1,1,0.00981,4,0.267191,0.28214,0
守望(1947),守望,notion,0,1,1,0,2,2,0.014732,4,0.276453,0.297813,0
安乐(1947),安乐,notion,0,1,1,0,1,1,0.017323,4,0.281723,0.306272,0
安全观(1947),安全观,notion,0,1,1,0,1,1,0.017323,4,0.281723,0.306272,0
安南(1947),安南,notion,0,1,1,0,1,1,0.014222,4,0.275404,0.296091,0
安娜(1947),安娜,notion,0,1,1,0,2,2,0.017323,4,0.281723,0.306272,0
安定(1947),安定,notion,0,2,2,0,4,4,0.023257,4,0.28761,0.315414,1169.271875
安富根(1947),安富根,notion,0,1,1,0,1,1,0.013711,4,0.275027,0.295469,0
安庆(1947),安庆,notion,0,1,1,0,1,1,0.017323,4,0.281723,0.306272,0
安徽大学(1947),安徽大学,notion,0,1,1,0,1,1,0.014222,4,0.275404,0.296091,0
安徽省(1947),安徽省,notion,0,1,1,0,1,1,0.014222,4,0.275404,0.296091,0
安心(1947),安心,notion,0,1,1,0,1,1,0.014732,4,0.276453,0.297813,0
安慰(1947),安慰,notion,0,1,1,0,1,1,0.017323,4,0.281723,0.306272,0
安排(1947),安排,notion,0,2,2,0,2,2,0.023116,4,0.288412,0.316623,1358.22258
安理会(1947),安理会,notion,0,1,1,0,1,1,0.011229,4,0.270366,0.287632,0
安眠(1947),安眠,notion,0,1,1,0,1,1,0.003588,4,0.255396,0.260534,0
安葬(1947),安葬,notion,0,1,1,0,1,1,0.017323,4,0.281723,0.306272,0
宋学(1947),宋学,notion,0,1,1,0,1,1,0.014222,4,0.275404,0.296091,0
宋庆龄(1947),宋庆龄,notion,0,1,1,0,1,1,0.017323,4,0.281723,0.306272,0
宋来(1947),宋来,notion,0,1,1,0,1,1,0.013711,4,0.275027,0.295469,0
宋阳(1947),宋阳,notion,0,1,1,0,1,1,0.014732,4,0.276453,0.297813,0
完了(1947),完了,notion,0,1,1,0,1,1,0.014081,4,0.275493,0.296238,0
完人(1947),完人,notion,0,1,1,0,1,1,0.014222,4,0.275404,0.296091,0
完成(1947),完成,notion,0,4,4,0,4,4,0.046185,4,0.329727,0.371051,11659.744108
完蛋(1947),完蛋,notion,0,1,1,0,1,1,0.013711,4,0.275027,0.295469,0
宗派主义(1947),宗派主义,notion,0,1,1,0,1,1,0.004749,4,0.257108,0.263793,0
官价(1947),官价,notion,0,1,1,0,1,1,0.014222,4,0.275404,0.296091,0
官僚作风(1947),官僚作风,notion,0,1,1,0,1,1,0.004749,4,0.257108,0.263793,0
官僚资本(1947),官僚资本,notion,0,4,4,0,4,4,0.039745,4,0.314391,0.352558,7311.315475
官僚资本家(1947),官僚资本家,notion,0,1,1,0,1,1,0.003699,4,0.256009,0.261706,0
官儿(1947),官儿,notion,0,2,2,0,2,2,0.023891,4,0.292014,0.321969,2116.906395
官制(1947),官制,notion,0,1,1,0,1,1,0.014732,4,0.276453,0.297813,0
官场(1947),官场,notion,0,3,3,0,3,3,0.046135,4,0.331006,0.372455,6671.362925
官常(1947),官常,notion,0,1,1,0,1,1,0.014081,4,0.275493,0.296238,0
官怪(1947),官怪,notion,0,1,1,0,1,1,0.011229,4,0.270366,0.287632,0
官方(1947),官方,notion,0,2,2,0,2,2,0.032055,4,0.30624,0.341853,2215.722594
官能(1947),官能,notion,0,1,1,0,1,1,0.014222,4,0.275404,0.296091,0
官腔(1947),官腔,notion,0,1,1,0,1,1,0.013711,4,0.275027,0.295469,0
定爲(1947),定爲,notion,0,2,2,0,2,2,0.028302,4,0.298866,0.331783,1965.8222
定理(1947),定理,notion,0,1,1,0,1,1,0.014732,4,0.276453,0.297813,0
宝安(1947),宝安,notion,0,1,1,0,2,2,0.011229,4,0.270366,0.287632,0
宝山(1947),宝山,notion,0,1,1,0,1,1,0.017323,4,0.281723,0.306272,0
宝贝儿(1947),宝贝儿,notion,0,1,1,0,1,1,0.003699,4,0.256009,0.261706,0
实义(1947),实义,notion,0,1,1,0,1,1,0.014222,4,0.275404,0.296091,0
实例(1947),实例,notion,0,1,1,0,1,1,0.007422,4,0.26356,0.275695,0
实况(1947),实况,notion,0,2,2,0,2,2,0.021502,4,0.288388,0.316586,2245.621531
实录(1947),实录,notion,0,2,2,0,2,2,0.017669,4,0.279944,0.303513,871.280033
实效(1947),实效,notion,0,1,1,0,1,1,0.009035,4,0.265075,0.278404,0
实施(1947),实施,notion,0,4,4,0,6,6,0.034378,4,0.305363,0.340804,7533.489475
实施办法(1947),实施办法,notion,0,1,1,0,1,1,0.007422,4,0.26356,0.275695,0
实现(1947),实现,notion,0,6,6,0,7,7,0.067471,4,0.370208,0.412626,25302.777786
实行(1947),实行,notion,0,5,5,0,7,7,0.055797,4,0.341777,0.384478,13597.675654
实质(1947),实质,notion,0,2,2,0,2,2,0.02494,4,0.292941,0.323324,1747.290038
实际(1947),实际,notion,0,1,1,0,1,1,0.011229,4,0.270366,0.287632,0
审判(1947),审判,notion,0,2,2,0,2,2,0.024542,4,0.292264,0.322335,1826.657886
审判权(1947),审判权,notion,0,1,1,0,1,1,0.014081,4,0.275493,0.296238,0
审美(1947),审美,notion,0,1,1,0,1,1,0.003588,4,0.255396,0.260534,0
客观(1947),客观,notion,0,1,1,0,1,1,0.017323,4,0.281723,0.306272,0
客问(1947),客问,notion,0,1,1,0,1,1,0.014222,4,0.275404,0.296091,0
宣传(1947),宣传,notion,0,4,4,0,4,4,0.048002,4,0.331649,0.373248,10897.334595
室家(1947),室家,notion,0,1,1,0,1,1,0.014222,4,0.275404,0.296091,0
宪典(1947),宪典,notion,0,1,1,0,2,2,0.014081,4,0.275493,0.296238,0
宪政时期(1947),宪政时期,notion,0,1,1,0,1,1,0.014222,4,0.275404,0.296091,0
宪章(1947),宪章,notion,0,2,2,0,3,3,0.021022,4,0.286837,0.314242,1344.24886
宪草(1947),宪草,notion,0,1,1,0,1,1,0.009035,4,0.265075,0.278404,0
宫内(1947),宫内,notion,0,1,1,0,1,1,0.00981,4,0.267191,0.28214,0
害人精(1947),害人精,notion,0,1,1,0,1,1,0.003699,4,0.256009,0.261706,0
家丑(1947),家丑,notion,0,1,1,0,1,1,0.014732,4,0.276453,0.297813,0
家乡(1947),家乡,notion,0,1,1,0,1,1,0.011229,4,0.270366,0.287632,0
家庭(1947),家庭,notion,0,2,2,0,4,4,0.021644,4,0.28732,0.314975,1747.667055
家莊(1947),家莊,notion,0,1,1,0,1,1,0.013711,4,0.275027,0.295469,0
容县(1947),容县,notion,0,1,1,0,1,1,0.013711,4,0.275027,0.295469,0
容忍(1947),容忍,notion,0,1,1,0,1,1,0.014081,4,0.275493,0.296238,0
容藤(1947),容藤,notion,0,1,1,0,1,1,0.011229,4,0.270366,0.287632,0
容量(1947),容量,notion,0,1,1,0,1,1,0.014732,4,0.276453,0.297813,0
宽阔(1947),宽阔,notion,0,1,1,0,1,1,0.00981,4,0.267191,0.28214,0
寄来(1947),寄来,notion,0,1,1,0,1,1,0.017323,4,0.281723,0.306272,0
寄语(1947),寄语,notion,0,2,2,0,2,2,0.009514,4,0.266295,0.280626,884.153289
密云(1947),密云,notion,0,2,2,0,2,2,0.032055,4,0.30624,0.341853,2215.722594
密令(1947),密令,notion,0,1,1,0,1,1,0.013711,4,0.275027,0.295469,0
密勒(1947),密勒,notion,0,2,2,0,2,2,0.013509,4,0.272459,0.291246,1005.901195
富丁(1947),富丁,notion,0,1,1,0,1,1,0.017323,4,0.281723,0.306272,0
富士山(1947),富士山,notion,0,1,1,0,1,1,0.004749,4,0.257108,0.263793,0
富室(1947),富室,notion,0,1,1,0,1,1,0.014081,4,0.275493,0.296238,0
富强(1947),富强,notion,0,1,1,0,1,1,0.014222,4,0.275404,0.296091,0
富强康乐(1947),富强康乐,notion,0,1,1,0,1,1,0.014222,4,0.275404,0.296091,0
富足(1947),富足,notion,0,1,1,0,1,1,0.00981,4,0.267191,0.28214,0
寓言(1947),寓言,notion,0,1,1,0,1,1,0.003699,4,0.256009,0.261706,0
察哈尔(1947),察哈尔,notion,0,1,1,0,1,1,0.014732,4,0.276453,0.297813,0
对付(1947),对付,notion,0,1,1,0,2,2,0.014081,4,0.275493,0.296238,0
对内(1947),对内,notion,0,1,1,0,1,1,0.014081,4,0.275493,0.296238,0
对内政策(1947),对内政策,notion,0,1,1,0,1,1,0.00981,4,0.267191,0.28214,0
对土(1947),对土,notion,0,1,1,0,1,1,0.00981,4,0.267191,0.28214,0
对外贸易(1947),对外贸易,notion,0,2,2,0,2,2,0.031034,4,0.30613,0.341707,2639.595687
对抗(1947),对抗,notion,0,1,1,0,2,2,0.00981,4,0.267191,0.28214,0
对敌(1947),对敌,notion,0,1,1,0,1,1,0.011229,4,0.270366,0.287632,0
对施(1947),对施,notion,0,1,1,0,1,1,0.017323,4,0.281723,0.306272,0
对比(1947),对比,notion,0,1,1,0,1,1,0.017323,4,0.281723,0.306272,0
对照(1947),对照,notion,0,3,3,0,3,3,0.037588,4,0.314884,0.35312,5761.963693
对立(1947),对立,notion,0,3,3,0,3,3,0.016651,4,0.275827,0.296909,1795.842069
对策(1947),对策,notion,0,3,3,0,4,4,0.043034,4,0.324061,0.364362,6056.258506
对美(1947),对美,notion,0,1,1,0,1,1,0.014732,4,0.276453,0.297813,0
对荷(1947),对荷,notion,0,1,1,0,1,1,0.017323,4,0.281723,0.306272,0
导师(1947),导师,notion,0,1,1,0,2,2,0.013711,4,0.275027,0.295469,0
寿任(1947),寿任,notion,0,1,1,0,1,1,0.017323,4,0.281723,0.306272,0
寿昌(1947),寿昌,notion,0,1,1,0,1,1,0.007422,4,0.26356,0.275695,0
寿祝(1947),寿祝,notion,0,1,1,0,1,1,0.00981,4,0.267191,0.28214,0
寿辰(1947),寿辰,notion,0,1,1,0,1,1,0.017323,4,0.281723,0.306272,0
封事(1947),封事,notion,0,1,1,0,1,1,0.017323,4,0.281723,0.306272,0
封信(1947),封信,notion,0,1,1,0,1,1,0.014081,4,0.275493,0.296238,0
封及(1947),封及,notion,0,2,2,0,2,2,0.018829,4,0.280473,0.304355,655.354404
封建(1947),封建,notion,0,2,2,0,2,2,0.027932,4,0.299811,0.333101,2443.455357
将士(1947),将士,notion,0,1,1,0,1,1,0.014222,4,0.275404,0.296091,0
将成(1947),将成,notion,0,1,1,0,1,1,0.002092,4,0.25318,0.25625,0
将来(1947),将来,notion,0,1,1,0,3,3,0.014222,4,0.275404,0.296091,0
尊孔(1947),尊孔,notion,0,1,1,0,1,1,0.014081,4,0.275493,0.296238,0
尊重(1947),尊重,notion,0,1,1,0,1,1,0.014732,4,0.276453,0.297813,0
尊重人权(1947),尊重人权,notion,0,2,2,0,2,2,0.028552,4,0.301506,0.335445,2588.539662
小事(1947),小事,notion,0,1,1,0,1,1,0.014732,4,0.276453,0.297813,0
小传(1947),小传,notion,0,2,2,0,2,2,0.018431,4,0.28119,0.30549,1040.874592
小佛(1947),小佛,notion,0,1,1,0,1,1,0.014732,4,0.276453,0.297813,0
小卒(1947),小卒,notion,0,1,1,0,1,1,0.014732,4,0.276453,0.297813,0
小品(1947),小品,notion,0,1,1,0,1,1,0.014222,4,0.275404,0.296091,0
小品文(1947),小品文,notion,0,1,1,0,1,1,0.014222,4,0.275404,0.296091,0
小圈子(1947),小圈子,notion,0,1,1,0,2,2,0.011229,4,0.270366,0.287632,0
小姐(1947),小姐,notion,0,1,1,0,1,1,0.013711,4,0.275027,0.295469,0
小学(1947),小学,notion,0,2,2,0,2,2,0.022153,4,0.289808,0.31871,2534.094371
小市民(1947),小市民,notion,0,3,3,0,3,3,0.02966,4,0.300603,0.334261,4391.062512
小康(1947),小康,notion,0,1,1,0,1,1,0.014081,4,0.275493,0.296238,0
小引(1947),小引,notion,0,1,1,0,1,1,0.014732,4,0.276453,0.297813,0
小志(1947),小志,notion,0,1,1,0,1,1,0.017323,4,0.281723,0.306272,0
小教联(1947),小教联,notion,0,1,1,0,1,1,0.017323,4,0.281723,0.306272,0
小星(1947),小星,notion,0,1,1,0,1,1,0.017323,4,0.281723,0.306272,0
小民(1947),小民,notion,0,1,1,0,1,1,0.004749,4,0.257108,0.263793,0
小疵(1947),小疵,notion,0,1,1,0,1,1,0.014081,4,0.275493,0.296238,0
小约翰(1947),小约翰,notion,0,1,1,0,1,1,0.014732,4,0.276453,0.297813,0
小纪(1947),小纪,notion,0,1,1,0,1,1,0.014732,4,0.276453,0.297813,0
小组(1947),小组,notion,0,2,2,0,2,2,0.016457,4,0.27778,0.300034,1514.385671
小结(1947),小结,notion,0,2,2,0,2,2,0.017232,4,0.279944,0.303513,1791.004954
小羊(1947),小羊,notion,0,1,1,0,1,1,0.014732,4,0.276453,0.297813,0
小言(1947),小言,notion,0,2,2,0,2,2,0.026359,4,0.294788,0.325997,1561.492709
小记(1947),小记,notion,0,2,2,0,2,2,0.031404,4,0.30602,0.34156,2430.025091
小说(1947),小说,notion,0,2,2,0,2,2,0.028954,4,0.300154,0.333577,2064.821066
小车(1947),小车,notion,0,1,1,0,1,1,0.017323,4,0.281723,0.306272,0
小镇(1947),小镇,notion,0,1,1,0,1,1,0.007422,4,0.26356,0.275695,0
小鱼(1947),小鱼,notion,0,1,1,0,1,1,0.017323,4,0.281723,0.306272,0
少女(1947),少女,notion,0,1,1,0,1,1,0.014732,4,0.276453,0.297813,0
少年先锋(1947),少年先锋,notion,0,1,1,0,1,1,0.00981,4,0.267191,0.28214,0
少数(1947),少数,notion,0,1,1,0,1,1,0.009035,4,0.265075,0.278404,0
少数民族(1947),少数民族,notion,0,1,1,0,1,1,0.014732,4,0.276453,0.297813,0
尔多(1947),尔多,notion,0,1,1,0,1,1,0.00981,4,0.267191,0.28214,0
尔德(1947),尔德,notion,0,1,1,0,1,1,0.009035,4,0.265075,0.278404,0
尚未(1947),尚未,notion,0,1,1,0,1,1,0.013711,4,0.275027,0.295469,0
尝试(1947),尝试,notion,0,1,1,0,2,2,0.007422,4,0.26356,0.275695,0
就业(1947),就业,notion,0,2,2,0,5,5,0.028302,4,0.298866,0.331783,1965.8222
就擒(1947),就擒,notion,0,1,1,0,1,1,0.011229,4,0.270366,0.287632,0
就是(1947),就是,notion,0,5,5,0,11,11,0.047499,4,0.328174,0.369318,11499.377453
就要(1947),就要,notion,0,1,1,0,1,1,0.013711,4,0.275027,0.295469,0
尴尬(1947),尴尬,notion,0,1,1,0,1,1,0.017323,4,0.281723,0.306272,0
尼克(1947),尼克,notion,0,1,1,0,1,1,0.014732,4,0.276453,0.297813,0
尼加拉瓜(1947),尼加拉瓜,notion,0,1,1,0,1,1,0.003588,4,0.255396,0.260534,0
尼古拉(1947),尼古拉,notion,0,1,1,0,1,1,0.00981,4,0.267191,0.28214,0
尼赫鲁(1947),尼赫鲁,notion,0,2,2,0,2,2,0.026359,4,0.294788,0.325997,1561.492709
尽其在我(1947),尽其在我,notion,0,1,1,0,1,1,0.009035,4,0.265075,0.278404,0
尽头(1947),尽头,notion,0,1,1,0,1,1,0.014081,4,0.275493,0.296238,0
尽瘁(1947),尽瘁,notion,0,1,1,0,1,1,0.017323,4,0.281723,0.306272,0
尾声(1947),尾声,notion,0,1,1,0,1,1,0.014732,4,0.276453,0.297813,0
尾巴(1947),尾巴,notion,0,3,3,0,3,3,0.033191,4,0.305036,0.340303,3773.298275
局长(1947),局长,notion,0,1,1,0,1,1,0.00981,4,0.267191,0.28214,0
局面(1947),局面,notion,0,4,4,0,5,5,0.039933,4,0.319034,0.358344,10309.812729
屁股(1947),屁股,notion,0,1,1,0,1,1,0.011229,4,0.270366,0.287632,0
居士(1947),居士,notion,0,1,1,0,1,1,0.009035,4,0.265075,0.278404,0
居正(1947),居正,notion,0,1,1,0,1,1,0.014081,4,0.275493,0.296238,0
屈膝(1947),屈膝,notion,0,1,1,0,1,1,0.00981,4,0.267191,0.28214,0
展开(1947),展开,notion,0,5,5,0,11,11,0.050141,4,0.338456,0.38089,18267.315905
展览(1947),展览,notion,0,1,1,0,1,1,0.007422,4,0.26356,0.275695,0
属于(1947),属于,notion,0,1,1,0,1,1,0.00981,4,0.267191,0.28214,0
属望(1947),属望,notion,0,1,1,0,1,1,0.017323,4,0.281723,0.306272,0
屠杀(1947),屠杀,notion,0,3,3,0,3,3,0.039671,4,0.318706,0.35788,6166.869009
山东(1947),山东,notion,0,4,4,0,6,6,0.049077,4,0.334673,0.376654,11176.572769
山东省(1947),山东省,notion,0,1,1,0,1,1,0.009035,4,0.265075,0.278404,0
山城(1947),山城,notion,0,2,2,0,2,2,0.025961,4,0.295759,0.327389,2231.848602
山姆(1947),山姆,notion,0,1,1,0,1,1,0.00981,4,0.267191,0.28214,0
山歌(1947),山歌,notion,0,1,1,0,4,4,0.003699,4,0.256009,0.261706,0
山水(1947),山水,notion,0,1,1,0,1,1,0.017323,4,0.281723,0.306272,0
山雨欲来(1947),山雨欲来,notion,0,1,1,0,1,1,0.017323,4,0.281723,0.306272,0
山顶(1947),山顶,notion,0,1,1,0,1,1,0.013711,4,0.275027,0.295469,0
岁尾(1947),岁尾,notion,0,1,1,0,1,1,0.011229,4,0.270366,0.287632,0
岁暮(1947),岁暮,notion,0,2,2,0,2,2,0.022153,4,0.289808,0.31871,2534.094371
岂止(1947),岂止,notion,0,1,1,0,1,1,0.013711,4,0.275027,0.295469,0
岂能(1947),岂能,notion,0,1,1,0,1,1,0.014081,4,0.275493,0.296238,0
岗位(1947),岗位,notion,0,1,1,0,1,1,0.017323,4,0.281723,0.306272,0
岩穴(1947),岩穴,notion,0,1,1,0,1,1,0.002092,4,0.25318,0.25625,0
岳军(1947),岳军,notion,0,1,1,0,1,1,0.009035,4,0.265075,0.278404,0
峡口(1947),峡口,notion,0,1,1,0,1,1,0.014222,4,0.275404,0.296091,0
峨嵋(1947),峨嵋,notion,0,1,1,0,1,1,0.014222,4,0.275404,0.296091,0
崑山(1947),崑山,notion,0,1,1,0,1,1,0.014222,4,0.275404,0.296091,0
嵊泗(1947),嵊泗,notion,0,1,1,0,1,1,0.007422,4,0.26356,0.275695,0
川南(1947),川南,notion,0,1,1,0,1,1,0.014222,4,0.275404,0.296091,0
巡映(1947),巡映,notion,0,1,1,0,1,1,0.007422,4,0.26356,0.275695,0
巡行(1947),巡行,notion,0,1,1,0,1,1,0.011229,4,0.270366,0.287632,0
工业化(1947),工业化,notion,0,3,3,0,4,4,0.037338,4,0.310954,0.348103,4493.316655
工业协会(1947),工业协会,notion,0,1,1,0,1,1,0.017323,4,0.281723,0.306272,0
工业家(1947),工业家,notion,0,1,1,0,1,1,0.017323,4,0.281723,0.306272,0
工人运动(1947),工人运动,notion,0,1,1,0,1,1,0.00981,4,0.267191,0.28214,0
工人阶级(1947),工人阶级,notion,0,1,1,0,1,1,0.00981,4,0.267191,0.28214,0
工会(1947),工会,notion,0,2,2,0,2,2,0.017299,4,0.278915,0.301865,688.562525
工作站(1947),工作站,notion,0,1,1,0,1,1,0.007422,4,0.26356,0.275695,0
工党(1947),工党,notion,0,2,2,0,4,4,0.023891,4,0.292014,0.321969,2116.906395
工兵(1947),工兵,notion,0,1,1,0,1,1,0.00981,4,0.267191,0.28214,0
工具(1947),工具,notion,0,2,2,0,2,2,0.023891,4,0.292014,0.321969,2116.906395
工农联盟(1947),工农联盟,notion,0,1,1,0,1,1,0.00981,4,0.267191,0.28214,0
工厂(1947),工厂,notion,0,2,2,0,3,3,0.024542,4,0.292264,0.322335,1826.657886
工商(1947),工商,notion,0,2,2,0,2,2,0.031034,4,0.30613,0.341707,2639.595687
工商业(1947),工商业,notion,0,4,4,0,4,4,0.045851,4,0.328869,0.370062,9160.854112
工潮(1947),工潮,notion,0,3,3,0,4,4,0.028528,4,0.296787,0.328915,3134.739374
工界(1947),工界,notion,0,1,1,0,1,1,0.013711,4,0.275027,0.295469,0
工矿(1947),工矿,notion,0,1,1,0,1,1,0.014222,4,0.275404,0.296091,0
工程(1947),工程,notion,0,1,1,0,1,1,0.014222,4,0.275404,0.296091,0
工程学(1947),工程学,notion,0,1,1,0,1,1,0.014222,4,0.275404,0.296091,0
工程师(1947),工程师,notion,0,1,1,0,3,3,0.014222,4,0.275404,0.296091,0
工资(1947),工资,notion,0,1,1,0,1,1,0.014222,4,0.275404,0.296091,0
工资制度(1947),工资制度,notion,0,1,1,0,1,1,0.014222,4,0.275404,0.296091,0
工赈(1947),工赈,notion,0,1,1,0,1,1,0.014732,4,0.276453,0.297813,0
工运(1947),工运,notion,0,2,2,0,2,2,0.021039,4,0.286524,0.313766,1874.195629
左右(1947),左右,notion,0,3,3,0,3,3,0.02535,4,0.289832,0.318808,2610.409927
左拉(1947),左拉,notion,0,1,1,0,1,1,0.014732,4,0.276453,0.297813,0
左派(1947),左派,notion,0,1,1,0,1,1,0.014732,4,0.276453,0.297813,0
巧妇(1947),巧妇,notion,0,2,2,0,2,2,0.018829,4,0.280473,0.304355,655.354404
巨雷(1947),巨雷,notion,0,1,1,0,1,1,0.014081,4,0.275493,0.296238,0
巩固(1947),巩固,notion,0,1,1,0,2,2,0.017323,4,0.281723,0.306272,0
差钦(1947),差钦,notion,0,1,1,0,1,1,0.013711,4,0.275027,0.295469,0
已刊(1947),已刊,notion,0,1,1,0,1,1,0.017323,4,0.281723,0.306272,0
已及(1947),已及,notion,0,1,1,0,1,1,0.014081,4,0.275493,0.296238,0
已成(1947),已成,notion,0,1,1,0,1,1,0.014732,4,0.276453,0.297813,0
已披(1947),已披,notion,0,1,1,0,1,1,0.014081,4,0.275493,0.296238,0
已空(1947),已空,notion,0,1,1,0,1,1,0.017323,4,0.281723,0.306272,0
已经(1947),已经,notion,0,3,3,0,3,3,0.039162,4,0.318825,0.358027,6544.514107
巴人(1947),巴人,notion,0,1,1,0,1,1,0.017323,4,0.281723,0.306272,0
巴勒(1947),巴勒,notion,0,1,1,0,1,1,0.014732,4,0.276453,0.297813,0
巴勒斯坦(1947),巴勒斯坦,notion,0,1,1,0,1,1,0.00981,4,0.267191,0.28214,0
巴基斯坦(1947),巴基斯坦,notion,0,2,2,0,2,2,0.026359,4,0.294788,0.325997,1561.492709
巴尔干(1947),巴尔干,notion,0,1,1,0,1,1,0.017323,4,0.281723,0.306272,0
巴尔扎克(1947),巴尔扎克,notion,0,1,1,0,1,1,0.014732,4,0.276453,0.297813,0
巴拿马(1947),巴拿马,notion,0,1,1,0,1,1,0.00981,4,0.267191,0.28214,0
巴特勒(1947),巴特勒,notion,0,1,1,0,1,1,0.017323,4,0.281723,0.306272,0
巴甫洛夫(1947),巴甫洛夫,notion,0,2,2,0,3,3,0.027133,4,0.29671,0.328744,1770.9936
币料(1947),币料,notion,0,1,1,0,1,1,0.014222,4,0.275404,0.296091,0
市价(1947),市价,notion,0,1,1,0,1,1,0.014081,4,0.275493,0.296238,0
市侩(1947),市侩,notion,0,2,2,0,2,2,0.01948,4,0.281468,0.30593,668.20053
市场(1947),市场,notion,0,2,2,0,5,5,0.018431,4,0.28119,0.30549,1040.874592
市政建设(1947),市政建设,notion,0,1,1,0,1,1,0.014222,4,0.275404,0.296091,0
市柴(1947),市柴,notion,0,1,1,0,1,1,0.009035,4,0.265075,0.278404,0
市民(1947),市民,notion,0,1,1,0,2,2,0.014732,4,0.276453,0.297813,0
市镇(1947),市镇,notion,0,1,1,0,1,1,0.011229,4,0.270366,0.287632,0
市长(1947),市长,notion,0,1,1,0,1,1,0.009035,4,0.265075,0.278404,0
布利(1947),布利,notion,0,1,1,0,1,1,0.000869,4,0.251131,0.252222,0
布尔(1947),布尔,notion,0,1,1,0,1,1,0.00981,4,0.267191,0.28214,0
布尔什维克(1947),布尔什维克,notion,0,1,1,0,1,1,0.014222,4,0.275404,0.296091,0
布拉(1947),布拉,notion,0,1,1,0,1,1,0.00981,4,0.267191,0.28214,0
布拉格(1947),布拉格,notion,0,1,1,0,1,1,0.013711,4,0.275027,0.295469,0
布置(1947),布置,notion,0,1,1,0,1,1,0.013711,4,0.275027,0.295469,0
布袋(1947),布袋,notion,0,1,1,0,1,1,0.011229,4,0.270366,0.287632,0
布达佩斯(1947),布达佩斯,notion,0,1,1,0,1,1,0.004749,4,0.257108,0.263793,0
师儒(1947),师儒,notion,0,1,1,0,1,1,0.014081,4,0.275493,0.296238,0
师生(1947),师生,notion,0,2,2,0,2,2,0.032055,4,0.30624,0.341853,2215.722594
师范大学(1947),师范大学,notion,0,1,1,0,1,1,0.014732,4,0.276453,0.297813,0
师范学院(1947),师范学院,notion,0,1,1,0,1,1,0.000869,4,0.251131,0.252222,0
师道(1947),师道,notion,0,1,1,0,1,1,0.003588,4,0.255396,0.260534,0
希卡(1947),希卡,notion,0,1,1,0,1,1,0.00981,4,0.267191,0.28214,0
希土(1947),希土,notion,0,2,2,0,2,2,0.023116,4,0.288412,0.316623,1358.22258
希土案(1947),希土案,notion,0,2,2,0,2,2,0.023257,4,0.28761,0.315414,1169.271875
希特勒(1947),希特勒,notion,0,1,1,0,3,3,0.00981,4,0.267191,0.28214,0
帝国(1947),帝国,notion,0,3,3,0,3,3,0.040439,4,0.318885,0.3581,5349.74038
帝国主义(1947),帝国主义,notion,0,6,6,0,8,8,0.06831,4,0.367616,0.410246,23550.425735
带来(1947),带来,notion,0,2,2,0,2,2,0.021132,4,0.288412,0.316623,2574.708611
带枪(1947),带枪,notion,0,1,1,0,1,1,0.017323,4,0.281723,0.306272,0
带给(1947),带给,notion,0,1,1,0,1,1,0.013711,4,0.275027,0.295469,0
帮会(1947),帮会,notion,0,1,1,0,1,1,0.009035,4,0.265075,0.278404,0
帮兇者(1947),帮兇者,notion,0,1,1,0,1,1,0.013711,4,0.275027,0.295469,0
帮兕(1947),帮兕,notion,0,1,1,0,1,1,0.013711,4,0.275027,0.295469,0
帮凶(1947),帮凶,notion,0,1,1,0,1,1,0.003699,4,0.256009,0.261706,0
帮助(1947),帮助,notion,0,1,1,0,1,1,0.013711,4,0.275027,0.295469,0
帮忙(1947),帮忙,notion,0,1,1,0,1,1,0.014732,4,0.276453,0.297813,0
常常(1947),常常,notion,0,1,1,0,2,2,0.014081,4,0.275493,0.296238,0
常态(1947),常态,notion,0,1,1,0,1,1,0.014222,4,0.275404,0.296091,0
常识(1947),常识,notion,0,2,2,0,2,2,0.024745,4,0.295069,0.3264,2684.608967
幕后(1947),幕后,notion,0,1,1,0,1,1,0.014222,4,0.275404,0.296091,0
干事(1947),干事,notion,0,1,1,0,1,1,0.011229,4,0.270366,0.287632,0
干什么(1947),干什么,notion,0,1,1,0,1,1,0.017323,4,0.281723,0.306272,0
干尼(1947),干尼,notion,0,1,1,0,1,1,0.017323,4,0.281723,0.306272,0
干涉(1947),干涉,notion,0,6,6,0,6,6,0.065782,4,0.363854,0.406731,24696.855873
干训(1947),干训,notion,0,1,1,0,1,1,0.011229,4,0.270366,0.287632,0
干部(1947),干部,notion,0,1,1,0,1,1,0.007422,4,0.26356,0.275695,0
平保(1947),平保,notion,0,1,1,0,1,1,0.017323,4,0.281723,0.306272,0
平保间(1947),平保间,notion,0,1,1,0,1,1,0.017323,4,0.281723,0.306272,0
平凡(1947),平凡,notion,0,1,1,0,1,1,0.014732,4,0.276453,0.297813,0
平分(1947),平分,notion,0,1,1,0,2,2,0.013711,4,0.275027,0.295469,0
平均(1947),平均,notion,0,1,1,0,1,1,0.002092,4,0.25318,0.25625,0
平均地权(1947),平均地权,notion,0,2,2,0,2,2,0.031545,4,0.305336,0.340645,2219.908318
平息(1947),平息,notion,0,2,2,0,2,2,0.028302,4,0.298866,0.331783,1965.8222
平教援(1947),平教援,notion,0,1,1,0,1,1,0.017323,4,0.281723,0.306272,0
平易近人(1947),平易近人,notion,0,1,1,0,1,1,0.014222,4,0.275404,0.296091,0
平民化(1947),平民化,notion,0,1,1,0,1,1,0.014222,4,0.275404,0.296091,0
平气(1947),平气,notion,0,1,1,0,1,1,0.009035,4,0.265075,0.278404,0
平汉(1947),平汉,notion,0,1,1,0,1,1,0.013711,4,0.275027,0.295469,0
平汉线(1947),平汉线,notion,0,1,1,0,1,1,0.017323,4,0.281723,0.306272,0
平等(1947),平等,notion,0,4,4,0,6,6,0.040205,4,0.317727,0.356733,8341.174562
平衡(1947),平衡,notion,0,1,1,0,1,1,0.014081,4,0.275493,0.296238,0
平议(1947),平议,notion,0,3,3,0,3,3,0.04109,4,0.319332,0.358649,5229.401507
平野(1947),平野,notion,0,1,1,0,2,2,0.017323,4,0.281723,0.306272,0
平静(1947),平静,notion,0,1,1,0,1,1,0.013711,4,0.275027,0.295469,0
年代(1947),年代,notion,0,1,1,0,1,1,0.014222,4,0.275404,0.296091,0
年关(1947),年关,notion,0,2,2,0,2,2,0.021022,4,0.286837,0.314242,1344.24886
年初(1947),年初,notion,0,1,1,0,1,1,0.011229,4,0.270366,0.287632,0
年前(1947),年前,notion,0,1,1,0,1,1,0.014081,4,0.275493,0.296238,0
年纪(1947),年纪,notion,0,1,1,0,1,1,0.011229,4,0.270366,0.287632,0
年终(1947),年终,notion,0,1,1,0,1,1,0.007422,4,0.26356,0.275695,0
年轻人(1947),年轻人,notion,0,1,1,0,1,1,0.007422,4,0.26356,0.275695,0
年间(1947),年间,notion,0,1,1,0,4,4,0.011229,4,0.270366,0.287632,0
年青人(1947),年青人,notion,0,1,1,0,1,1,0.014732,4,0.276453,0.297813,0
并不一定(1947),并不一定,notion,0,1,1,0,1,1,0.013711,4,0.275027,0.295469,0
并未(1947),并未,notion,0,1,1,0,1,1,0.013711,4,0.275027,0.295469,0
并重(1947),并重,notion,0,1,1,0,1,1,0.011229,4,0.270366,0.287632,0
幸福(1947),幸福,notion,0,2,2,0,3,3,0.028442,4,0.300022,0.333394,2187.730369
幻影(1947),幻影,notion,0,1,1,0,1,1,0.00981,4,0.267191,0.28214,0
幻想(1947),幻想,notion,0,2,2,0,2,2,0.023521,4,0.291018,0.320504,1911.402908
幻术(1947),幻术,notion,0,1,1,0,1,1,0.014732,4,0.276453,0.297813,0
幻灭(1947),幻灭,notion,0,1,1,0,1,1,0.014222,4,0.275404,0.296091,0
幼年(1947),幼年,notion,0,1,1,0,1,1,0.017323,4,0.281723,0.306272,0
幼稚(1947),幼稚,notion,0,1,1,0,1,1,0.007422,4,0.26356,0.275695,0
幼稚教育(1947),幼稚教育,notion,0,1,1,0,1,1,0.014222,4,0.275404,0.296091,0
幽灵(1947),幽灵,notion,0,2,2,0,2,2,0.018845,4,0.280243,0.303989,1083.402703
幽静(1947),幽静,notion,0,1,1,0,1,1,0.014222,4,0.275404,0.296091,0
幽默(1947),幽默,notion,0,1,1,0,1,1,0.00981,4,0.267191,0.28214,0
广告(1947),广告,notion,0,2,2,0,4,4,0.01778,4,0.280866,0.304978,1353.416142
广大(1947),广大,notion,0,1,1,0,1,1,0.009035,4,0.265075,0.278404,0
广孝(1947),广孝,notion,0,1,1,0,1,1,0.017323,4,0.281723,0.306272,0
广宁(1947),广宁,notion,0,1,1,0,3,3,0.011229,4,0.270366,0.287632,0
广播(1947),广播,notion,0,3,3,0,7,7,0.032633,4,0.306432,0.342171,2472.136099
广泛(1947),广泛,notion,0,1,1,0,1,1,0.011229,4,0.270366,0.287632,0
广济(1947),广济,notion,0,1,1,0,1,1,0.014081,4,0.275493,0.296238,0
广西大学(1947),广西大学,notion,0,2,2,0,2,2,0.02494,4,0.292941,0.323324,1747.290038
庄严(1947),庄严,notion,0,1,1,0,1,1,0.017323,4,0.281723,0.306272,0
庄启锡(1947),庄启锡,notion,0,1,1,0,1,1,0.011229,4,0.270366,0.287632,0
庆祝(1947),庆祝,notion,0,2,2,0,2,2,0.032055,4,0.30624,0.341853,2215.722594
庆祝会(1947),庆祝会,notion,0,1,1,0,2,2,0.014222,4,0.275404,0.296091,0
庆祝大会(1947),庆祝大会,notion,0,1,1,0,1,1,0.00981,4,0.267191,0.28214,0
庇护(1947),庇护,notion,0,1,1,0,1,1,0.003699,4,0.256009,0.261706,0
库洛夫(1947),库洛夫,notion,0,1,1,0,1,1,0.00981,4,0.267191,0.28214,0
应使(1947),应使,notion,0,1,1,0,1,1,0.009035,4,0.265075,0.278404,0
应即(1947),应即,notion,0,1,1,0,1,1,0.004749,4,0.257108,0.263793,0
应否(1947),应否,notion,0,1,1,0,1,1,0.013711,4,0.275027,0.295469,0
应对(1947),应对,notion,0,1,1,0,1,1,0.014081,4,0.275493,0.296238,0
应当(1947),应当,notion,0,2,2,0,2,2,0.021502,4,0.288388,0.316586,2245.621531
应循(1947),应循,notion,0,1,1,0,1,1,0.014222,4,0.275404,0.296091,0
应有(1947),应有,notion,0,6,6,0,13,13,0.071367,4,0.377704,0.419328,26400.306193
应由(1947),应由,notion,0,1,1,0,1,1,0.014081,4,0.275493,0.296238,0
应立即(1947),应立即,notion,0,1,1,0,1,1,0.002092,4,0.25318,0.25625,0
应该(1947),应该,notion,0,9,9,0,18,18,0.084392,4,0.397265,0.435806,45377.798929
应重(1947),应重,notion,0,1,1,0,1,1,0.014081,4,0.275493,0.296238,0
底新(1947),底新,notion,0,1,1,0,1,1,0.014732,4,0.276453,0.297813,0
废止(1947),废止,notion,0,1,1,0,1,1,0.017323,4,0.281723,0.306272,0
废票(1947),废票,notion,0,1,1,0,1,1,0.014732,4,0.276453,0.297813,0
座谈(1947),座谈,notion,0,2,2,0,2,2,0.024745,4,0.295069,0.3264,2684.608967
座谈会(1947),座谈会,notion,0,2,2,0,4,4,0.028552,4,0.301506,0.335445,2588.539662
庵谭(1947),庵谭,notion,0,1,1,0,1,1,0.014222,4,0.275404,0.296091,0
庶几(1947),庶几,notion,0,1,1,0,1,1,0.013711,4,0.275027,0.295469,0
康定(1947),康定,notion,0,1,1,0,1,1,0.014081,4,0.275493,0.296238,0
廉价(1947),廉价,notion,0,1,1,0,1,1,0.013711,4,0.275027,0.295469,0
延安(1947),延安,notion,0,4,4,0,10,10,0.048056,4,0.332424,0.374127,11195.206897
延期(1947),延期,notion,0,1,1,0,1,1,0.014222,4,0.275404,0.296091,0
延辉(1947),延辉,notion,0,1,1,0,1,1,0.017323,4,0.281723,0.306272,0
建军(1947),建军,notion,0,1,1,0,1,1,0.00981,4,0.267191,0.28214,0
建农(1947),建农,notion,0,1,1,0,1,1,0.007422,4,0.26356,0.275695,0
建国(1947),建国,notion,0,4,4,0,6,6,0.052584,4,0.34291,0.385626,12502.904696
建省(1947),建省,notion,0,1,1,0,1,1,0.014222,4,0.275404,0.296091,0
建立(1947),建立,notion,0,3,3,0,6,6,0.038112,4,0.315379,0.353742,5778.22737
建筑(1947),建筑,notion,0,2,2,0,2,2,0.024032,4,0.290894,0.320321,1695.498775
建置(1947),建置,notion,0,1,1,0,3,3,0.007422,4,0.26356,0.275695,0
建议案(1947),建议案,notion,0,1,1,0,1,1,0.009035,4,0.265075,0.278404,0
建都(1947),建都,notion,0,2,2,0,2,2,0.018845,4,0.280243,0.303989,1083.402703
廿七(1947),廿七,notion,0,1,1,0,1,1,0.011229,4,0.270366,0.287632,0
廿三(1947),廿三,notion,0,1,1,0,1,1,0.00981,4,0.267191,0.28214,0
廿二(1947),廿二,notion,0,2,2,0,2,2,0.023521,4,0.291018,0.320504,1911.402908
廿五(1947),廿五,notion,0,1,1,0,1,1,0.014222,4,0.275404,0.296091,0
廿五年(1947),廿五年,notion,0,1,1,0,1,1,0.014222,4,0.275404,0.296091,0
廿年(1947),廿年,notion,0,1,1,0,1,1,0.011229,4,0.270366,0.287632,0
开会(1947),开会,notion,0,1,1,0,1,1,0.017323,4,0.281723,0.306272,0
开去(1947),开去,notion,0,1,1,0,1,1,0.014732,4,0.276453,0.297813,0
开封(1947),开封,notion,0,1,1,0,2,2,0.013711,4,0.275027,0.295469,0
开展(1947),开展,notion,0,4,4,0,4,4,0.039324,4,0.321074,0.360834,9597.021393
开幕(1947),开幕,notion,0,2,2,0,2,2,0.024032,4,0.290894,0.320321,1695.498775
开拓(1947),开拓,notion,0,1,1,0,1,1,0.007422,4,0.26356,0.275695,0
开放(1947),开放,notion,0,7,7,0,13,13,0.087852,4,0.407315,0.443448,33925.397637
开明(1947),开明,notion,0,1,1,0,1,1,0.011229,4,0.270366,0.287632,0
开禁(1947),开禁,notion,0,1,1,0,1,1,0.014081,4,0.275493,0.296238,0
开端(1947),开端,notion,0,2,2,0,2,2,0.017299,4,0.278915,0.301865,688.562525
开释(1947),开释,notion,0,1,1,0,1,1,0.017323,4,0.281723,0.306272,0
开除(1947),开除,notion,0,3,3,0,4,4,0.039532,4,0.319751,0.359162,6816.359733
异哉(1947),异哉,notion,0,1,1,0,1,1,0.017323,4,0.281723,0.306272,0
异域(1947),异域,notion,0,1,1,0,1,1,0.007422,4,0.26356,0.275695,0
异己(1947),异己,notion,0,1,1,0,1,1,0.014081,4,0.275493,0.296238,0
异战(1947),异战,notion,0,1,1,0,1,1,0.014732,4,0.276453,0.297813,0
异邦(1947),异邦,notion,0,1,1,0,1,1,0.014222,4,0.275404,0.296091,0
弃市(1947),弃市,notion,0,1,1,0,1,1,0.011229,4,0.270366,0.287632,0
弄清(1947),弄清,notion,0,1,1,0,2,2,0.011229,4,0.270366,0.287632,0
弄通(1947),弄通,notion,0,1,1,0,1,1,0.011229,4,0.270366,0.287632,0
弊端(1947),弊端,notion,0,1,1,0,1,1,0.009035,4,0.265075,0.278404,0
弔民伐罪(1947),弔民伐罪,notion,0,1,1,0,1,1,0.014222,4,0.275404,0.296091,0
引伸(1947),引伸,notion,0,1,1,0,1,1,0.014081,4,0.275493,0.296238,0
引入歧途(1947),引入歧途,notion,0,1,1,0,1,1,0.017323,4,0.281723,0.306272,0
引导(1947),引导,notion,0,1,1,0,1,1,0.00981,4,0.267191,0.28214,0
引用(1947),引用,notion,0,1,1,0,1,1,0.014222,4,0.275404,0.296091,0
引错(1947),引错,notion,0,1,1,0,1,1,0.014732,4,0.276453,0.297813,0
弗朗哥(1947),弗朗哥,notion,0,1,1,0,1,1,0.014732,4,0.276453,0.297813,0
张作霖(1947),张作霖,notion,0,1,1,0,1,1,0.014222,4,0.275404,0.296091,0
张发奎(1947),张发奎,notion,0,1,1,0,1,1,0.013711,4,0.275027,0.295469,0
张园(1947),张园,notion,0,1,1,0,1,1,0.017323,4,0.281723,0.306272,0
张学良(1947),张学良,notion,0,2,2,0,2,2,0.022072,4,0.287175,0.314755,862.424175
张家口(1947),张家口,notion,0,1,1,0,1,1,0.014732,4,0.276453,0.297813,0
张居正(1947),张居正,notion,0,1,1,0,1,1,0.014222,4,0.275404,0.296091,0
张弘(1947),张弘,notion,0,1,1,0,1,1,0.017323,4,0.281723,0.306272,0
张氏(1947),张氏,notion,0,1,1,0,1,1,0.014732,4,0.276453,0.297813,0
张网(1947),张网,notion,0,1,1,0,1,1,0.007422,4,0.26356,0.275695,0
张美淦(1947),张美淦,notion,0,1,1,0,1,1,0.011229,4,0.270366,0.287632,0
张羣(1947),张羣,notion,0,1,1,0,1,1,0.014081,4,0.275493,0.296238,0
弥补(1947),弥补,notion,0,1,1,0,1,1,0.014222,4,0.275404,0.296091,0
弱小民族(1947),弱小民族,notion,0,1,1,0,1,1,0.000869,4,0.251131,0.252222,0
弱点(1947),弱点,notion,0,1,1,0,1,1,0.017323,4,0.281723,0.306272,0
强力(1947),强力,notion,0,1,1,0,1,1,0.002092,4,0.25318,0.25625,0
强化(1947),强化,notion,0,1,1,0,1,1,0.007422,4,0.26356,0.275695,0
强奸(1947),强奸,notion,0,1,1,0,2,2,0.014732,4,0.276453,0.297813,0
强姦(1947),强姦,notion,0,1,1,0,1,1,0.009035,4,0.265075,0.278404,0
强姦案(1947),强姦案,notion,0,1,1,0,1,1,0.014081,4,0.275493,0.296238,0
强权政治(1947),强权政治,notion,0,1,1,0,1,1,0.014222,4,0.275404,0.296091,0
强渡(1947),强渡,notion,0,1,1,0,1,1,0.013711,4,0.275027,0.295469,0
强点(1947),强点,notion,0,1,1,0,1,1,0.017323,4,0.281723,0.306272,0
强盗(1947),强盗,notion,0,1,1,0,1,1,0.013711,4,0.275027,0.295469,0
强硬(1947),强硬,notion,0,1,1,0,1,1,0.009035,4,0.265075,0.278404,0
强调(1947),强调,notion,0,1,1,0,1,1,0.017323,4,0.281723,0.306272,0
强辞(1947),强辞,notion,0,1,1,0,1,1,0.017323,4,0.281723,0.306272,0
归于(1947),归于,notion,0,1,1,0,1,1,0.00981,4,0.267191,0.28214,0
归客(1947),归客,notion,0,1,1,0,1,1,0.014081,4,0.275493,0.296238,0
归属(1947),归属,notion,0,1,1,0,1,1,0.014081,4,0.275493,0.296238,0
归来(1947),归来,notion,0,3,3,0,3,3,0.039532,4,0.319751,0.359162,6816.359733
归还(1947),归还,notion,0,1,1,0,1,1,0.014081,4,0.275493,0.296238,0
当代(1947),当代,notion,0,1,1,0,1,1,0.002092,4,0.25318,0.25625,0
当作(1947),当作,notion,0,1,1,0,1,1,0.013711,4,0.275027,0.295469,0
当兵(1947),当兵,notion,0,1,1,0,1,1,0.014732,4,0.276453,0.297813,0
当局(1947),当局,notion,0,4,4,0,5,5,0.047381,4,0.331907,0.373541,9930.284138
当年(1947),当年,notion,0,2,2,0,2,2,0.024745,4,0.295069,0.3264,2684.608967
当心(1947),当心,notion,0,3,3,0,4,4,0.032361,4,0.30646,0.342207,6339.208536
当急(1947),当急,notion,0,1,1,0,1,1,0.011229,4,0.270366,0.287632,0
当时(1947),当时,notion,0,1,1,0,1,1,0.007422,4,0.26356,0.275695,0
当权(1947),当权,notion,0,1,1,0,1,1,0.011229,4,0.270366,0.287632,0
当选(1947),当选,notion,0,1,1,0,1,1,0.017323,4,0.281723,0.306272,0
录之五(1947),录之五,notion,0,1,1,0,1,1,0.007422,4,0.26356,0.275695,0
录之六(1947),录之六,notion,0,1,1,0,1,1,0.007422,4,0.26356,0.275695,0
形势(1947),形势,notion,0,6,6,0,6,6,0.074916,4,0.387216,0.427457,28650.565513
形式(1947),形式,notion,0,2,2,0,2,2,0.028954,4,0.300154,0.333577,2064.821066
形成(1947),形成,notion,0,2,2,0,2,2,0.011128,4,0.267547,0.282823,588.117547
影剧(1947),影剧,notion,0,1,1,0,1,1,0.014222,4,0.275404,0.296091,0
影响(1947),影响,notion,0,3,3,0,3,3,0.033383,4,0.30932,0.345979,6783.15286
影城(1947),影城,notion,0,1,1,0,1,1,0.017323,4,0.281723,0.306272,0
影子(1947),影子,notion,0,1,1,0,1,1,0.014732,4,0.276453,0.297813,0
影片(1947),影片,notion,0,1,1,0,1,1,0.003699,4,0.256009,0.261706,0
影讯(1947),影讯,notion,0,1,1,0,1,1,0.014732,4,0.276453,0.297813,0
彼得(1947),彼得,notion,0,1,1,0,1,1,0.00981,4,0.267191,0.28214,0
彼得格勒(1947),彼得格勒,notion,0,1,1,0,1,1,0.00981,4,0.267191,0.28214,0
往事(1947),往事,notion,0,2,2,0,2,2,0.027133,4,0.29671,0.328744,1770.9936
征借(1947),征借,notion,0,1,1,0,1,1,0.014732,4,0.276453,0.297813,0
征兆(1947),征兆,notion,0,1,1,0,1,1,0.00981,4,0.267191,0.28214,0
征兵(1947),征兵,notion,0,2,2,0,2,2,0.025961,4,0.295759,0.327389,2231.848602
征戍忆(1947),征戍忆,notion,0,1,1,0,1,1,0.009035,4,0.265075,0.278404,0
征服(1947),征服,notion,0,3,3,0,3,3,0.03475,4,0.309488,0.346199,5532.888574
征粮(1947),征粮,notion,0,2,2,0,2,2,0.023116,4,0.288412,0.316623,1358.22258
待人接物(1947),待人接物,notion,0,1,1,0,1,1,0.014222,4,0.275404,0.296091,0
待遇(1947),待遇,notion,0,3,3,0,4,4,0.033561,4,0.304356,0.339388,3349.170174
律师(1947),律师,notion,0,1,1,0,1,1,0.017323,4,0.281723,0.306272,0
徐家(1947),徐家,notion,0,1,1,0,1,1,0.013711,4,0.275027,0.295469,0
徐州(1947),徐州,notion,0,2,2,0,2,2,0.028302,4,0.298866,0.331783,1965.8222
得到(1947),得到,notion,0,3,3,0,3,3,0.037478,4,0.313669,0.351582,5215.620442
得奖(1947),得奖,notion,0,1,1,0,1,1,0.00981,4,0.267191,0.28214,0
得来(1947),得来,notion,0,1,1,0,1,1,0.007422,4,0.26356,0.275695,0
微弱(1947),微弱,notion,0,1,1,0,1,1,0.009035,4,0.265075,0.278404,0
徵兵(1947),徵兵,notion,0,2,2,0,2,2,0.027791,4,0.29968,0.332918,2405.290268
徵文(1947),徵文,notion,0,1,1,0,8,8,0.014222,4,0.275404,0.296091,0
徵答(1947),徵答,notion,0,1,1,0,1,1,0.014081,4,0.275493,0.296238,0
德化(1947),德化,notion,0,1,1,0,1,1,0.014081,4,0.275493,0.296238,0
德境(1947),德境,notion,0,1,1,0,4,4,0.00981,4,0.267191,0.28214,0
德惠(1947),德惠,notion,0,1,1,0,1,1,0.004749,4,0.257108,0.263793,0
心事(1947),心事,notion,0,1,1,0,1,1,0.017323,4,0.281723,0.306272,0
心压(1947),心压,notion,0,1,1,0,1,1,0.013711,4,0.275027,0.295469,0
心影录(1947),心影录,notion,0,1,1,0,1,1,0.007422,4,0.26356,0.275695,0
心理健康(1947),心理健康,notion,0,1,1,0,1,1,0.007422,4,0.26356,0.275695,0
心理学(1947),心理学,notion,0,1,1,0,1,1,0.014081,4,0.275493,0.296238,0
心目(1947),心目,notion,0,2,2,0,2,2,0.027932,4,0.299811,0.333101,2443.455357
心脏(1947),心脏,notion,0,1,1,0,1,1,0.003699,4,0.256009,0.261706,0
心迹(1947),心迹,notion,0,1,1,0,1,1,0.009035,4,0.265075,0.278404,0
心里(1947),心里,notion,0,2,2,0,2,2,0.02494,4,0.292941,0.323324,1747.290038
必修(1947),必修,notion,0,1,1,0,1,1,0.014081,4,0.275493,0.296238,0
必善(1947),必善,notion,0,1,1,0,1,1,0.014222,4,0.275404,0.296091,0
必杀(1947),必杀,notion,0,1,1,0,1,1,0.014732,4,0.276453,0.297813,0
必能(1947),必能,notion,0,1,1,0,1,1,0.002092,4,0.25318,0.25625,0
必要(1947),必要,notion,0,1,1,0,1,1,0.007422,4,0.26356,0.275695,0
忆之九(1947),忆之九,notion,0,1,1,0,1,1,0.014081,4,0.275493,0.296238,0
忆之十(1947),忆之十,notion,0,1,1,0,1,1,0.014081,4,0.275493,0.296238,0
忆屑(1947),忆屑,notion,0,1,1,0,1,1,0.007422,4,0.26356,0.275695,0
忆晴皋(1947),忆晴皋,notion,0,1,1,0,1,1,0.014222,4,0.275404,0.296091,0
忆柔石(1947),忆柔石,notion,0,1,1,0,1,1,0.003699,4,0.256009,0.261706,0
忌辰(1947),忌辰,notion,0,1,1,0,3,3,0.00981,4,0.267191,0.28214,0
忍受(1947),忍受,notion,0,1,1,0,1,1,0.011229,4,0.270366,0.287632,0
忍耐(1947),忍耐,notion,0,1,1,0,1,1,0.014081,4,0.275493,0.296238,0
志愿兵(1947),志愿兵,notion,0,2,2,0,2,2,0.02494,4,0.292941,0.323324,1747.290038
志愿军(1947),志愿军,notion,0,1,1,0,1,1,0.014732,4,0.276453,0.297813,0
忘却(1947),忘却,notion,0,1,1,0,1,1,0.007422,4,0.26356,0.275695,0
忘掉(1947),忘掉,notion,0,1,1,0,1,1,0.017323,4,0.281723,0.306272,0
忘记(1947),忘记,notion,0,2,2,0,2,2,0.028442,4,0.300022,0.333394,2187.730369
忙死(1947),忙死,notion,0,1,1,0,1,1,0.013711,4,0.275027,0.295469,0
忠告(1947),忠告,notion,0,3,3,0,4,4,0.02265,4,0.287368,0.315109,1036.781532
忠孝(1947),忠孝,notion,0,1,1,0,1,1,0.014732,4,0.276453,0.297813,0
忠诚(1947),忠诚,notion,0,1,1,0,2,2,0.011229,4,0.270366,0.287632,0
忠魂(1947),忠魂,notion,0,1,1,0,1,1,0.014732,4,0.276453,0.297813,0
快些(1947),快些,notion,0,1,1,0,1,1,0.014732,4,0.276453,0.297813,0
快来(1947),快来,notion,0,1,1,0,1,1,0.014732,4,0.276453,0.297813,0
快要(1947),快要,notion,0,1,1,0,1,1,0.013711,4,0.275027,0.295469,0
快车(1947),快车,notion,0,1,1,0,1,1,0.017323,4,0.281723,0.306272,0
忽视(1947),忽视,notion,0,1,1,0,1,1,0.011229,4,0.270366,0.287632,0
怀中(1947),怀中,notion,0,1,1,0,1,1,0.009035,4,0.265075,0.278404,0
怀念(1947),怀念,notion,0,3,3,0,5,5,0.042774,4,0.326479,0.367218,7162.216692
怀疑(1947),怀疑,notion,0,1,1,0,1,1,0.017323,4,0.281723,0.306272,0
态度(1947),态度,notion,0,9,9,0,15,15,0.087818,4,0.408582,0.444522,52503.127853
怎么(1947),怎么,notion,0,1,1,0,1,1,0.009035,4,0.265075,0.278404,0
怎么样(1947),怎么样,notion,0,1,1,0,1,1,0.011229,4,0.270366,0.287632,0
怒吼(1947),怒吼,notion,0,4,4,0,4,4,0.049465,4,0.336256,0.378412,10626.65254
怒视(1947),怒视,notion,0,1,1,0,1,1,0.011229,4,0.270366,0.287632,0
思潮(1947),思潮,notion,0,3,3,0,4,4,0.033496,4,0.308621,0.345064,4530.343632
思索(1947),思索,notion,0,1,1,0,1,1,0.009035,4,0.265075,0.278404,0
急惊风(1947),急惊风,notion,0,1,1,0,1,1,0.013711,4,0.275027,0.295469,0
性国(1947),性国,notion,0,1,1,0,1,1,0.00981,4,0.267191,0.28214,0
怨女(1947),怨女,notion,0,1,1,0,1,1,0.017323,4,0.281723,0.306272,0
总书记(1947),总书记,notion,0,1,1,0,1,1,0.00981,4,0.267191,0.28214,0
总会(1947),总会,notion,0,1,1,0,1,1,0.017323,4,0.281723,0.306272,0
总危机(1947),总危机,notion,0,1,1,0,1,1,0.014732,4,0.276453,0.297813,0
总工会(1947),总工会,notion,0,1,1,0,1,1,0.013711,4,0.275027,0.295469,0
总帐(1947),总帐,notion,0,1,1,0,1,1,0.011229,4,0.270366,0.287632,0
总抢(1947),总抢,notion,0,1,1,0,1,1,0.013711,4,0.275027,0.295469,0
总支部(1947),总支部,notion,0,1,1,0,1,1,0.003588,4,0.255396,0.260534,0
总有一天(1947),总有一天,notion,0,1,1,0,1,1,0.014732,4,0.276453,0.297813,0
总结(1947),总结,notion,0,6,6,0,9,9,0.064104,4,0.363583,0.406474,25466.712489
总统(1947),总统,notion,0,4,4,0,4,4,0.041668,4,0.319481,0.358894,5559.596269
总罢业(1947),总罢业,notion,0,1,1,0,1,1,0.017323,4,0.281723,0.306272,0
总部(1947),总部,notion,0,1,1,0,1,1,0.017323,4,0.281723,0.306272,0
总队(1947),总队,notion,0,2,2,0,4,4,0.018651,4,0.283055,0.30842,2017.209887
恐怖(1947),恐怖,notion,0,6,6,0,12,12,0.074805,4,0.38551,0.426029,26492.047034
恐惧(1947),恐惧,notion,0,2,2,0,3,3,0.028302,4,0.298866,0.331783,1965.8222
恐慌(1947),恐慌,notion,0,2,2,0,2,2,0.026359,4,0.294788,0.325997,1561.492709
恐要(1947),恐要,notion,0,1,1,0,1,1,0.014732,4,0.276453,0.297813,0
恢复(1947),恢复,notion,0,4,4,0,6,6,0.040473,4,0.316548,0.355268,8130.378935
恨然(1947),恨然,notion,0,1,1,0,1,1,0.014732,4,0.276453,0.297813,0
恩斯特(1947),恩斯特,notion,0,1,1,0,1,1,0.00981,4,0.267191,0.28214,0
恩狄(1947),恩狄,notion,0,1,1,0,1,1,0.017323,4,0.281723,0.306272,0
恩病(1947),恩病,notion,0,1,1,0,1,1,0.017323,4,0.281723,0.306272,0
恫吓(1947),恫吓,notion,0,1,1,0,1,1,0.013711,4,0.275027,0.295469,0
恭喜发财(1947),恭喜发财,notion,0,1,1,0,1,1,0.003699,4,0.256009,0.261706,0
息演(1947),息演,notion,0,1,1,0,1,1,0.014732,4,0.276453,0.297813,0
恳挚(1947),恳挚,notion,0,1,1,0,1,1,0.003699,4,0.256009,0.261706,0
恶丐(1947),恶丐,notion,0,1,1,0,1,1,0.013711,4,0.275027,0.295469,0
恶化(1947),恶化,notion,0,1,1,0,1,1,0.014732,4,0.276453,0.297813,0
恶感(1947),恶感,notion,0,1,1,0,1,1,0.013711,4,0.275027,0.295469,0
恶草(1947),恶草,notion,0,1,1,0,1,1,0.014081,4,0.275493,0.296238,0
悲哀(1947),悲哀,notion,0,1,1,0,2,2,0.014732,4,0.276453,0.297813,0
悲悼(1947),悲悼,notion,0,1,1,0,1,1,0.011229,4,0.270366,0.287632,0
悲惨(1947),悲惨,notion,0,1,1,0,1,1,0.014081,4,0.275493,0.296238,0
悲愤(1947),悲愤,notion,0,1,1,0,1,1,0.011229,4,0.270366,0.287632,0
悲鸣(1947),悲鸣,notion,0,2,2,0,2,2,0.02494,4,0.292941,0.323324,1747.290038
悼王(1947),悼王,notion,0,1,1,0,1,1,0.011229,4,0.270366,0.287632,0
情况(1947),情况,notion,0,2,2,0,3,3,0.020912,4,0.285589,0.312338,797.979389
情势(1947),情势,notion,0,1,1,0,1,1,0.017323,4,0.281723,0.306272,0
情形(1947),情形,notion,0,3,3,0,4,4,0.014653,4,0.271139,0.289073,927.585417
情报(1947),情报,notion,0,2,2,0,2,2,0.031404,4,0.30602,0.34156,2430.025091
情报局(1947),情报局,notion,0,1,1,0,1,1,0.00981,4,0.267191,0.28214,0
情报部(1947),情报部,notion,0,1,1,0,1,1,0.017323,4,0.281723,0.306272,0
情绪(1947),情绪,notion,0,1,1,0,2,2,0.011229,4,0.270366,0.287632,0
情魔(1947),情魔,notion,0,1,1,0,1,1,0.014732,4,0.276453,0.297813,0
惊人(1947),惊人,notion,0,1,1,0,1,1,0.017323,4,0.281723,0.306272,0
惊心动魄(1947),惊心动魄,notion,0,1,1,0,1,1,0.011229,4,0.270366,0.287632,0
惠来(1947),惠来,notion,0,1,1,0,1,1,0.011229,4,0.270366,0.287632,0
惠鉴(1947),惠鉴,notion,0,1,1,0,1,1,0.014081,4,0.275493,0.296238,0
惠阳(1947),惠阳,notion,0,2,2,0,2,2,0.02494,4,0.292941,0.323324,1747.290038
惨剧(1947),惨剧,notion,0,1,1,0,1,1,0.017323,4,0.281723,0.306272,0
惨死(1947),惨死,notion,0,3,3,0,3,3,0.046135,4,0.331006,0.372455,6671.362925
惨绝人寰(1947),惨绝人寰,notion,0,1,1,0,1,1,0.011229,4,0.270366,0.287632,0
惨胜(1947),惨胜,notion,0,1,1,0,1,1,0.014732,4,0.276453,0.297813,0
惩处(1947),惩处,notion,0,1,1,0,1,1,0.017323,4,0.281723,0.306272,0
惩罚(1947),惩罚,notion,0,1,1,0,1,1,0.013711,4,0.275027,0.295469,0
惯例(1947),惯例,notion,0,1,1,0,1,1,0.002092,4,0.25318,0.25625,0
想着(1947),想着,notion,0,1,1,0,1,1,0.007422,4,0.26356,0.275695,0
愁城(1947),愁城,notion,0,1,1,0,1,1,0.014732,4,0.276453,0.297813,0
愈来愈(1947),愈来愈,notion,0,1,1,0,1,1,0.009035,4,0.265075,0.278404,0
意会(1947),意会,notion,0,1,1,0,1,1,0.007422,4,0.26356,0.275695,0
意大利(1947),意大利,notion,0,3,3,0,3,3,0.033301,4,0.307066,0.343013,4348.135821
意志(1947),意志,notion,0,1,1,0,3,3,0.014081,4,0.275493,0.296238,0
意见书(1947),意见书,notion,0,1,1,0,1,1,0.009035,4,0.265075,0.278404,0
意识(1947),意识,notion,0,1,1,0,1,1,0.009035,4,0.265075,0.278404,0
愚民(1947),愚民,notion,0,1,1,0,1,1,0.013711,4,0.275027,0.295469,0
感到(1947),感到,notion,0,1,1,0,1,1,0.014081,4,0.275493,0.296238,0
感受(1947),感受,notion,0,1,1,0,1,1,0.017323,4,0.281723,0.306272,0
感念(1947),感念,notion,0,1,1,0,1,1,0.007422,4,0.26356,0.275695,0
感怀(1947),感怀,notion,0,1,1,0,1,1,0.017323,4,0.281723,0.306272,0
感情(1947),感情,notion,0,1,1,0,1,1,0.014081,4,0.275493,0.296238,0
感想(1947),感想,notion,0,4,4,0,7,7,0.047861,4,0.333236,0.375043,11794.356549
感觉(1947),感觉,notion,0,1,1,0,2,2,0.014081,4,0.275493,0.296238,0
感触(1947),感触,notion,0,1,1,0,1,1,0.014732,4,0.276453,0.297813,0
感言(1947),感言,notion,0,4,4,0,4,4,0.052677,4,0.345793,0.388665,14309.943994
感谢(1947),感谢,notion,0,1,1,0,1,1,0.014222,4,0.275404,0.296091,0
愤怒(1947),愤怒,notion,0,4,4,0,4,4,0.043371,4,0.323693,0.363984,9524.563356
愤慨(1947),愤慨,notion,0,1,1,0,1,1,0.017323,4,0.281723,0.306272,0
愤激(1947),愤激,notion,0,1,1,0,1,1,0.014081,4,0.275493,0.296238,0
愤火(1947),愤火,notion,0,1,1,0,1,1,0.011229,4,0.270366,0.287632,0
愿望(1947),愿望,notion,0,1,1,0,1,1,0.003588,4,0.255396,0.260534,0
愿言(1947),愿言,notion,0,1,1,0,1,1,0.017323,4,0.281723,0.306272,0
慌做一团(1947),慌做一团,notion,0,1,1,0,1,1,0.011229,4,0.270366,0.287632,0
慕尼黑(1947),慕尼黑,notion,0,1,1,0,1,1,0.00981,4,0.267191,0.28214,0
慢点(1947),慢点,notion,0,1,1,0,1,1,0.014732,4,0.276453,0.297813,0
慧星(1947),慧星,notion,0,1,1,0,1,1,0.017323,4,0.281723,0.306272,0
慰劳(1947),慰劳,notion,0,1,1,0,1,1,0.013711,4,0.275027,0.295469,0
慰问(1947),慰问,notion,0,1,1,0,1,1,0.017323,4,0.281723,0.306272,0
懦怯(1947),懦怯,notion,0,1,1,0,1,1,0.013711,4,0.275027,0.295469,0
戏剧家(1947),戏剧家,notion,0,1,1,0,1,1,0.014222,4,0.275404,0.296091,0
戏法(1947),戏法,notion,0,1,1,0,1,1,0.013711,4,0.275027,0.295469,0
戏看(1947),戏看,notion,0,1,1,0,1,1,0.014222,4,0.275404,0.296091,0
成为(1947),成为,notion,0,1,1,0,1,1,0.014732,4,0.276453,0.297813,0
成为泡影(1947),成为泡影,notion,0,1,1,0,1,1,0.00981,4,0.267191,0.28214,0
成功(1947),成功,notion,0,3,3,0,3,3,0.045114,4,0.331456,0.372968,7474.911045
成就(1947),成就,notion,0,2,2,0,2,2,0.018845,4,0.280243,0.303989,1083.402703
成教(1947),成教,notion,0,1,1,0,1,1,0.017323,4,0.281723,0.306272,0
成本(1947),成本,notion,0,1,1,0,1,1,0.014222,4,0.275404,0.296091,0
成案(1947),成案,notion,0,1,1,0,1,1,0.014081,4,0.275493,0.296238,0
成长(1947),成长,notion,0,3,3,0,4,4,0.025613,4,0.293622,0.324374,3860.761273
我心(1947),我心,notion,0,1,1,0,1,1,0.017323,4,0.281723,0.306272,0
我的(1947),我的,notion,0,1,1,0,1,1,0.014222,4,0.275404,0.296091,0
我者(1947),我者,notion,0,1,1,0,1,1,0.017323,4,0.281723,0.306272,0
我见(1947),我见,notion,0,2,2,0,3,3,0.023257,4,0.28761,0.315414,1169.271875
戒严(1947),戒严,notion,0,1,1,0,1,1,0.014732,4,0.276453,0.297813,0
戒严令(1947),戒严令,notion,0,1,1,0,1,1,0.014081,4,0.275493,0.296238,0
战争罪犯(1947),战争罪犯,notion,0,1,1,0,1,1,0.013711,4,0.275027,0.295469,0
战争贩子(1947),战争贩子,notion,0,2,2,0,3,3,0.027133,4,0.29671,0.328744,1770.9936
战事(1947),战事,notion,0,2,2,0,3,3,0.031034,4,0.30613,0.341707,2639.595687
战况(1947),战况,notion,0,1,1,0,2,2,0.011229,4,0.270366,0.287632,0
战区(1947),战区,notion,0,1,1,0,1,1,0.014732,4,0.276453,0.297813,0
战地(1947),战地,notion,0,1,1,0,1,1,0.003699,4,0.256009,0.261706,0
战士(1947),战士,notion,0,1,1,0,1,1,0.014732,4,0.276453,0.297813,0
战役(1947),战役,notion,0,2,2,0,2,2,0.01741,4,0.280151,0.303843,1198.480437
战报(1947),战报,notion,0,1,1,0,1,1,0.013711,4,0.275027,0.295469,0
战时(1947),战时,notion,0,4,4,0,7,7,0.042738,4,0.317107,0.355964,6461.667401
战法(1947),战法,notion,0,1,1,0,1,1,0.003588,4,0.255396,0.260534,0
战火(1947),战火,notion,0,1,1,0,1,1,0.017323,4,0.281723,0.306272,0
战略(1947),战略,notion,0,3,3,0,3,3,0.035133,4,0.309264,0.345906,3836.42653
战神(1947),战神,notion,0,1,1,0,1,1,0.00981,4,0.267191,0.28214,0
战胜(1947),战胜,notion,0,1,1,0,1,1,0.011229,4,0.270366,0.287632,0
战都(1947),战都,notion,0,1,1,0,1,1,0.007422,4,0.26356,0.275695,0
战马(1947),战马,notion,0,1,1,0,1,1,0.009035,4,0.265075,0.278404,0
战鬥(1947),战鬥,notion,0,2,2,0,2,2,0.027791,4,0.29968,0.332918,2405.290268
战鼓(1947),战鼓,notion,0,1,1,0,1,1,0.014732,4,0.276453,0.297813,0
戡乱(1947),戡乱,notion,0,2,2,0,4,4,0.028302,4,0.298866,0.331783,1965.8222
戳破(1947),戳破,notion,0,1,1,0,1,1,0.003699,4,0.256009,0.261706,0
戳穿(1947),戳穿,notion,0,1,1,0,1,1,0.013711,4,0.275027,0.295469,0
戴云山(1947),戴云山,notion,0,1,1,0,1,1,0.011229,4,0.270366,0.287632,0
戴高乐(1947),戴高乐,notion,0,2,2,0,2,2,0.023257,4,0.28761,0.315414,1169.271875
户政(1947),户政,notion,0,1,1,0,1,1,0.014222,4,0.275404,0.296091,0
房屋(1947),房屋,notion,0,1,1,0,1,1,0.014081,4,0.275493,0.296238,0
房荒(1947),房荒,notion,0,1,1,0,1,1,0.014222,4,0.275404,0.296091,0
所云(1947),所云,notion,0,1,1,0,1,1,0.014222,4,0.275404,0.296091,0
所到之处(1947),所到之处,notion,0,1,1,0,1,1,0.00981,4,0.267191,0.28214,0
所处(1947),所处,notion,0,1,1,0,1,1,0.009035,4,0.265075,0.278404,0
所得(1947),所得,notion,0,1,1,0,1,1,0.013711,4,0.275027,0.295469,0
所担(1947),所担,notion,0,1,1,0,1,1,0.013711,4,0.275027,0.295469,0
所欲(1947),所欲,notion,0,1,1,0,1,1,0.009035,4,0.265075,0.278404,0
所见(1947),所见,notion,0,2,2,0,2,2,0.031034,4,0.30613,0.341707,2639.595687
所谓(1947),所谓,notion,0,9,9,0,15,15,0.100201,4,0.433984,0.462429,53564.603862
所负(1947),所负,notion,0,1,1,0,1,1,0.003699,4,0.256009,0.261706,0
所需(1947),所需,notion,0,1,1,0,1,1,0.014222,4,0.275404,0.296091,0
手上(1947),手上,notion,0,1,1,0,1,1,0.017323,4,0.281723,0.306272,0
手向(1947),手向,notion,0,1,1,0,1,1,0.014732,4,0.276453,0.297813,0
手工业(1947),手工业,notion,0,1,1,0,2,2,0.007422,4,0.26356,0.275695,0
手段(1947),手段,notion,0,1,1,0,1,1,0.009035,4,0.265075,0.278404,0
手稿(1947),手稿,notion,0,1,1,0,1,1,0.013711,4,0.275027,0.295469,0
手续(1947),手续,notion,0,1,1,0,1,1,0.007422,4,0.26356,0.275695,0
手谕(1947),手谕,notion,0,1,1,0,1,1,0.009035,4,0.265075,0.278404,0
手迹(1947),手迹,notion,0,1,1,0,1,1,0.014732,4,0.276453,0.297813,0
才能(1947),才能,notion,0,1,1,0,2,2,0.011229,4,0.270366,0.287632,0
打不死(1947),打不死,notion,0,1,1,0,1,1,0.013711,4,0.275027,0.295469,0
打仔(1947),打仔,notion,0,1,1,0,1,1,0.003699,4,0.256009,0.261706,0
打倒(1947),打倒,notion,0,3,3,0,3,3,0.038252,4,0.315992,0.354511,5925.791163
打击(1947),打击,notion,0,2,2,0,2,2,0.023257,4,0.28761,0.315414,1169.271875
打劫(1947),打劫,notion,0,1,1,0,1,1,0.011229,4,0.270366,0.287632,0
打天下(1947),打天下,notion,0,1,1,0,1,1,0.011229,4,0.270366,0.287632,0
打开(1947),打开,notion,0,1,1,0,1,1,0.011229,4,0.270366,0.287632,0
打得(1947),打得,notion,0,1,1,0,1,1,0.003699,4,0.256009,0.261706,0
打手(1947),打手,notion,0,1,1,0,1,1,0.014732,4,0.276453,0.297813,0
打折(1947),打折,notion,0,1,1,0,1,1,0.011229,4,0.270366,0.287632,0
打算(1947),打算,notion,0,4,4,0,4,4,0.055312,4,0.343947,0.386724,10683.402766
打算盘(1947),打算盘,notion,0,1,1,0,1,1,0.017323,4,0.281723,0.306272,0
打胜仗(1947),打胜仗,notion,0,1,1,0,1,1,0.011229,4,0.270366,0.287632,0
托于(1947),托于,notion,0,1,1,0,7,7,0.007422,4,0.26356,0.275695,0
托尔斯泰(1947),托尔斯泰,notion,0,1,1,0,1,1,0.014732,4,0.276453,0.297813,0
托管(1947),托管,notion,0,1,1,0,1,1,0.00981,4,0.267191,0.28214,0
执会(1947),执会,notion,0,1,1,0,1,1,0.009035,4,0.265075,0.278404,0
执友(1947),执友,notion,0,1,1,0,1,1,0.011229,4,0.270366,0.287632,0
执委会(1947),执委会,notion,0,1,1,0,2,2,0.013711,4,0.275027,0.295469,0
执政(1947),执政,notion,0,1,1,0,1,1,0.002092,4,0.25318,0.25625,0
执教(1947),执教,notion,0,1,1,0,2,2,0.014222,4,0.275404,0.296091,0
执法(1947),执法,notion,0,1,1,0,1,1,0.014732,4,0.276453,0.297813,0
执行(1947),执行,notion,0,2,2,0,2,2,0.017232,4,0.279944,0.303513,1791.004954
扩军(1947),扩军,notion,0,1,1,0,1,1,0.011229,4,0.270366,0.287632,0
扩大(1947),扩大,notion,0,3,3,0,3,3,0.037848,4,0.312921,0.35063,4836.024023
扩张(1947),扩张,notion,0,2,2,0,9,9,0.027133,4,0.29671,0.328744,1770.9936
扩张政策(1947),扩张政策,notion,0,2,2,0,2,2,0.024542,4,0.292264,0.322335,1826.657886
扫征(1947),扫征,notion,0,1,1,0,1,1,0.011229,4,0.270366,0.287632,0
扫除(1947),扫除,notion,0,1,1,0,1,1,0.00981,4,0.267191,0.28214,0
扫雷(1947),扫雷,notion,0,1,1,0,1,1,0.00981,4,0.267191,0.28214,0
扭扭(1947),扭扭,notion,0,1,1,0,1,1,0.014081,4,0.275493,0.296238,0
扯淡(1947),扯淡,notion,0,1,1,0,1,1,0.014732,4,0.276453,0.297813,0
扰攘(1947),扰攘,notion,0,1,1,0,1,1,0.014222,4,0.275404,0.296091,0
批战(1947),批战,notion,0,1,1,0,1,1,0.003699,4,0.256009,0.261706,0
扼杀(1947),扼杀,notion,0,1,1,0,1,1,0.014732,4,0.276453,0.297813,0
技术(1947),技术,notion,0,3,3,0,10,10,0.035724,4,0.311778,0.349165,5959.110786
技术人员(1947),技术人员,notion,0,1,1,0,1,1,0.014081,4,0.275493,0.296238,0
抄书(1947),抄书,notion,0,1,1,0,1,1,0.014222,4,0.275404,0.296091,0
抉择(1947),抉择,notion,0,3,3,0,4,4,0.036375,4,0.313266,0.351069,6346.582492
把戏(1947),把戏,notion,0,2,2,0,2,2,0.031034,4,0.30613,0.341707,2639.595687
抓丁(1947),抓丁,notion,0,1,1,0,1,1,0.011229,4,0.270366,0.287632,0
抓紧(1947),抓紧,notion,0,1,1,0,1,1,0.011229,4,0.270366,0.287632,0
投效(1947),投效,notion,0,1,1,0,1,1,0.004749,4,0.257108,0.263793,0
投敌(1947),投敌,notion,0,1,1,0,1,1,0.013711,4,0.275027,0.295469,0
投票(1947),投票,notion,0,1,1,0,1,1,0.014222,4,0.275404,0.296091,0
投诗(1947),投诗,notion,0,1,1,0,1,1,0.017323,4,0.281723,0.306272,0
投资(1947),投资,notion,0,1,1,0,1,1,0.014732,4,0.276453,0.297813,0
投递(1947),投递,notion,0,1,1,0,1,1,0.004749,4,0.257108,0.263793,0
投降(1947),投降,notion,0,2,2,0,2,2,0.027133,4,0.29671,0.328744,1770.9936
抗争(1947),抗争,notion,0,1,1,0,1,1,0.013711,4,0.275027,0.295469,0
抗卫(1947),抗卫,notion,0,1,1,0,1,1,0.007422,4,0.26356,0.275695,0
抗征(1947),抗征,notion,0,1,1,0,1,1,0.011229,4,0.270366,0.287632,0
抗敌(1947),抗敌,notion,0,1,1,0,1,1,0.007422,4,0.26356,0.275695,0
抗暴(1947),抗暴,notion,0,5,5,0,7,7,0.050711,4,0.336388,0.378619,13766.517037
抗过(1947),抗过,notion,0,1,1,0,1,1,0.014222,4,0.275404,0.296091,0
折扣(1947),折扣,notion,0,1,1,0,1,1,0.007422,4,0.26356,0.275695,0
折腰(1947),折腰,notion,0,1,1,0,1,1,0.014732,4,0.276453,0.297813,0
抛砖引玉(1947),抛砖引玉,notion,0,1,1,0,1,1,0.014732,4,0.276453,0.297813,0
抢掠(1947),抢掠,notion,0,1,1,0,1,1,0.013711,4,0.275027,0.295469,0
抢救(1947),抢救,notion,0,1,1,0,1,1,0.004749,4,0.257108,0.263793,0
抢米(1947),抢米,notion,0,2,2,0,2,2,0.028442,4,0.300022,0.333394,2187.730369
抢粮(1947),抢粮,notion,0,1,1,0,1,1,0.011229,4,0.270366,0.287632,0
护乡团(1947),护乡团,notion,0,1,1,0,1,1,0.011229,4,0.270366,0.287632,0
护权(1947),护权,notion,0,1,1,0,1,1,0.014081,4,0.275493,0.296238,0
报业(1947),报业,notion,0,2,2,0,2,2,0.032055,4,0.30624,0.341853,2215.722594
报信(1947),报信,notion,0,1,1,0,1,1,0.013711,4,0.275027,0.295469,0
报刊(1947),报刊,notion,0,1,1,0,1,1,0.014732,4,0.276453,0.297813,0
报告书(1947),报告书,notion,0,2,2,0,3,3,0.031404,4,0.30602,0.34156,2430.025091
报告文学(1947),报告文学,notion,0,1,1,0,1,1,0.003699,4,0.256009,0.261706,0
报界(1947),报界,notion,0,1,1,0,1,1,0.014081,4,0.275493,0.296238,0
报社(1947),报社,notion,0,3,3,0,3,3,0.020931,4,0.285231,0.31185,3907.097001
报评(1947),报评,notion,0,1,1,0,1,1,0.017323,4,0.281723,0.306272,0
报馆(1947),报馆,notion,0,2,2,0,2,2,0.028812,4,0.299917,0.333248,2025.61524
抬头(1947),抬头,notion,0,2,2,0,2,2,0.005791,4,0.258785,0.267004,433.712148
抱负(1947),抱负,notion,0,2,2,0,2,2,0.01217,4,0.269981,0.287034,858.702851
抵制(1947),抵制,notion,0,1,1,0,1,1,0.013711,4,0.275027,0.295469,0
抵哈(1947),抵哈,notion,0,1,1,0,1,1,0.013711,4,0.275027,0.295469,0
抵平(1947),抵平,notion,0,1,1,0,1,1,0.014081,4,0.275493,0.296238,0
抽税(1947),抽税,notion,0,1,1,0,1,1,0.014222,4,0.275404,0.296091,0
担当(1947),担当,notion,0,1,1,0,8,8,0.007422,4,0.26356,0.275695,0
担负(1947),担负,notion,0,1,1,0,1,1,0.011229,4,0.270366,0.287632,0
拆洋(1947),拆洋,notion,0,1,1,0,1,1,0.003699,4,0.256009,0.261706,0
拆穿(1947),拆穿,notion,0,2,2,0,2,2,0.031034,4,0.30613,0.341707,2639.595687
拉丁(1947),拉丁,notion,0,2,2,0,2,2,0.028442,4,0.300022,0.333394,2187.730369
拉丁美洲(1947),拉丁美洲,notion,0,1,1,0,1,1,0.00981,4,0.267191,0.28214,0
拉兹(1947),拉兹,notion,0,1,1,0,1,1,0.00981,4,0.267191,0.28214,0
拉屎(1947),拉屎,notion,0,1,1,0,1,1,0.014732,4,0.276453,0.297813,0
拉斯基(1947),拉斯基,notion,0,1,1,0,1,1,0.017323,4,0.281723,0.306272,0
拒查(1947),拒查,notion,0,1,1,0,1,1,0.011229,4,0.270366,0.287632,0
招待(1947),招待,notion,0,1,1,0,1,1,0.017323,4,0.281723,0.306272,0
招待会(1947),招待会,notion,0,2,2,0,2,2,0.023891,4,0.292014,0.321969,2116.906395
拜读(1947),拜读,notion,0,1,1,0,1,1,0.003588,4,0.255396,0.260534,0
拟出(1947),拟出,notion,0,1,1,0,1,1,0.014732,4,0.276453,0.297813,0
拟议(1947),拟议,notion,0,1,1,0,1,1,0.014222,4,0.275404,0.296091,0
拥护(1947),拥护,notion,0,1,1,0,1,1,0.017323,4,0.281723,0.306272,0
拥护者(1947),拥护者,notion,0,1,1,0,1,1,0.00981,4,0.267191,0.28214,0
拦不住(1947),拦不住,notion,0,1,1,0,1,1,0.014081,4,0.275493,0.296238,0
拦路(1947),拦路,notion,0,1,1,0,1,1,0.014081,4,0.275493,0.296238,0
拨矩(1947),拨矩,notion,0,1,1,0,1,1,0.011229,4,0.270366,0.287632,0
择肥而噬(1947),择肥而噬,notion,0,1,1,0,1,1,0.014081,4,0.275493,0.296238,0
拯救(1947),拯救,notion,0,1,1,0,1,1,0.017323,4,0.281723,0.306272,0
拾零(1947),拾零,notion,0,1,1,0,1,1,0.009035,4,0.265075,0.278404,0
拿来(1947),拿来,notion,0,1,1,0,1,1,0.014732,4,0.276453,0.297813,0
持续(1947),持续,notion,0,1,1,0,1,1,0.007422,4,0.26356,0.275695,0
指定(1947),指定,notion,0,1,1,0,1,1,0.014222,4,0.275404,0.296091,0
指挥家(1947),指挥家,notion,0,1,1,0,1,1,0.013711,4,0.275027,0.295469,0
指挥部(1947),指挥部,notion,0,1,1,0,1,1,0.011229,4,0.270366,0.287632,0
指摘(1947),指摘,notion,0,1,1,0,1,1,0.017323,4,0.281723,0.306272,0
指数(1947),指数,notion,0,2,2,0,2,2,0.031034,4,0.30613,0.341707,2639.595687
指斥(1947),指斥,notion,0,1,1,0,1,1,0.017323,4,0.281723,0.306272,0
指标(1947),指标,notion,0,2,2,0,2,2,0.024542,4,0.292264,0.322335,1826.657886
挑战(1947),挑战,notion,0,1,1,0,1,1,0.013711,4,0.275027,0.295469,0
挑拨(1947),挑拨,notion,0,1,1,0,1,1,0.011229,4,0.270366,0.287632,0
挖乾净(1947),挖乾净,notion,0,1,1,0,1,1,0.013711,4,0.275027,0.295469,0
挖起(1947),挖起,notion,0,1,1,0,1,1,0.013711,4,0.275027,0.295469,0
挟制(1947),挟制,notion,0,1,1,0,1,1,0.014222,4,0.275404,0.296091,0
挡不住(1947),挡不住,notion,0,1,1,0,1,1,0.014081,4,0.275493,0.296238,0
挡得住(1947),挡得住,notion,0,1,1,0,1,1,0.014732,4,0.276453,0.297813,0
挣扎(1947),挣扎,notion,0,2,2,0,4,4,0.01741,4,0.280151,0.303843,1198.480437
挤下(1947),挤下,notion,0,1,1,0,1,1,0.017323,4,0.281723,0.306272,0
振衰起(1947),振衰起,notion,0,1,1,0,1,1,0.009035,4,0.265075,0.278404,0
挺进(1947),挺进,notion,0,2,2,0,2,2,0.017232,4,0.279944,0.303513,1791.004954
挽救(1947),挽救,notion,0,6,6,0,9,9,0.066828,4,0.366118,0.408855,21409.248941
挽救不了(1947),挽救不了,notion,0,1,1,0,1,1,0.011229,4,0.270366,0.287632,0
捉襟见肘(1947),捉襟见肘,notion,0,1,1,0,1,1,0.017323,4,0.281723,0.306272,0
捉马图(1947),捉马图,notion,0,1,1,0,1,1,0.004749,4,0.257108,0.263793,0
捐款(1947),捐款,notion,0,1,1,0,1,1,0.014081,4,0.275493,0.296238,0
捐苛(1947),捐苛,notion,0,1,1,0,1,1,0.013711,4,0.275027,0.295469,0
捕人(1947),捕人,notion,0,2,2,0,2,2,0.026359,4,0.294788,0.325997,1561.492709
换汤不换药(1947),换汤不换药,notion,0,1,1,0,1,1,0.013711,4,0.275027,0.295469,0
捣毁(1947),捣毁,notion,0,1,1,0,1,1,0.013711,4,0.275027,0.295469,0
据点(1947),据点,notion,0,1,1,0,1,1,0.011229,4,0.270366,0.287632,0
捷克(1947),捷克,notion,0,4,4,0,7,7,0.052333,4,0.34212,0.384783,12473.603065
掀起(1947),掀起,notion,0,2,2,0,3,3,0.02494,4,0.292941,0.323324,1747.290038
排中律(1947),排中律,notion,0,1,1,0,1,1,0.014222,4,0.275404,0.296091,0
排华(1947),排华,notion,0,1,1,0,1,1,0.013711,4,0.275027,0.295469,0
掘墓(1947),掘墓,notion,0,1,1,0,1,1,0.011229,4,0.270366,0.287632,0
探囊取(1947),探囊取,notion,0,1,1,0,1,1,0.014732,4,0.276453,0.297813,0
探源(1947),探源,notion,0,1,1,0,1,1,0.014222,4,0.275404,0.296091,0
接受(1947),接受,notion,0,1,1,0,1,1,0.007422,4,0.26356,0.275695,0
接收(1947),接收,notion,0,2,2,0,2,2,0.028302,4,0.298866,0.331783,1965.8222
接替(1947),接替,notion,0,1,1,0,1,1,0.014732,4,0.276453,0.297813,0
接着(1947),接着,notion,0,1,1,0,1,1,0.013711,4,0.275027,0.295469,0
接运(1947),接运,notion,0,1,1,0,1,1,0.007422,4,0.26356,0.275695,0
接近(1947),接近,notion,0,1,1,0,1,1,0.013711,4,0.275027,0.295469,0
接连(1947),接连,notion,0,1,1,0,1,1,0.013711,4,0.275027,0.295469,0
控制(1947),控制,notion,0,3,3,0,3,3,0.028241,4,0.297123,0.329391,3873.433673
控诉(1947),控诉,notion,0,4,4,0,7,7,0.052319,4,0.340924,0.383502,11661.721093
推动(1947),推动,notion,0,2,2,0,2,2,0.017232,4,0.279944,0.303513,1791.004954
推开(1947),推开,notion,0,1,1,0,1,1,0.002092,4,0.25318,0.25625,0
推残(1947),推残,notion,0,1,1,0,1,1,0.017323,4,0.281723,0.306272,0
推测(1947),推测,notion,0,1,1,0,1,1,0.017323,4,0.281723,0.306272,0
推近(1947),推近,notion,0,1,1,0,1,1,0.011229,4,0.270366,0.287632,0
推销(1947),推销,notion,0,1,1,0,1,1,0.013711,4,0.275027,0.295469,0
掩口葫芦(1947),掩口葫芦,notion,0,1,1,0,1,1,0.014081,4,0.275493,0.296238,0
措施(1947),措施,notion,0,1,1,0,4,4,0.014222,4,0.275404,0.296091,0
提倡(1947),提倡,notion,0,1,1,0,1,1,0.011229,4,0.270366,0.287632,0
提到(1947),提到,notion,0,1,1,0,1,1,0.014081,4,0.275493,0.296238,0
提升(1947),提升,notion,0,1,1,0,1,1,0.014081,4,0.275493,0.296238,0
提拔(1947),提拔,notion,0,1,1,0,1,1,0.007422,4,0.26356,0.275695,0
提琴手(1947),提琴手,notion,0,1,1,0,1,1,0.014081,4,0.275493,0.296238,0
提议(1947),提议,notion,0,2,2,0,2,2,0.01897,4,0.280427,0.304282,657.210893
提高(1947),提高,notion,0,1,1,0,1,1,0.011229,4,0.270366,0.287632,0
插图(1947),插图,notion,0,1,1,0,1,1,0.00981,4,0.267191,0.28214,0
插曲(1947),插曲,notion,0,2,2,0,2,2,0.027133,4,0.29671,0.328744,1770.9936
揣克(1947),揣克,notion,0,1,1,0,1,1,0.014222,4,0.275404,0.296091,0
揭去(1947),揭去,notion,0,1,1,0,1,1,0.013711,4,0.275027,0.295469,0
揭发(1947),揭发,notion,0,2,2,0,2,2,0.028552,4,0.301506,0.335445,2588.539662
揭幕(1947),揭幕,notion,0,2,2,0,2,2,0.028302,4,0.298866,0.331783,1965.8222
揭开(1947),揭开,notion,0,1,1,0,1,1,0.014081,4,0.275493,0.296238,0
揭晓(1947),揭晓,notion,0,1,1,0,1,1,0.017323,4,0.281723,0.306272,0
揭起(1947),揭起,notion,0,1,1,0,1,1,0.00981,4,0.267191,0.28214,0
揭阳(1947),揭阳,notion,0,1,1,0,1,1,0.011229,4,0.270366,0.287632,0
揭露(1947),揭露,notion,0,1,1,0,1,1,0.013711,4,0.275027,0.295469,0
援华援(1947),援华援,notion,0,1,1,0,1,1,0.014222,4,0.275404,0.296091,0
援希(1947),援希,notion,0,1,1,0,1,1,0.017323,4,0.281723,0.306272,0
援蒋(1947),援蒋,notion,0,2,2,0,2,2,0.02494,4,0.292941,0.323324,1747.290038
搜查(1947),搜查,notion,0,1,1,0,1,1,0.009035,4,0.265075,0.278404,0
搬演(1947),搬演,notion,0,1,1,0,1,1,0.003699,4,0.256009,0.261706,0
携手(1947),携手,notion,0,1,1,0,1,1,0.017323,4,0.281723,0.306272,0
摄影(1947),摄影,notion,0,1,1,0,1,1,0.014222,4,0.275404,0.296091,0
摇摇欲坠(1947),摇摇欲坠,notion,0,1,1,0,1,1,0.013711,4,0.275027,0.295469,0
摇篮(1947),摇篮,notion,0,2,2,0,2,2,0.021644,4,0.28732,0.314975,1747.667055
摊派(1947),摊派,notion,0,1,1,0,1,1,0.014081,4,0.275493,0.296238,0
摧毁(1947),摧毁,notion,0,1,1,0,1,1,0.014222,4,0.275404,0.296091,0
摩尔(1947),摩尔,notion,0,1,1,0,1,1,0.00981,4,0.267191,0.28214,0
撒下(1947),撒下,notion,0,1,1,0,1,1,0.013711,4,0.275027,0.295469,0
撒娇(1947),撒娇,notion,0,1,1,0,1,1,0.013711,4,0.275027,0.295469,0
撤军(1947),撤军,notion,0,2,2,0,2,2,0.031545,4,0.305336,0.340645,2219.908318
撤出(1947),撤出,notion,0,1,1,0,1,1,0.014732,4,0.276453,0.297813,0
撤守(1947),撤守,notion,0,1,1,0,1,1,0.017323,4,0.281723,0.306272,0
撤掉(1947),撤掉,notion,0,1,1,0,1,1,0.011229,4,0.270366,0.287632,0
撤消(1947),撤消,notion,0,1,1,0,1,1,0.009035,4,0.265075,0.278404,0
撤离(1947),撤离,notion,0,1,1,0,1,1,0.017323,4,0.281723,0.306272,0
撤退(1947),撤退,notion,0,1,1,0,1,1,0.014081,4,0.275493,0.296238,0
撤销(1947),撤销,notion,0,1,1,0,1,1,0.017323,4,0.281723,0.306272,0
撲灭(1947),撲灭,notion,0,1,1,0,1,1,0.003588,4,0.255396,0.260534,0
支援(1947),支援,notion,0,2,2,0,2,2,0.031034,4,0.30613,0.341707,2639.595687
支票(1947),支票,notion,0,1,1,0,1,1,0.017323,4,0.281723,0.306272,0
支配(1947),支配,notion,0,2,2,0,2,2,0.024745,4,0.295069,0.3264,2684.608967
收买(1947),收买,notion,0,1,1,0,1,1,0.017323,4,0.281723,0.306272,0
收入(1947),收入,notion,0,1,1,0,1,1,0.00981,4,0.267191,0.28214,0
收后(1947),收后,notion,0,1,1,0,1,1,0.003699,4,0.256009,0.261706,0
收回(1947),收回,notion,0,1,1,0,1,1,0.014222,4,0.275404,0.296091,0
收复(1947),收复,notion,0,2,2,0,2,2,0.020265,4,0.284375,0.310471,1611.931322
收复区(1947),收复区,notion,0,1,1,0,1,1,0.009035,4,0.265075,0.278404,0
收拾(1947),收拾,notion,0,1,1,0,1,1,0.014732,4,0.276453,0.297813,0
收油(1947),收油,notion,0,1,1,0,1,1,0.007422,4,0.26356,0.275695,0
收获(1947),收获,notion,0,2,2,0,2,2,0.017299,4,0.278915,0.301865,688.562525
收购(1947),收购,notion,0,2,2,0,2,2,0.024745,4,0.295069,0.3264,2684.608967
收费(1947),收费,notion,0,1,1,0,1,1,0.017323,4,0.281723,0.306272,0
改出(1947),改出,notion,0,1,1,0,1,1,0.014081,4,0.275493,0.296238,0
改制(1947),改制,notion,0,1,1,0,1,1,0.009035,4,0.265075,0.278404,0
改变(1947),改变,notion,0,3,3,0,3,3,0.032361,4,0.30646,0.342207,6339.208536
改善(1947),改善,notion,0,2,2,0,2,2,0.028302,4,0.298866,0.331783,1965.8222
改善生活(1947),改善生活,notion,0,1,1,0,1,1,0.017323,4,0.281723,0.306272,0
改用(1947),改用,notion,0,1,1,0,1,1,0.014222,4,0.275404,0.296091,0
改省(1947),改省,notion,0,1,1,0,1,1,0.014222,4,0.275404,0.296091,0
改良主义(1947),改良主义,notion,0,1,1,0,1,1,0.004749,4,0.257108,0.263793,0
改订(1947),改订,notion,0,1,1,0,1,1,0.014081,4,0.275493,0.296238,0
改进(1947),改进,notion,0,3,3,0,10,10,0.035724,4,0.311778,0.349165,5959.110786
改选(1947),改选,notion,0,1,1,0,1,1,0.017323,4,0.281723,0.306272,0
改革方案(1947),改革方案,notion,0,3,3,0,3,3,0.028006,4,0.292339,0.322506,2276.459601
攻入(1947),攻入,notion,0,2,2,0,2,2,0.020265,4,0.284375,0.310471,1611.931322
攻击(1947),攻击,notion,0,3,3,0,3,3,0.040439,4,0.318885,0.3581,5349.74038
攻占(1947),攻占,notion,0,1,1,0,1,1,0.014081,4,0.275493,0.296238,0
攻守(1947),攻守,notion,0,2,2,0,2,2,0.017299,4,0.278915,0.301865,688.562525
放任(1947),放任,notion,0,1,1,0,1,1,0.014222,4,0.275404,0.296091,0
放弃(1947),放弃,notion,0,2,2,0,3,3,0.023257,4,0.28761,0.315414,1169.271875
放远(1947),放远,notion,0,1,1,0,1,1,0.011229,4,0.270366,0.287632,0
放逐(1947),放逐,notion,0,2,2,0,2,2,0.031404,4,0.30602,0.34156,2430.025091
政争(1947),政争,notion,0,1,1,0,1,1,0.017323,4,0.281723,0.306272,0
政党政治(1947),政党政治,notion,0,1,1,0,1,1,0.009035,4,0.265075,0.278404,0
政军(1947),政军,notion,0,2,2,0,2,2,0.031404,4,0.30602,0.34156,2430.025091
政变(1947),政变,notion,0,6,6,0,7,7,0.074805,4,0.38551,0.426029,26492.047034
政客(1947),政客,notion,0,1,1,0,1,1,0.014732,4,0.276453,0.297813,0
政情(1947),政情,notion,0,1,1,0,1,1,0.017323,4,0.281723,0.306272,0
政本(1947),政本,notion,0,1,1,0,1,1,0.009035,4,0.265075,0.278404,0
政权(1947),政权,notion,0,1,1,0,1,1,0.00981,4,0.267191,0.28214,0
政权机关(1947),政权机关,notion,0,1,1,0,1,1,0.00981,4,0.267191,0.28214,0
政治危机(1947),政治危机,notion,0,2,2,0,2,2,0.031545,4,0.305336,0.340645,2219.908318
政治家(1947),政治家,notion,0,1,1,0,1,1,0.003588,4,0.255396,0.260534,0
政治犯(1947),政治犯,notion,0,1,1,0,1,1,0.017323,4,0.281723,0.306272,0
政治路线(1947),政治路线,notion,0,2,2,0,2,2,0.023767,4,0.289685,0.318527,1452.186204
政治阴谋(1947),政治阴谋,notion,0,1,1,0,1,1,0.013711,4,0.275027,0.295469,0
政界(1947),政界,notion,0,2,2,0,2,2,0.024542,4,0.292264,0.322335,1826.657886
政略(1947),政略,notion,0,1,1,0,1,1,0.014732,4,0.276453,0.297813,0
政纲(1947),政纲,notion,0,1,1,0,1,1,0.009035,4,0.265075,0.278404,0
政论(1947),政论,notion,0,1,1,0,1,1,0.014732,4,0.276453,0.297813,0
政院(1947),政院,notion,0,1,1,0,1,1,0.017323,4,0.281723,0.306272,0
故乡(1947),故乡,notion,0,2,2,0,2,2,0.02494,4,0.292941,0.323324,1747.290038
故国(1947),故国,notion,0,1,1,0,1,1,0.014222,4,0.275404,0.296091,0
故都(1947),故都,notion,0,2,2,0,3,3,0.027932,4,0.299811,0.333101,2443.455357
效弃(1947),效弃,notion,0,1,1,0,1,1,0.009035,4,0.265075,0.278404,0
效果(1947),效果,notion,0,1,1,0,1,1,0.014222,4,0.275404,0.296091,0
效率(1947),效率,notion,0,1,1,0,1,1,0.007422,4,0.26356,0.275695,0
敌人(1947),敌人,notion,0,1,1,0,1,1,0.00981,4,0.267191,0.28214,0
敌友(1947),敌友,notion,0,1,1,0,1,1,0.011229,4,0.270366,0.287632,0
救人一命(1947),救人一命,notion,0,1,1,0,1,1,0.014222,4,0.275404,0.296091,0
救得(1947),救得,notion,0,1,1,0,2,2,0.013711,4,0.275027,0.295469,0
救急(1947),救急,notion,0,1,1,0,1,1,0.014081,4,0.275493,0.296238,0
救救(1947),救救,notion,0,1,1,0,1,1,0.014732,4,0.276453,0.297813,0
救星(1947),救星,notion,0,2,2,0,2,2,0.028442,4,0.300022,0.333394,2187.730369
救死与(1947),救死与,notion,0,1,1,0,1,1,0.014222,4,0.275404,0.296091,0
救死扶伤(1947),救死扶伤,notion,0,1,1,0,1,1,0.011229,4,0.270366,0.287632,0
救治(1947),救治,notion,0,1,1,0,1,1,0.014222,4,0.275404,0.296091,0
救济(1947),救济,notion,0,3,3,0,6,6,0.046277,4,0.33091,0.372345,6500.451978
救济粮(1947),救济粮,notion,0,1,1,0,1,1,0.014222,4,0.275404,0.296091,0
救火(1947),救火,notion,0,1,1,0,1,1,0.007422,4,0.26356,0.275695,0
救灾(1947),救灾,notion,0,1,1,0,3,3,0.011229,4,0.270366,0.287632,0
教人(1947),教人,notion,0,1,1,0,1,1,0.017323,4,0.281723,0.306272,0
教养(1947),教养,notion,0,1,1,0,1,1,0.007422,4,0.26356,0.275695,0
教员(1947),教员,notion,0,1,1,0,1,1,0.014732,4,0.276453,0.297813,0
教学(1947),教学,notion,0,1,1,0,1,1,0.017323,4,0.281723,0.306272,0
教民(1947),教民,notion,0,1,1,0,1,1,0.014732,4,0.276453,0.297813,0
教育家(1947),教育家,notion,0,2,2,0,2,2,0.013398,4,0.271635,0.289854,656.368623
教育界(1947),教育界,notion,0,1,1,0,1,1,0.014222,4,0.275404,0.296091,0
教育社(1947),教育社,notion,0,1,1,0,1,1,0.017323,4,0.281723,0.306272,0
教训(1947),教训,notion,0,5,5,0,5,5,0.050155,4,0.33772,0.380084,14976.801887
教费(1947),教费,notion,0,1,1,0,1,1,0.014732,4,0.276453,0.297813,0
教部(1947),教部,notion,0,1,1,0,2,2,0.014732,4,0.276453,0.297813,0
散文(1947),散文,notion,0,2,2,0,2,2,0.028954,4,0.300154,0.333577,2064.821066
散沙(1947),散沙,notion,0,1,1,0,1,1,0.014081,4,0.275493,0.296238,0
敬告(1947),敬告,notion,0,3,3,0,3,3,0.030395,4,0.30116,0.33503,3792.675967
敬答(1947),敬答,notion,0,1,1,0,1,1,0.014081,4,0.275493,0.296238,0
敬请(1947),敬请,notion,0,1,1,0,1,1,0.003699,4,0.256009,0.261706,0
数不完(1947),数不完,notion,0,1,1,0,1,1,0.011229,4,0.270366,0.287632,0
数字(1947),数字,notion,0,3,3,0,3,3,0.035724,4,0.311778,0.349165,5959.110786
整个(1947),整个,notion,0,1,1,0,1,1,0.007422,4,0.26356,0.275695,0
整肃(1947),整肃,notion,0,1,1,0,1,1,0.011229,4,0.270366,0.287632,0
整顿(1947),整顿,notion,0,1,1,0,1,1,0.013711,4,0.275027,0.295469,0
文与艺(1947),文与艺,notion,0,1,1,0,1,1,0.014222,4,0.275404,0.296091,0
文中(1947),文中,notion,0,1,1,0,1,1,0.014222,4,0.275404,0.296091,0
文书(1947),文书,notion,0,2,2,0,2,2,0.016457,4,0.27778,0.300034,1514.385671
文人(1947),文人,notion,0,1,1,0,1,1,0.014222,4,0.275404,0.296091,0
文件(1947),文件,notion,0,2,2,0,2,2,0.02531,4,0.2954,0.326876,2496.768821
文化教育界(1947),文化教育界,notion,0,1,1,0,1,1,0.014732,4,0.276453,0.297813,0
文化界(1947),文化界,notion,0,1,1,0,1,1,0.014222,4,0.275404,0.296091,0
文史(1947),文史,notion,0,1,1,0,1,1,0.014732,4,0.276453,0.297813,0
文字(1947),文字,notion,0,3,3,0,4,4,0.037601,4,0.316372,0.354988,6433.59957
文学(1947),文学,notion,0,5,5,0,14,14,0.057866,4,0.350156,0.39323,18181.114532
文学史(1947),文学史,notion,0,1,1,0,1,1,0.00981,4,0.267191,0.28214,0
文学艺术(1947),文学艺术,notion,0,1,1,0,1,1,0.002092,4,0.25318,0.25625,0
文学革命(1947),文学革命,notion,0,1,1,0,1,1,0.014732,4,0.276453,0.297813,0
文官(1947),文官,notion,0,1,1,0,1,1,0.009035,4,0.265075,0.278404,0
文幼章(1947),文幼章,notion,0,1,1,0,1,1,0.017323,4,0.281723,0.306272,0
文摘(1947),文摘,notion,0,1,1,0,1,1,0.004749,4,0.257108,0.263793,0
文昌(1947),文昌,notion,0,1,1,0,1,1,0.011229,4,0.270366,0.287632,0
文明(1947),文明,notion,0,1,1,0,1,1,0.014081,4,0.275493,0.296238,0
文汇(1947),文汇,notion,0,2,2,0,2,2,0.018829,4,0.280473,0.304355,655.354404
文献(1947),文献,notion,0,2,2,0,2,2,0.024032,4,0.290894,0.320321,1695.498775
文盲(1947),文盲,notion,0,1,1,0,1,1,0.00981,4,0.267191,0.28214,0
文章(1947),文章,notion,0,1,1,0,1,1,0.014081,4,0.275493,0.296238,0
文腔(1947),文腔,notion,0,1,1,0,1,1,0.011229,4,0.270366,0.287632,0
文艺(1947),文艺,notion,0,6,6,0,13,13,0.066486,4,0.365882,0.408635,24539.729924
文艺创作(1947),文艺创作,notion,0,1,1,0,1,1,0.011229,4,0.270366,0.287632,0
文艺复兴(1947),文艺复兴,notion,0,1,1,0,1,1,0.014081,4,0.275493,0.296238,0
文艺界(1947),文艺界,notion,0,1,1,0,1,1,0.013711,4,0.275027,0.295469,0
文语(1947),文语,notion,0,1,1,0,1,1,0.011229,4,0.270366,0.287632,0
文赋(1947),文赋,notion,0,1,1,0,1,1,0.014081,4,0.275493,0.296238,0
文集(1947),文集,notion,0,1,1,0,1,1,0.014732,4,0.276453,0.297813,0
文麟(1947),文麟,notion,0,1,1,0,1,1,0.007422,4,0.26356,0.275695,0
斗士(1947),斗士,notion,0,1,1,0,1,1,0.014732,4,0.276453,0.297813,0
斗鸡场(1947),斗鸡场,notion,0,1,1,0,1,1,0.017323,4,0.281723,0.306272,0
斥美(1947),斥美,notion,0,1,1,0,1,1,0.017323,4,0.281723,0.306272,0
斥责(1947),斥责,notion,0,1,1,0,1,1,0.017323,4,0.281723,0.306272,0
斯大林(1947),斯大林,notion,0,1,1,0,1,1,0.013711,4,0.275027,0.295469,0
斯太林(1947),斯太林,notion,0,1,1,0,1,1,0.014081,4,0.275493,0.296238,0
斯拉(1947),斯拉,notion,0,1,1,0,1,1,0.014222,4,0.275404,0.296091,0
斯特(1947),斯特,notion,0,1,1,0,1,1,0.00981,4,0.267191,0.28214,0
斯莫尔(1947),斯莫尔,notion,0,1,1,0,1,1,0.00981,4,0.267191,0.28214,0
新一军(1947),新一军,notion,0,1,1,0,1,1,0.011229,4,0.270366,0.287632,0
新中国(1947),新中国,notion,0,1,1,0,1,1,0.013711,4,0.275027,0.295469,0
新丰(1947),新丰,notion,0,1,1,0,2,2,0.011229,4,0.270366,0.287632,0
新书(1947),新书,notion,0,1,1,0,1,1,0.011229,4,0.270366,0.287632,0
新人(1947),新人,notion,0,1,1,0,1,1,0.002092,4,0.25318,0.25625,0
新元素(1947),新元素,notion,0,1,1,0,1,1,0.014222,4,0.275404,0.296091,0
新党(1947),新党,notion,0,1,1,0,2,2,0.017323,4,0.281723,0.306272,0
新兴(1947),新兴,notion,0,2,2,0,2,2,0.014579,4,0.275783,0.296775,568.859546
新兵(1947),新兵,notion,0,1,1,0,1,1,0.013711,4,0.275027,0.295469,0
新加坡(1947),新加坡,notion,0,1,1,0,2,2,0.017323,4,0.281723,0.306272,0
新动向(1947),新动向,notion,0,2,2,0,2,2,0.01531,4,0.276699,0.298276,117.280732
新华日报(1947),新华日报,notion,0,1,1,0,1,1,0.013711,4,0.275027,0.295469,0
新四军(1947),新四军,notion,0,1,1,0,1,1,0.009035,4,0.265075,0.278404,0
新型(1947),新型,notion,0,2,2,0,2,2,0.023767,4,0.289685,0.318527,1452.186204
新大陆(1947),新大陆,notion,0,1,1,0,1,1,0.014081,4,0.275493,0.296238,0
新字(1947),新字,notion,0,1,1,0,2,2,0.014081,4,0.275493,0.296238,0
新官(1947),新官,notion,0,1,1,0,1,1,0.017323,4,0.281723,0.306272,0
新官上任(1947),新官上任,notion,0,3,3,0,3,3,0.030058,4,0.300418,0.334005,4049.295209
新宪所定(1947),新宪所定,notion,0,1,1,0,1,1,0.014222,4,0.275404,0.296091,0
新小(1947),新小,notion,0,1,1,0,1,1,0.014732,4,0.276453,0.297813,0
新币(1947),新币,notion,0,1,1,0,1,1,0.003699,4,0.256009,0.261706,0
新年(1947),新年,notion,0,1,1,0,7,7,0.014222,4,0.275404,0.296091,0
新开(1947),新开,notion,0,1,1,0,1,1,0.017323,4,0.281723,0.306272,0
新形势下(1947),新形势下,notion,0,1,1,0,1,1,0.013711,4,0.275027,0.295469,0
新德里(1947),新德里,notion,0,1,1,0,1,1,0.017323,4,0.281723,0.306272,0
新攻势(1947),新攻势,notion,0,2,2,0,2,2,0.021039,4,0.286524,0.313766,1874.195629
新政(1947),新政,notion,0,1,1,0,1,1,0.014732,4,0.276453,0.297813,0
新政府(1947),新政府,notion,0,2,2,0,2,2,0.028302,4,0.298866,0.331783,1965.8222
新春(1947),新春,notion,0,1,1,0,2,2,0.003699,4,0.256009,0.261706,0
新月(1947),新月,notion,0,1,1,0,1,1,0.014732,4,0.276453,0.297813,0
新村(1947),新村,notion,0,1,1,0,1,1,0.007422,4,0.26356,0.275695,0
新民(1947),新民,notion,0,2,2,0,2,2,0.018829,4,0.280473,0.304355,655.354404
新泰(1947),新泰,notion,0,1,1,0,1,1,0.017323,4,0.281723,0.306272,0
新版(1947),新版,notion,0,1,1,0,1,1,0.009035,4,0.265075,0.278404,0
新生(1947),新生,notion,0,7,7,0,8,8,0.056511,4,0.347236,0.39035,23759.826113
新生代(1947),新生代,notion,0,1,1,0,1,1,0.013711,4,0.275027,0.295469,0
新的(1947),新的,notion,0,1,1,0,1,1,0.003699,4,0.256009,0.261706,0
新省(1947),新省,notion,0,1,1,0,1,1,0.017323,4,0.281723,0.306272,0
新缪司(1947),新缪司,notion,0,1,1,0,1,1,0.003699,4,0.256009,0.261706,0
新花样(1947),新花样,notion,0,2,2,0,2,2,0.024542,4,0.292264,0.322335,1826.657886
新诗(1947),新诗,notion,0,1,1,0,1,1,0.003699,4,0.256009,0.261706,0
新路(1947),新路,notion,0,1,1,0,1,1,0.002092,4,0.25318,0.25625,0
新近(1947),新近,notion,0,1,1,0,1,1,0.014081,4,0.275493,0.296238,0
新进展(1947),新进展,notion,0,1,1,0,1,1,0.014222,4,0.275404,0.296091,0
新闻(1947),新闻,notion,0,5,5,0,7,7,0.051387,4,0.332684,0.374481,12110.563663
新闻界(1947),新闻界,notion,0,1,1,0,2,2,0.017323,4,0.281723,0.306272,0
新闻纸(1947),新闻纸,notion,0,2,2,0,2,2,0.028302,4,0.298866,0.331783,1965.8222
新阁(1947),新阁,notion,0,1,1,0,1,1,0.00981,4,0.267191,0.28214,0
新面貌(1947),新面貌,notion,0,1,1,0,1,1,0.013711,4,0.275027,0.295469,0
新高潮(1947),新高潮,notion,0,1,1,0,1,1,0.003699,4,0.256009,0.261706,0
新鬼烦(1947),新鬼烦,notion,0,2,2,0,2,2,0.01948,4,0.281468,0.30593,668.20053
方向(1947),方向,notion,0,5,5,0,6,6,0.054155,4,0.343981,0.386822,17344.06495
方式(1947),方式,notion,0,1,1,0,1,1,0.014222,4,0.275404,0.296091,0
方显(1947),方显,notion,0,2,2,0,2,2,0.018829,4,0.280473,0.304355,655.354404
方策(1947),方策,notion,0,1,1,0,1,1,0.014222,4,0.275404,0.296091,0
方针(1947),方针,notion,0,5,5,0,5,5,0.064928,4,0.369127,0.411577,22658.189234
方面(1947),方面,notion,0,1,1,0,1,1,0.013711,4,0.275027,0.295469,0
施政(1947),施政,notion,0,1,1,0,1,1,0.014732,4,0.276453,0.297813,0
施用(1947),施用,notion,0,1,1,0,1,1,0.014081,4,0.275493,0.296238,0
旁观(1947),旁观,notion,0,1,1,0,1,1,0.014081,4,0.275493,0.296238,0
旅大(1947),旅大,notion,0,1,1,0,1,1,0.014222,4,0.275404,0.296091,0
旅程(1947),旅程,notion,0,1,1,0,1,1,0.014081,4,0.275493,0.296238,0
旅行(1947),旅行,notion,0,6,6,0,10,10,0.057899,4,0.348441,0.391534,22813.048284
旅途(1947),旅途,notion,0,3,3,0,3,3,0.041355,4,0.320953,0.360627,5686.400693
旗帜(1947),旗帜,notion,0,3,3,0,4,4,0.027032,4,0.295733,0.327413,3946.77169
无声(1947),无声,notion,0,1,1,0,1,1,0.014732,4,0.276453,0.297813,0
无处(1947),无处,notion,0,1,1,0,1,1,0.009035,4,0.265075,0.278404,0
无家(1947),无家,notion,0,1,1,0,1,1,0.00981,4,0.267191,0.28214,0
无家可归(1947),无家可归,notion,0,2,2,0,2,2,0.013398,4,0.271635,0.289854,656.368623
无所事事(1947),无所事事,notion,0,1,1,0,1,1,0.014081,4,0.275493,0.296238,0
无措(1947),无措,notion,0,1,1,0,1,1,0.013711,4,0.275027,0.295469,0
无期(1947),无期,notion,0,1,1,0,1,1,0.014732,4,0.276453,0.297813,0
无权(1947),无权,notion,0,1,1,0,1,1,0.013711,4,0.275027,0.295469,0
无法(1947),无法,notion,0,1,1,0,1,1,0.004749,4,0.257108,0.263793,0
无益(1947),无益,notion,0,1,1,0,1,1,0.007422,4,0.26356,0.275695,0
无知(1947),无知,notion,0,2,2,0,2,2,0.028442,4,0.300022,0.333394,2187.730369
无米之炊(1947),无米之炊,notion,0,2,2,0,2,2,0.01948,4,0.281468,0.30593,668.20053
无罪(1947),无罪,notion,0,2,2,0,2,2,0.017669,4,0.279944,0.303513,871.280033
无耻(1947),无耻,notion,0,4,4,0,4,4,0.045851,4,0.328869,0.370062,9160.854112
无聊(1947),无聊,notion,0,1,1,0,1,1,0.013711,4,0.275027,0.295469,0
无辜(1947),无辜,notion,0,1,1,0,1,1,0.013711,4,0.275027,0.295469,0
无边(1947),无边,notion,0,1,1,0,1,1,0.013711,4,0.275027,0.295469,0
无锡(1947),无锡,notion,0,1,1,0,1,1,0.014732,4,0.276453,0.297813,0
无门(1947),无门,notion,0,1,1,0,1,1,0.004749,4,0.257108,0.263793,0
无限(1947),无限,notion,0,1,1,0,1,1,0.017323,4,0.281723,0.306272,0
无非(1947),无非,notion,0,1,1,0,1,1,0.014222,4,0.275404,0.296091,0
无题(1947),无题,notion,0,3,3,0,3,3,0.026815,4,0.293546,0.324264,3447.670844
既得利益(1947),既得利益,notion,0,1,1,0,1,1,0.014081,4,0.275493,0.296238,0
日内瓦(1947),日内瓦,notion,0,1,1,0,1,1,0.00981,4,0.267191,0.28214,0
日子(1947),日子,notion,0,6,6,0,11,11,0.074086,4,0.387523,0.427713,31998.539597
日寇(1947),日寇,notion,0,1,1,0,1,1,0.00981,4,0.267191,0.28214,0
日惹(1947),日惹,notion,0,1,1,0,1,1,0.017323,4,0.281723,0.306272,0
日报(1947),日报,notion,0,2,2,0,2,2,0.01741,4,0.280151,0.303843,1198.480437
日日(1947),日日,notion,0,1,1,0,1,1,0.014732,4,0.276453,0.297813,0
日益(1947),日益,notion,0,1,1,0,1,1,0.011229,4,0.270366,0.287632,0
日益壮大(1947),日益壮大,notion,0,1,1,0,1,1,0.013711,4,0.275027,0.295469,0
日知录(1947),日知录,notion,0,1,1,0,1,1,0.014222,4,0.275404,0.296091,0
日货(1947),日货,notion,0,1,1,0,3,3,0.013711,4,0.275027,0.295469,0
日趋(1947),日趋,notion,0,1,1,0,1,1,0.017323,4,0.281723,0.306272,0
日趋激烈(1947),日趋激烈,notion,0,1,1,0,1,1,0.017323,4,0.281723,0.306272,0
日食(1947),日食,notion,0,1,1,0,1,1,0.014222,4,0.275404,0.296091,0
旧事(1947),旧事,notion,0,1,1,0,1,1,0.017323,4,0.281723,0.306272,0
旧地重游(1947),旧地重游,notion,0,1,1,0,1,1,0.014732,4,0.276453,0.297813,0
旧戏(1947),旧戏,notion,0,1,1,0,1,1,0.011229,4,0.270366,0.287632,0
旧报(1947),旧报,notion,0,1,1,0,1,1,0.014732,4,0.276453,0.297813,0
旧调(1947),旧调,notion,0,1,1,0,1,1,0.017323,4,0.281723,0.306272,0
旧货摊(1947),旧货摊,notion,0,1,1,0,1,1,0.014732,4,0.276453,0.297813,0
旧金山(1947),旧金山,notion,0,1,1,0,1,1,0.013711,4,0.275027,0.295469,0
早就(1947),早就,notion,0,1,1,0,1,1,0.011229,4,0.270366,0.287632,0
旬刊(1947),旬刊,notion,0,1,1,0,1,1,0.014222,4,0.275404,0.296091,0
时代背景(1947),时代背景,notion,0,1,1,0,1,1,0.014222,4,0.275404,0.296091,0
时候(1947),时候,notion,0,4,4,0,6,6,0.046983,4,0.331843,0.373468,10539.573628
时光(1947),时光,notion,0,1,1,0,1,1,0.014081,4,0.275493,0.296238,0
时君(1947),时君,notion,0,1,1,0,1,1,0.014732,4,0.276453,0.297813,0
时君为(1947),时君为,notion,0,1,1,0,1,1,0.014732,4,0.276453,0.297813,0
时报(1947),时报,notion,0,1,1,0,1,1,0.014732,4,0.276453,0.297813,0
时期(1947),时期,notion,0,2,2,0,2,2,0.017921,4,0.280658,0.304648,1255.9419
时机(1947),时机,notion,0,1,1,0,1,1,0.007422,4,0.26356,0.275695,0
时评(1947),时评,notion,0,2,2,0,2,2,0.02494,4,0.292941,0.323324,1747.290038
时间表(1947),时间表,notion,0,1,1,0,1,1,0.00981,4,0.267191,0.28214,0
明代(1947),明代,notion,0,1,1,0,1,1,0.014732,4,0.276453,0.297813,0
明天(1947),明天,notion,0,1,1,0,1,1,0.017323,4,0.281723,0.306272,0
明日(1947),明日,notion,0,1,1,0,1,1,0.017323,4,0.281723,0.306272,0
明朗化(1947),明朗化,notion,0,1,1,0,1,1,0.004749,4,0.257108,0.263793,0
明白(1947),明白,notion,0,1,1,0,1,1,0.014081,4,0.275493,0.296238,0
明确(1947),明确,notion,0,1,1,0,1,1,0.014732,4,0.276453,0.297813,0
易势(1947),易势,notion,0,2,2,0,2,2,0.017299,4,0.278915,0.301865,688.562525
星星之火(1947),星星之火,notion,0,1,1,0,1,1,0.002092,4,0.25318,0.25625,0
星洲(1947),星洲,notion,0,2,2,0,3,3,0.032055,4,0.30624,0.341853,2215.722594
星海(1947),星海,notion,0,1,1,0,1,1,0.014732,4,0.276453,0.297813,0
春天(1947),春天,notion,0,2,2,0,2,2,0.027791,4,0.29968,0.332918,2405.290268
春日(1947),春日,notion,0,1,1,0,1,1,0.017323,4,0.281723,0.306272,0
春耕(1947),春耕,notion,0,1,1,0,1,1,0.014732,4,0.276453,0.297813,0
春色(1947),春色,notion,0,1,1,0,1,1,0.017323,4,0.281723,0.306272,0
昨日(1947),昨日,notion,0,1,1,0,1,1,0.014732,4,0.276453,0.297813,0
是乎(1947),是乎,notion,0,1,1,0,1,1,0.003699,4,0.256009,0.261706,0
是非(1947),是非,notion,0,2,2,0,2,2,0.017299,4,0.278915,0.301865,688.562525
是靠(1947),是靠,notion,0,1,1,0,1,1,0.014732,4,0.276453,0.297813,0
显明(1947),显明,notion,0,1,1,0,1,1,0.014222,4,0.275404,0.296091,0
晋南(1947),晋南,notion,0,2,2,0,2,2,0.028302,4,0.298866,0.331783,1965.8222
晋察冀(1947),晋察冀,notion,0,1,1,0,2,2,0.013711,4,0.275027,0.295469,0
晋察冀边区(1947),晋察冀边区,notion,0,1,1,0,2,2,0.013711,4,0.275027,0.295469,0
晓得(1947),晓得,notion,0,1,1,0,1,1,0.014732,4,0.276453,0.297813,0
晚会(1947),晚会,notion,0,2,2,0,2,2,0.014818,4,0.274563,0.294761,698.886811
晚报(1947),晚报,notion,0,2,2,0,3,3,0.027133,4,0.29671,0.328744,1770.9936
晦明(1947),晦明,notion,0,1,1,0,1,1,0.014081,4,0.275493,0.296238,0
晦涩(1947),晦涩,notion,0,1,1,0,1,1,0.014081,4,0.275493,0.296238,0
普选(1947),普选,notion,0,2,2,0,4,4,0.024032,4,0.290894,0.320321,1695.498775
普通人(1947),普通人,notion,0,1,1,0,1,1,0.00981,4,0.267191,0.28214,0
普遍(1947),普遍,notion,0,4,4,0,4,4,0.056855,4,0.352835,0.395879,14054.832805
普遍推行(1947),普遍推行,notion,0,1,1,0,1,1,0.007422,4,0.26356,0.275695,0
普陀(1947),普陀,notion,0,1,1,0,1,1,0.007422,4,0.26356,0.275695,0
景行(1947),景行,notion,0,1,1,0,1,1,0.014222,4,0.275404,0.296091,0
晴和(1947),晴和,notion,0,1,1,0,1,1,0.017323,4,0.281723,0.306272,0
晴朗(1947),晴朗,notion,0,1,1,0,1,1,0.017323,4,0.281723,0.306272,0
晴雨计(1947),晴雨计,notion,0,2,2,0,2,2,0.032055,4,0.30624,0.341853,2215.722594
智力(1947),智力,notion,0,1,1,0,1,1,0.002092,4,0.25318,0.25625,0
智取(1947),智取,notion,0,1,1,0,1,1,0.011229,4,0.270366,0.287632,0
智慧(1947),智慧,notion,0,2,2,0,2,2,0.028552,4,0.301506,0.335445,2588.539662
智识份子(1947),智识份子,notion,0,1,1,0,1,1,0.011229,4,0.270366,0.287632,0
暂时(1947),暂时,notion,0,1,1,0,1,1,0.014081,4,0.275493,0.296238,0
暑假(1947),暑假,notion,0,1,1,0,2,2,0.011229,4,0.270366,0.287632,0
暑工队(1947),暑工队,notion,0,1,1,0,1,1,0.007422,4,0.26356,0.275695,0
暗影(1947),暗影,notion,0,1,1,0,1,1,0.014222,4,0.275404,0.296091,0
暗杀(1947),暗杀,notion,0,1,1,0,1,1,0.017323,4,0.281723,0.306272,0
暨大(1947),暨大,notion,0,2,2,0,2,2,0.032055,4,0.30624,0.341853,2215.722594
暮秋(1947),暮秋,notion,0,1,1,0,1,1,0.013711,4,0.275027,0.295469,0
暴动(1947),暴动,notion,0,1,1,0,3,3,0.014081,4,0.275493,0.296238,0
暴露(1947),暴露,notion,0,1,1,0,1,1,0.013711,4,0.275027,0.295469,0
暴风雨(1947),暴风雨,notion,0,1,1,0,2,2,0.013711,4,0.275027,0.295469,0
曲折(1947),曲折,notion,0,1,1,0,1,1,0.007422,4,0.26356,0.275695,0
曲江(1947),曲江,notion,0,1,1,0,1,1,0.011229,4,0.270366,0.287632,0
曲解(1947),曲解,notion,0,2,2,0,2,2,0.028812,4,0.299917,0.333248,2025.61524
曳引机(1947),曳引机,notion,0,1,1,0,1,1,0.007422,4,0.26356,0.275695,0
更大(1947),更大,notion,0,1,1,0,1,1,0.013711,4,0.275027,0.295469,0
更好(1947),更好,notion,0,1,1,0,1,1,0.013711,4,0.275027,0.295469,0
更正(1947),更正,notion,0,1,1,0,2,2,0.014081,4,0.275493,0.296238,0
更深(1947),更深,notion,0,1,1,0,1,1,0.013711,4,0.275027,0.295469,0
更迭(1947),更迭,notion,0,1,1,0,1,1,0.011229,4,0.270366,0.287632,0
曹禺(1947),曹禺,notion,0,1,1,0,1,1,0.014732,4,0.276453,0.297813,0
曼纽斯基(1947),曼纽斯基,notion,0,1,1,0,1,1,0.00981,4,0.267191,0.28214,0
曾琦(1947),曾琦,notion,0,2,2,0,2,2,0.028442,4,0.300022,0.333394,2187.730369
曾进(1947),曾进,notion,0,1,1,0,1,1,0.014222,4,0.275404,0.296091,0
替换(1947),替换,notion,0,1,1,0,1,1,0.013711,4,0.275027,0.295469,0
替死(1947),替死,notion,0,1,1,0,1,1,0.013711,4,0.275027,0.295469,0
最低(1947),最低,notion,0,2,2,0,2,2,0.028302,4,0.298866,0.331783,1965.8222
最兇(1947),最兇,notion,0,1,1,0,1,1,0.013711,4,0.275027,0.295469,0
最后(1947),最后,notion,0,7,7,0,13,13,0.088626,4,0.412035,0.446963,36455.377636
最好(1947),最好,notion,0,1,1,0,1,1,0.011229,4,0.270366,0.287632,0
最眞实(1947),最眞实,notion,0,1,1,0,1,1,0.014081,4,0.275493,0.296238,0
最着(1947),最着,notion,0,1,1,0,1,1,0.014222,4,0.275404,0.296091,0
最高(1947),最高,notion,0,3,3,0,4,4,0.041865,4,0.321892,0.361762,5813.37408
月刊(1947),月刊,notion,0,1,1,0,1,1,0.014732,4,0.276453,0.297813,0
月夜(1947),月夜,notion,0,1,1,0,1,1,0.011229,4,0.270366,0.287632,0
有事(1947),有事,notion,0,2,2,0,2,2,0.02494,4,0.292941,0.323324,1747.290038
有人(1947),有人,notion,0,2,2,0,2,2,0.027791,4,0.29968,0.332918,2405.290268
有何感想(1947),有何感想,notion,0,1,1,0,1,1,0.014732,4,0.276453,0.297813,0
有何面目(1947),有何面目,notion,0,1,1,0,1,1,0.004749,4,0.257108,0.263793,0
有关(1947),有关,notion,0,2,2,0,2,2,0.027791,4,0.29968,0.332918,2405.290268
有利(1947),有利,notion,0,1,1,0,1,1,0.007422,4,0.26356,0.275695,0
有啼痕(1947),有啼痕,notion,0,2,2,0,2,2,0.031404,4,0.30602,0.34156,2430.025091
有志(1947),有志,notion,0,2,2,0,2,2,0.028302,4,0.298866,0.331783,1965.8222
有感(1947),有感,notion,0,2,2,0,2,2,0.026359,4,0.294788,0.325997,1561.492709
有时候(1947),有时候,notion,0,1,1,0,1,1,0.013711,4,0.275027,0.295469,0
有朋自远方来(1947),有朋自远方来,notion,0,1,1,0,1,1,0.004749,4,0.257108,0.263793,0
有术(1947),有术,notion,0,1,1,0,1,1,0.014732,4,0.276453,0.297813,0
有机(1947),有机,notion,0,1,1,0,1,1,0.013711,4,0.275027,0.295469,0
有权(1947),有权,notion,0,1,1,0,1,1,0.017323,4,0.281723,0.306272,0
有毒(1947),有毒,notion,0,1,1,0,1,1,0.011229,4,0.270366,0.287632,0
有空(1947),有空,notion,0,1,1,0,1,1,0.013711,4,0.275027,0.295469,0
朋友(1947),朋友,notion,0,5,5,0,6,6,0.071217,4,0.381418,0.422489,22692.680406
朋反(1947),朋反,notion,0,1,1,0,1,1,0.013711,4,0.275027,0.295469,0
服从(1947),服从,notion,0,1,1,0,1,1,0.014081,4,0.275493,0.296238,0
服务队(1947),服务队,notion,0,2,2,0,2,2,0.022153,4,0.289808,0.31871,2534.094371
服役(1947),服役,notion,0,1,1,0,1,1,0.014732,4,0.276453,0.297813,0
服输(1947),服输,notion,0,1,1,0,1,1,0.014081,4,0.275493,0.296238,0
朗诵诗(1947),朗诵诗,notion,0,1,1,0,1,1,0.014081,4,0.275493,0.296238,0
朝华(1947),朝华,notion,0,1,1,0,1,1,0.014081,4,0.275493,0.296238,0
期内(1947),期内,notion,0,1,1,0,1,1,0.014222,4,0.275404,0.296091,0
期刊(1947),期刊,notion,0,1,1,0,1,1,0.013711,4,0.275027,0.295469,0
期待(1947),期待,notion,0,1,1,0,1,1,0.014081,4,0.275493,0.296238,0
期望(1947),期望,notion,0,3,3,0,3,3,0.04058,4,0.317727,0.356672,4950.672902
期近(1947),期近,notion,0,1,1,0,1,1,0.014222,4,0.275404,0.296091,0
期间(1947),期间,notion,0,1,1,0,10,10,0.007422,4,0.26356,0.275695,0
木展(1947),木展,notion,0,1,1,0,5,5,0.014732,4,0.276453,0.297813,0
木材(1947),木材,notion,0,1,1,0,1,1,0.007422,4,0.26356,0.275695,0
木鱼(1947),木鱼,notion,0,1,1,0,2,2,0.011229,4,0.270366,0.287632,0
未了(1947),未了,notion,0,1,1,0,1,1,0.014732,4,0.276453,0.297813,0
未婚妻(1947),未婚妻,notion,0,1,1,0,1,1,0.011229,4,0.270366,0.287632,0
未收(1947),未收,notion,0,1,1,0,1,1,0.011229,4,0.270366,0.287632,0
未有(1947),未有,notion,0,1,1,0,1,1,0.014222,4,0.275404,0.296091,0
末日(1947),末日,notion,0,2,2,0,3,3,0.027932,4,0.299811,0.333101,2443.455357
末段(1947),末段,notion,0,1,1,0,1,1,0.017323,4,0.281723,0.306272,0
末路(1947),末路,notion,0,2,2,0,2,2,0.016314,4,0.277757,0.299998,853.020505
本书(1947),本书,notion,0,1,1,0,1,1,0.011229,4,0.270366,0.287632,0
本人(1947),本人,notion,0,1,1,0,1,1,0.00981,4,0.267191,0.28214,0
本区(1947),本区,notion,0,1,1,0,1,1,0.007422,4,0.26356,0.275695,0
本届(1947),本届,notion,0,1,1,0,1,1,0.014081,4,0.275493,0.296238,0
本屐(1947),本屐,notion,0,1,1,0,1,1,0.014732,4,0.276453,0.297813,0
本息(1947),本息,notion,0,1,1,0,1,1,0.009035,4,0.265075,0.278404,0
本报(1947),本报,notion,0,1,1,0,1,1,0.011229,4,0.270366,0.287632,0
本文(1947),本文,notion,0,1,1,0,1,1,0.009035,4,0.265075,0.278404,0
本来(1947),本来,notion,0,1,1,0,1,1,0.014081,4,0.275493,0.296238,0
本纪(1947),本纪,notion,0,1,1,0,1,1,0.017323,4,0.281723,0.306272,0
本钱(1947),本钱,notion,0,1,1,0,1,1,0.013711,4,0.275027,0.295469,0
朱家骅(1947),朱家骅,notion,0,1,1,0,1,1,0.013711,4,0.275027,0.295469,0
朱希祖(1947),朱希祖,notion,0,1,1,0,1,1,0.014222,4,0.275404,0.296091,0
朱德(1947),朱德,notion,0,1,1,0,1,1,0.013711,4,0.275027,0.295469,0
朱氏(1947),朱氏,notion,0,1,1,0,1,1,0.017323,4,0.281723,0.306272,0
机会(1947),机会,notion,0,3,3,0,3,3,0.037338,4,0.310954,0.348103,4493.316655
机关(1947),机关,notion,0,3,3,0,3,3,0.041214,4,0.322074,0.361982,6317.925086
机器(1947),机器,notion,0,2,2,0,3,3,0.031404,4,0.30602,0.34156,2430.025091
机枪(1947),机枪,notion,0,1,1,0,1,1,0.014732,4,0.276453,0.297813,0
机械(1947),机械,notion,0,1,1,0,1,1,0.014081,4,0.275493,0.296238,0
机械化(1947),机械化,notion,0,1,1,0,1,1,0.014222,4,0.275404,0.296091,0
机站(1947),机站,notion,0,1,1,0,1,1,0.00981,4,0.267191,0.28214,0
杀了人(1947),杀了人,notion,0,1,1,0,1,1,0.017323,4,0.281723,0.306272,0
杀人(1947),杀人,notion,0,2,2,0,2,2,0.01832,4,0.280681,0.304685,795.39908
杀头(1947),杀头,notion,0,1,1,0,1,1,0.011229,4,0.270366,0.287632,0
杀妻案(1947),杀妻案,notion,0,1,1,0,1,1,0.014732,4,0.276453,0.297813,0
杀掠(1947),杀掠,notion,0,1,1,0,1,1,0.013711,4,0.275027,0.295469,0
杀机(1947),杀机,notion,0,1,1,0,1,1,0.011229,4,0.270366,0.287632,0
杀死(1947),杀死,notion,0,2,2,0,2,2,0.017299,4,0.278915,0.301865,688.562525
杂写(1947),杂写,notion,0,1,1,0,1,1,0.011229,4,0.270366,0.287632,0
杂忆(1947),杂忆,notion,0,1,1,0,1,1,0.007422,4,0.26356,0.275695,0
杂志社(1947),杂志社,notion,0,1,1,0,1,1,0.00981,4,0.267191,0.28214,0
杂感(1947),杂感,notion,0,2,2,0,6,6,0.023767,4,0.289685,0.318527,1452.186204
杂文集(1947),杂文集,notion,0,1,1,0,1,1,0.009035,4,0.265075,0.278404,0
杂誌(1947),杂誌,notion,0,2,2,0,3,3,0.028302,4,0.298866,0.331783,1965.8222
权利(1947),权利,notion,0,2,2,0,2,2,0.026359,4,0.294788,0.325997,1561.492709
权威人士(1947),权威人士,notion,0,1,1,0,1,1,0.013711,4,0.275027,0.295469,0
权益(1947),权益,notion,0,1,1,0,1,1,0.017323,4,0.281723,0.306272,0
权门(1947),权门,notion,0,1,1,0,1,1,0.004749,4,0.257108,0.263793,0
李何(1947),李何,notion,0,1,1,0,1,1,0.017323,4,0.281723,0.306272,0
李健吾(1947),李健吾,notion,0,1,1,0,1,1,0.014222,4,0.275404,0.296091,0
李先念(1947),李先念,notion,0,1,1,0,1,1,0.014732,4,0.276453,0.297813,0
李公樸(1947),李公樸,notion,0,1,1,0,1,1,0.003588,4,0.255396,0.260534,0
李兰英(1947),李兰英,notion,0,1,1,0,1,1,0.013711,4,0.275027,0.295469,0
李冯(1947),李冯,notion,0,1,1,0,1,1,0.017323,4,0.281723,0.306272,0
李崇淮(1947),李崇淮,notion,0,1,1,0,1,1,0.004749,4,0.257108,0.263793,0
李德(1947),李德,notion,0,1,1,0,1,1,0.014222,4,0.275404,0.296091,0
李普曼(1947),李普曼,notion,0,1,1,0,1,1,0.00981,4,0.267191,0.28214,0
李林绍(1947),李林绍,notion,0,1,1,0,1,1,0.017323,4,0.281723,0.306272,0
李济深(1947),李济深,notion,0,2,2,0,3,3,0.021022,4,0.286837,0.314242,1344.24886
李滋(1947),李滋,notion,0,1,1,0,1,1,0.017323,4,0.281723,0.306272,0
李璜(1947),李璜,notion,0,1,1,0,1,1,0.009035,4,0.265075,0.278404,0
李虾(1947),李虾,notion,0,1,1,0,1,1,0.004749,4,0.257108,0.263793,0
李香香(1947),李香香,notion,0,1,1,0,1,1,0.013711,4,0.275027,0.295469,0
村里(1947),村里,notion,0,1,1,0,1,1,0.014732,4,0.276453,0.297813,0
杜会(1947),杜会,notion,0,1,1,0,1,1,0.009035,4,0.265075,0.278404,0
杜斌(1947),杜斌,notion,0,1,1,0,2,2,0.017323,4,0.281723,0.306272,0
杜案(1947),杜案,notion,0,1,1,0,1,1,0.017323,4,0.281723,0.306272,0
杜绝(1947),杜绝,notion,0,1,1,0,1,1,0.014222,4,0.275404,0.296091,0
杜蒲(1947),杜蒲,notion,0,1,1,0,1,1,0.014081,4,0.275493,0.296238,0
杜门(1947),杜门,notion,0,1,1,0,1,1,0.013711,4,0.275027,0.295469,0
束手待毙(1947),束手待毙,notion,0,1,1,0,1,1,0.011229,4,0.270366,0.287632,0
束紧(1947),束紧,notion,0,1,1,0,1,1,0.011229,4,0.270366,0.287632,0
束缚(1947),束缚,notion,0,1,1,0,2,2,0.014732,4,0.276453,0.297813,0
条件(1947),条件,notion,0,4,4,0,7,7,0.060357,4,0.356893,0.399907,12921.914509
条约(1947),条约,notion,0,3,3,0,4,4,0.041214,4,0.322074,0.361982,6317.925086
来了(1947),来了,notion,0,1,1,0,2,2,0.013711,4,0.275027,0.295469,0
来信(1947),来信,notion,0,4,4,0,8,8,0.049863,4,0.336455,0.378631,9910.057001
来华(1947),来华,notion,0,5,5,0,8,8,0.065106,4,0.361351,0.404289,15765.104512
来往(1947),来往,notion,0,1,1,0,1,1,0.014081,4,0.275493,0.296238,0
来看(1947),来看,notion,0,1,1,0,1,1,0.007422,4,0.26356,0.275695,0
杨人(1947),杨人,notion,0,1,1,0,1,1,0.014081,4,0.275493,0.296238,0
杨光(1947),杨光,notion,0,1,1,0,2,2,0.014732,4,0.276453,0.297813,0
杨石魂(1947),杨石魂,notion,0,1,1,0,1,1,0.011229,4,0.270366,0.287632,0
松懈(1947),松懈,notion,0,1,1,0,1,1,0.013711,4,0.275027,0.295469,0
松花江畔(1947),松花江畔,notion,0,1,1,0,1,1,0.014081,4,0.275493,0.296238,0
极北(1947),极北,notion,0,1,1,0,1,1,0.00981,4,0.267191,0.28214,0
极目(1947),极目,notion,0,1,1,0,1,1,0.014081,4,0.275493,0.296238,0
林彪(1947),林彪,notion,0,1,1,0,2,2,0.013711,4,0.275027,0.295469,0
林荫(1947),林荫,notion,0,1,1,0,1,1,0.00981,4,0.267191,0.28214,0
林语堂(1947),林语堂,notion,0,1,1,0,1,1,0.014081,4,0.275493,0.296238,0
果园(1947),果园,notion,0,1,1,0,1,1,0.014081,4,0.275493,0.296238,0
果如所料(1947),果如所料,notion,0,1,1,0,1,1,0.011229,4,0.270366,0.287632,0
果能(1947),果能,notion,0,2,2,0,2,2,0.026359,4,0.294788,0.325997,1561.492709
枯燥(1947),枯燥,notion,0,1,1,0,1,1,0.013711,4,0.275027,0.295469,0
柏吞(1947),柏吞,notion,0,1,1,0,1,1,0.014222,4,0.275404,0.296091,0
柏拉图(1947),柏拉图,notion,0,1,1,0,1,1,0.014081,4,0.275493,0.296238,0
柏林(1947),柏林,notion,0,3,3,0,3,3,0.036169,4,0.309685,0.346455,4415.889012
某些(1947),某些,notion,0,1,1,0,1,1,0.00981,4,0.267191,0.28214,0
柔石(1947),柔石,notion,0,1,1,0,1,1,0.003699,4,0.256009,0.261706,0
查出(1947),查出,notion,0,1,1,0,1,1,0.009035,4,0.265075,0.278404,0
查孔(1947),查孔,notion,0,1,1,0,1,1,0.017323,4,0.281723,0.306272,0
查看(1947),查看,notion,0,1,1,0,1,1,0.007422,4,0.26356,0.275695,0
查禁(1947),查禁,notion,0,1,1,0,1,1,0.017323,4,0.281723,0.306272,0
柯亨(1947),柯亨,notion,0,1,1,0,1,1,0.017323,4,0.281723,0.306272,0
柯佛(1947),柯佛,notion,0,1,1,0,1,1,0.00981,4,0.267191,0.28214,0
柯尔(1947),柯尔,notion,0,1,1,0,1,1,0.00981,4,0.267191,0.28214,0
柯诺华洛夫(1947),柯诺华洛夫,notion,0,1,1,0,1,1,0.00981,4,0.267191,0.28214,0
柳州(1947),柳州,notion,0,1,1,0,1,1,0.013711,4,0.275027,0.295469,0
柴可夫斯基(1947),柴可夫斯基,notion,0,1,1,0,1,1,0.014732,4,0.276453,0.297813,0
标準(1947),标準,notion,0,1,1,0,1,1,0.014081,4,0.275493,0.296238,0
标的(1947),标的,notion,0,1,1,0,1,1,0.009035,4,0.265075,0.278404,0
标题(1947),标题,notion,0,1,1,0,1,1,0.014222,4,0.275404,0.296091,0
树立(1947),树立,notion,0,3,3,0,3,3,0.035724,4,0.311778,0.349165,5959.110786
校友(1947),校友,notion,0,1,1,0,2,2,0.014732,4,0.276453,0.297813,0
株连(1947),株连,notion,0,1,1,0,1,1,0.011229,4,0.270366,0.287632,0
样子(1947),样子,notion,0,1,1,0,1,1,0.014081,4,0.275493,0.296238,0
核心(1947),核心,notion,0,1,1,0,1,1,0.014222,4,0.275404,0.296091,0
根室与(1947),根室与,notion,0,1,1,0,1,1,0.017323,4,0.281723,0.306272,0
根据(1947),根据,notion,0,1,1,0,1,1,0.003588,4,0.255396,0.260534,0
根据地(1947),根据地,notion,0,1,1,0,1,1,0.014222,4,0.275404,0.296091,0
根本(1947),根本,notion,0,3,3,0,3,3,0.026251,4,0.29347,0.324154,3759.678787
根源(1947),根源,notion,0,1,1,0,1,1,0.014081,4,0.275493,0.296238,0
格勒(1947),格勒,notion,0,1,1,0,2,2,0.00981,4,0.267191,0.28214,0
格特(1947),格特,notion,0,1,1,0,1,1,0.011229,4,0.270366,0.287632,0
桂东(1947),桂东,notion,0,1,1,0,1,1,0.011229,4,0.270366,0.287632,0
桂林(1947),桂林,notion,0,3,3,0,6,6,0.025808,4,0.293622,0.324374,2814.449083
桂省(1947),桂省,notion,0,1,1,0,1,1,0.017323,4,0.281723,0.306272,0
桂花(1947),桂花,notion,0,1,1,0,1,1,0.011229,4,0.270366,0.287632,0
桂西(1947),桂西,notion,0,1,1,0,1,1,0.013711,4,0.275027,0.295469,0
案续志(1947),案续志,notion,0,1,1,0,1,1,0.014732,4,0.276453,0.297813,0
梁永章(1947),梁永章,notion,0,1,1,0,1,1,0.013711,4,0.275027,0.295469,0
梁漱溟(1947),梁漱溟,notion,0,1,1,0,1,1,0.014081,4,0.275493,0.296238,0
梁纯夫(1947),梁纯夫,notion,0,1,1,0,1,1,0.003588,4,0.255396,0.260534,0
梅尔(1947),梅尔,notion,0,1,1,0,1,1,0.00981,4,0.267191,0.28214,0
梅州(1947),梅州,notion,0,1,1,0,1,1,0.011229,4,0.270366,0.287632,0
梅月涵(1947),梅月涵,notion,0,1,1,0,1,1,0.014081,4,0.275493,0.296238,0
梅花(1947),梅花,notion,0,1,1,0,1,1,0.004749,4,0.257108,0.263793,0
梅隐(1947),梅隐,notion,0,1,1,0,1,1,0.014222,4,0.275404,0.296091,0
梦呓(1947),梦呓,notion,0,1,1,0,1,1,0.003588,4,0.255396,0.260534,0
检查(1947),检查,notion,0,5,5,0,6,6,0.062255,4,0.358354,0.401396,16759.616536
检核(1947),检核,notion,0,1,1,0,1,1,0.007422,4,0.26356,0.275695,0
棉作(1947),棉作,notion,0,1,1,0,1,1,0.007422,4,0.26356,0.275695,0
棉花(1947),棉花,notion,0,2,2,0,2,2,0.023116,4,0.288412,0.316623,1358.22258
植棉(1947),植棉,notion,0,1,1,0,2,2,0.007422,4,0.26356,0.275695,0
楚材晋用(1947),楚材晋用,notion,0,1,1,0,1,1,0.014222,4,0.275404,0.296091,0
楼板(1947),楼板,notion,0,1,1,0,1,1,0.017323,4,0.281723,0.306272,0
楼梯(1947),楼梯,notion,0,1,1,0,1,1,0.014222,4,0.275404,0.296091,0
概要(1947),概要,notion,0,1,1,0,1,1,0.014222,4,0.275404,0.296091,0
概观(1947),概观,notion,0,1,1,0,1,1,0.014222,4,0.275404,0.296091,0
概论(1947),概论,notion,0,1,1,0,1,1,0.014222,4,0.275404,0.296091,0
榆林(1947),榆林,notion,0,1,1,0,2,2,0.017323,4,0.281723,0.306272,0
榜样(1947),榜样,notion,0,1,1,0,1,1,0.017323,4,0.281723,0.306272,0
榨取(1947),榨取,notion,0,1,1,0,1,1,0.014222,4,0.275404,0.296091,0
槟城(1947),槟城,notion,0,1,1,0,1,1,0.017323,4,0.281723,0.306272,0
樊弘(1947),樊弘,notion,0,1,1,0,1,1,0.014081,4,0.275493,0.296238,0
樊笼(1947),樊笼,notion,0,1,1,0,1,1,0.014081,4,0.275493,0.296238,0
模范(1947),模范,notion,0,1,1,0,1,1,0.011229,4,0.270366,0.287632,0
横扫(1947),横扫,notion,0,1,1,0,1,1,0.011229,4,0.270366,0.287632,0
横死(1947),横死,notion,0,1,1,0,1,1,0.014222,4,0.275404,0.296091,0
横行(1947),横行,notion,0,1,1,0,1,1,0.013711,4,0.275027,0.295469,0
横行霸道(1947),横行霸道,notion,0,1,1,0,1,1,0.011229,4,0.270366,0.287632,0
横贯(1947),横贯,notion,0,1,1,0,1,1,0.007422,4,0.26356,0.275695,0
次序(1947),次序,notion,0,1,1,0,1,1,0.014732,4,0.276453,0.297813,0
次要(1947),次要,notion,0,1,1,0,1,1,0.014222,4,0.275404,0.296091,0
次长(1947),次长,notion,0,2,2,0,2,2,0.024542,4,0.292264,0.322335,1826.657886
欢呼(1947),欢呼,notion,0,1,1,0,2,2,0.014222,4,0.275404,0.296091,0
欢迎(1947),欢迎,notion,0,2,2,0,4,4,0.022072,4,0.287175,0.314755,862.424175
欢迎会(1947),欢迎会,notion,0,1,1,0,1,1,0.014222,4,0.275404,0.296091,0
欢迎批评(1947),欢迎批评,notion,0,1,1,0,1,1,0.013711,4,0.275027,0.295469,0
欢送(1947),欢送,notion,0,1,1,0,1,1,0.014732,4,0.276453,0.297813,0
欣赏(1947),欣赏,notion,0,3,3,0,3,3,0.038825,4,0.319841,0.359272,7360.255589
欧文(1947),欧文,notion,0,1,1,0,1,1,0.014222,4,0.275404,0.296091,0
欧洲联盟(1947),欧洲联盟,notion,0,1,1,0,1,1,0.014222,4,0.275404,0.296091,0
欧说(1947),欧说,notion,0,1,1,0,1,1,0.014222,4,0.275404,0.296091,0
欲明(1947),欲明,notion,0,1,1,0,1,1,0.003699,4,0.256009,0.261706,0
欲海(1947),欲海,notion,0,1,1,0,1,1,0.014732,4,0.276453,0.297813,0
欺人(1947),欺人,notion,0,1,1,0,1,1,0.00981,4,0.267191,0.28214,0
欺骗(1947),欺骗,notion,0,1,1,0,2,2,0.013711,4,0.275027,0.295469,0
款建(1947),款建,notion,0,1,1,0,1,1,0.011229,4,0.270366,0.287632,0
款项(1947),款项,notion,0,1,1,0,1,1,0.014732,4,0.276453,0.297813,0
歇斯(1947),歇斯,notion,0,1,1,0,1,1,0.017323,4,0.281723,0.306272,0
歌咏队(1947),歌咏队,notion,0,1,1,0,1,1,0.007422,4,0.26356,0.275695,0
歌唱(1947),歌唱,notion,0,2,2,0,2,2,0.025961,4,0.295759,0.327389,2231.848602
歌声(1947),歌声,notion,0,2,2,0,3,3,0.024745,4,0.295069,0.3264,2684.608967
歌谣(1947),歌谣,notion,0,2,2,0,2,2,0.018431,4,0.28119,0.30549,1040.874592
歌颂(1947),歌颂,notion,0,1,1,0,1,1,0.00981,4,0.267191,0.28214,0
正义(1947),正义,notion,0,2,2,0,2,2,0.023891,4,0.292014,0.321969,2116.906395
正义感(1947),正义感,notion,0,1,1,0,1,1,0.014081,4,0.275493,0.296238,0
正告(1947),正告,notion,0,3,3,0,3,3,0.041214,4,0.322074,0.361982,6317.925086
正在(1947),正在,notion,0,3,3,0,3,3,0.03149,4,0.304845,0.340047,4957.186847
正多(1947),正多,notion,0,1,1,0,1,1,0.017323,4,0.281723,0.306272,0
正式(1947),正式,notion,0,1,1,0,1,1,0.017323,4,0.281723,0.306272,0
正确(1947),正确,notion,0,2,2,0,3,3,0.02531,4,0.2954,0.326876,2496.768821
正统派(1947),正统派,notion,0,1,1,0,1,1,0.002092,4,0.25318,0.25625,0
正视(1947),正视,notion,0,2,2,0,4,4,0.022072,4,0.287175,0.314755,862.424175
正误(1947),正误,notion,0,1,1,0,1,1,0.014081,4,0.275493,0.296238,0
此事(1947),此事,notion,0,1,1,0,1,1,0.014081,4,0.275493,0.296238,0
此信(1947),此信,notion,0,1,1,0,1,1,0.014081,4,0.275493,0.296238,0
此时(1947),此时,notion,0,1,1,0,1,1,0.017323,4,0.281723,0.306272,0
此时此地(1947),此时此地,notion,0,1,1,0,1,1,0.011229,4,0.270366,0.287632,0
此来(1947),此来,notion,0,1,1,0,1,1,0.003588,4,0.255396,0.260534,0
此次(1947),此次,notion,0,1,1,0,1,1,0.014222,4,0.275404,0.296091,0
此起彼伏(1947),此起彼伏,notion,0,1,1,0,1,1,0.017323,4,0.281723,0.306272,0
步步高升(1947),步步高升,notion,0,1,1,0,1,1,0.003699,4,0.256009,0.261706,0
步骤(1947),步骤,notion,0,3,3,0,4,4,0.033561,4,0.304356,0.339388,3349.170174
武剧(1947),武剧,notion,0,2,2,0,2,2,0.028812,4,0.299917,0.333248,2025.61524
武力(1947),武力,notion,0,4,4,0,8,8,0.055575,4,0.347944,0.390899,12552.103043
武大(1947),武大,notion,0,3,3,0,4,4,0.040069,4,0.319541,0.358906,5776.792264
武岭(1947),武岭,notion,0,1,1,0,1,1,0.014081,4,0.275493,0.296238,0
武汉(1947),武汉,notion,0,2,2,0,5,5,0.027791,4,0.29968,0.332918,2405.290268
武汉大学(1947),武汉大学,notion,0,1,1,0,1,1,0.011229,4,0.270366,0.287632,0
武装(1947),武装,notion,0,2,2,0,4,4,0.023521,4,0.291018,0.320504,1911.402908
武装力量(1947),武装力量,notion,0,1,1,0,1,1,0.007422,4,0.26356,0.275695,0
武装部队(1947),武装部队,notion,0,1,1,0,1,1,0.013711,4,0.275027,0.295469,0
歧途(1947),歧途,notion,0,1,1,0,1,1,0.009035,4,0.265075,0.278404,0
死光(1947),死光,notion,0,1,1,0,1,1,0.009035,4,0.265075,0.278404,0
死刑(1947),死刑,notion,0,2,2,0,2,2,0.031404,4,0.30602,0.34156,2430.025091
死后(1947),死后,notion,0,1,1,0,1,1,0.009035,4,0.265075,0.278404,0
死灭(1947),死灭,notion,0,1,1,0,1,1,0.017323,4,0.281723,0.306272,0
死的(1947),死的,notion,0,1,1,0,1,1,0.013711,4,0.275027,0.295469,0
死者(1947),死者,notion,0,2,2,0,2,2,0.020265,4,0.284375,0.310471,1611.931322
死路(1947),死路,notion,0,2,2,0,2,2,0.028442,4,0.300022,0.333394,2187.730369
死路一条(1947),死路一条,notion,0,1,1,0,1,1,0.014732,4,0.276453,0.297813,0
死难(1947),死难,notion,0,2,2,0,2,2,0.027791,4,0.29968,0.332918,2405.290268
殉国(1947),殉国,notion,0,1,1,0,1,1,0.017323,4,0.281723,0.306272,0
殊勳(1947),殊勳,notion,0,1,1,0,1,1,0.014222,4,0.275404,0.296091,0
残冬(1947),残冬,notion,0,1,1,0,1,1,0.000869,4,0.251131,0.252222,0
残忍(1947),残忍,notion,0,1,1,0,1,1,0.013711,4,0.275027,0.295469,0
残暴(1947),残暴,notion,0,2,2,0,2,2,0.028302,4,0.298866,0.331783,1965.8222
残梦(1947),残梦,notion,0,1,1,0,1,1,0.014732,4,0.276453,0.297813,0
残酷(1947),残酷,notion,0,1,1,0,1,1,0.007422,4,0.26356,0.275695,0
殖民(1947),殖民,notion,0,1,1,0,1,1,0.00981,4,0.267191,0.28214,0
殖民地(1947),殖民地,notion,0,5,5,0,9,9,0.067316,4,0.371133,0.413408,20841.954844
殴打(1947),殴打,notion,0,1,1,0,1,1,0.017323,4,0.281723,0.306272,0
毁灭(1947),毁灭,notion,0,1,1,0,1,1,0.002092,4,0.25318,0.25625,0
毁谤(1947),毁谤,notion,0,1,1,0,1,1,0.00981,4,0.267191,0.28214,0
母亲(1947),母亲,notion,0,2,2,0,2,2,0.027133,4,0.29671,0.328744,1770.9936
母性(1947),母性,notion,0,1,1,0,1,1,0.00981,4,0.267191,0.28214,0
每日(1947),每日,notion,0,1,1,0,1,1,0.003588,4,0.255396,0.260534,0
每月(1947),每月,notion,0,1,1,0,1,1,0.014732,4,0.276453,0.297813,0
毒刺(1947),毒刺,notion,0,1,1,0,1,1,0.014081,4,0.275493,0.296238,0
毒贩(1947),毒贩,notion,0,1,1,0,1,1,0.004749,4,0.257108,0.263793,0
比乐(1947),比乐,notion,0,1,1,0,1,1,0.017323,4,0.281723,0.306272,0
比例(1947),比例,notion,0,1,1,0,1,1,0.014222,4,0.275404,0.296091,0
比赛(1947),比赛,notion,0,1,1,0,1,1,0.013711,4,0.275027,0.295469,0
比较(1947),比较,notion,0,2,2,0,2,2,0.01778,4,0.280866,0.304978,1353.416142
毕业会考(1947),毕业会考,notion,0,1,1,0,1,1,0.014732,4,0.276453,0.297813,0
毕业生(1947),毕业生,notion,0,2,2,0,3,3,0.031404,4,0.30602,0.34156,2430.025091
毕迦索(1947),毕迦索,notion,0,1,1,0,1,1,0.00981,4,0.267191,0.28214,0
毛房(1947),毛房,notion,0,1,1,0,1,1,0.014732,4,0.276453,0.297813,0
毛泽东(1947),毛泽东,notion,0,3,3,0,4,4,0.039162,4,0.318825,0.358027,6544.514107
毛泽东思想(1947),毛泽东思想,notion,0,1,1,0,1,1,0.013711,4,0.275027,0.295469,0
毛病(1947),毛病,notion,0,1,1,0,1,1,0.011229,4,0.270366,0.287632,0
氏责(1947),氏责,notion,0,1,1,0,1,1,0.014732,4,0.276453,0.297813,0
民主主义(1947),民主主义,notion,0,2,2,0,2,2,0.006841,4,0.259671,0.268651,284.374141
民主作风(1947),民主作风,notion,0,1,1,0,1,1,0.014732,4,0.276453,0.297813,0
民主党(1947),民主党,notion,0,1,1,0,1,1,0.017323,4,0.281723,0.306272,0
民主化(1947),民主化,notion,0,5,5,0,6,6,0.064471,4,0.360359,0.403337,17371.544246
民主同盟(1947),民主同盟,notion,0,3,3,0,6,6,0.04058,4,0.317727,0.356672,4950.672902
民主思想(1947),民主思想,notion,0,1,1,0,1,1,0.013711,4,0.275027,0.295469,0
民主派(1947),民主派,notion,0,1,1,0,1,1,0.017323,4,0.281723,0.306272,0
民主联盟(1947),民主联盟,notion,0,1,1,0,1,1,0.017323,4,0.281723,0.306272,0
民主自由(1947),民主自由,notion,0,2,2,0,7,7,0.016314,4,0.277757,0.299998,853.020505
民主运动(1947),民主运动,notion,0,4,4,0,5,5,0.016901,4,0.274563,0.294883,1780.234591
民主革命(1947),民主革命,notion,0,1,1,0,1,1,0.013711,4,0.275027,0.295469,0
民众(1947),民众,notion,0,1,1,0,1,1,0.007422,4,0.26356,0.275695,0
民六至民八(1947),民六至民八,notion,0,1,1,0,1,1,0.014732,4,0.276453,0.297813,0
民兵(1947),民兵,notion,0,1,1,0,1,1,0.013711,4,0.275027,0.295469,0
民变(1947),民变,notion,0,5,5,0,9,9,0.062787,4,0.360359,0.403337,19092.587312
民团(1947),民团,notion,0,1,1,0,1,1,0.014222,4,0.275404,0.296091,0
民心(1947),民心,notion,0,1,1,0,1,1,0.013711,4,0.275027,0.295469,0
民意(1947),民意,notion,0,5,5,0,7,7,0.05955,4,0.350444,0.393523,14530.400345
民意机关(1947),民意机关,notion,0,1,1,0,1,1,0.014081,4,0.275493,0.296238,0
民报(1947),民报,notion,0,1,1,0,1,1,0.017323,4,0.281723,0.306272,0
民教(1947),民教,notion,0,1,1,0,1,1,0.007422,4,0.26356,0.275695,0
民族运动(1947),民族运动,notion,0,1,1,0,1,1,0.017323,4,0.281723,0.306272,0
民权(1947),民权,notion,0,1,1,0,1,1,0.014081,4,0.275493,0.296238,0
民歌(1947),民歌,notion,0,1,1,0,1,1,0.014732,4,0.276453,0.297813,0
民治(1947),民治,notion,0,1,1,0,1,1,0.017323,4,0.281723,0.306272,0
民生(1947),民生,notion,0,1,1,0,2,2,0.014222,4,0.275404,0.296091,0
民盟二中全会(1947),民盟二中全会,notion,0,1,1,0,1,1,0.003588,4,0.255396,0.260534,0
民着(1947),民着,notion,0,1,1,0,1,1,0.014222,4,0.275404,0.296091,0
民社(1947),民社,notion,0,1,1,0,1,1,0.017323,4,0.281723,0.306272,0
民营(1947),民营,notion,0,1,1,0,1,1,0.014081,4,0.275493,0.296238,0
民营事业(1947),民营事业,notion,0,1,1,0,1,1,0.014081,4,0.275493,0.296238,0
民衆(1947),民衆,notion,0,1,1,0,1,1,0.014222,4,0.275404,0.296091,0
民谣(1947),民谣,notion,0,3,3,0,3,3,0.035782,4,0.31155,0.348872,4419.387238
民间(1947),民间,notion,0,1,1,0,1,1,0.009035,4,0.265075,0.278404,0
民食(1947),民食,notion,0,1,1,0,1,1,0.014081,4,0.275493,0.296238,0
气息(1947),气息,notion,0,1,1,0,1,1,0.014732,4,0.276453,0.297813,0
气氛(1947),气氛,notion,0,1,1,0,1,1,0.009035,4,0.265075,0.278404,0
水力发电站(1947),水力发电站,notion,0,1,1,0,1,1,0.00981,4,0.267191,0.28214,0
水喝(1947),水喝,notion,0,1,1,0,1,1,0.013711,4,0.275027,0.295469,0
水杉(1947),水杉,notion,0,1,1,0,1,1,0.014081,4,0.275493,0.296238,0
水浇错(1947),水浇错,notion,0,1,1,0,1,1,0.014732,4,0.276453,0.297813,0
水涨(1947),水涨,notion,0,1,1,0,1,1,0.014732,4,0.276453,0.297813,0
水深火热(1947),水深火热,notion,0,1,1,0,1,1,0.014732,4,0.276453,0.297813,0
水灾(1947),水灾,notion,0,3,3,0,4,4,0.029549,4,0.299759,0.333089,3726.134493
水车(1947),水车,notion,0,1,1,0,1,1,0.014732,4,0.276453,0.297813,0
水边(1947),水边,notion,0,1,1,0,1,1,0.011229,4,0.270366,0.287632,0
永久(1947),永久,notion,0,2,2,0,3,3,0.01781,4,0.279738,0.303183,818.538823
永嘉(1947),永嘉,notion,0,1,1,0,1,1,0.013711,4,0.275027,0.295469,0
永远(1947),永远,notion,0,5,5,0,7,7,0.067974,4,0.373611,0.415641,21922.410674
求学(1947),求学,notion,0,1,1,0,4,4,0.014222,4,0.275404,0.296091,0
求援(1947),求援,notion,0,1,1,0,1,1,0.013711,4,0.275027,0.295469,0
求生(1947),求生,notion,0,1,1,0,1,1,0.014081,4,0.275493,0.296238,0
求真(1947),求真,notion,0,1,1,0,1,1,0.017323,4,0.281723,0.306272,0
汇合(1947),汇合,notion,0,1,1,0,1,1,0.014732,4,0.276453,0.297813,0
汇率(1947),汇率,notion,0,2,2,0,2,2,0.01778,4,0.280866,0.304978,1353.416142
汉口(1947),汉口,notion,0,2,2,0,2,2,0.02494,4,0.292941,0.323324,1747.290038
汉城(1947),汉城,notion,0,2,2,0,2,2,0.031545,4,0.305336,0.340645,2219.908318
汉奸(1947),汉奸,notion,0,3,3,0,4,4,0.040183,4,0.320622,0.360224,6650.43838
汉朝(1947),汉朝,notion,0,1,1,0,1,1,0.017323,4,0.281723,0.306272,0
汉英(1947),汉英,notion,0,1,1,0,1,1,0.013711,4,0.275027,0.295469,0
汕头(1947),汕头,notion,0,2,2,0,2,2,0.014818,4,0.274563,0.294761,698.886811
江北(1947),江北,notion,0,1,1,0,1,1,0.011229,4,0.270366,0.287632,0
江屯(1947),江屯,notion,0,1,1,0,1,1,0.011229,4,0.270366,0.287632,0
江河(1947),江河,notion,0,1,1,0,1,1,0.002092,4,0.25318,0.25625,0
江流(1947),江流,notion,0,1,1,0,1,1,0.014222,4,0.275404,0.296091,0
江西(1947),江西,notion,0,1,1,0,1,1,0.014081,4,0.275493,0.296238,0
污吏(1947),污吏,notion,0,1,1,0,1,1,0.014081,4,0.275493,0.296238,0
污泥(1947),污泥,notion,0,1,1,0,1,1,0.011229,4,0.270366,0.287632,0
污辱(1947),污辱,notion,0,1,1,0,1,1,0.014222,4,0.275404,0.296091,0
汽车(1947),汽车,notion,0,1,1,0,2,2,0.014222,4,0.275404,0.296091,0
沈从文(1947),沈从文,notion,0,1,1,0,1,1,0.003699,4,0.256009,0.261706,0
沈兼士(1947),沈兼士,notion,0,1,1,0,1,1,0.014732,4,0.276453,0.297813,0
沈崇案(1947),沈崇案,notion,0,1,1,0,1,1,0.014081,4,0.275493,0.296238,0
沈曾(1947),沈曾,notion,0,1,1,0,1,1,0.014732,4,0.276453,0.297813,0
沈痛(1947),沈痛,notion,0,1,1,0,1,1,0.017323,4,0.281723,0.306272,0
沈钧儒(1947),沈钧儒,notion,0,1,1,0,1,1,0.003588,4,0.255396,0.260534,0
沈阳(1947),沈阳,notion,0,1,1,0,1,1,0.014732,4,0.276453,0.297813,0
沉寂(1947),沉寂,notion,0,1,1,0,1,1,0.011229,4,0.270366,0.287632,0
沉痛(1947),沉痛,notion,0,3,3,0,3,3,0.022048,4,0.284802,0.311191,1883.054836
沉着(1947),沉着,notion,0,2,2,0,2,2,0.027791,4,0.29968,0.332918,2405.290268
沉醉(1947),沉醉,notion,0,1,1,0,1,1,0.014081,4,0.275493,0.296238,0
沉默(1947),沉默,notion,0,1,1,0,1,1,0.014732,4,0.276453,0.297813,0
沙丁楼(1947),沙丁楼,notion,0,1,1,0,1,1,0.014732,4,0.276453,0.297813,0
沙堤(1947),沙堤,notion,0,1,1,0,1,1,0.013711,4,0.275027,0.295469,0
沙汀楼(1947),沙汀楼,notion,0,1,1,0,1,1,0.014732,4,0.276453,0.297813,0
没落(1947),没落,notion,0,3,3,0,3,3,0.014827,4,0.272502,0.29138,1757.861817
没衣(1947),没衣,notion,0,1,1,0,1,1,0.011229,4,0.270366,0.287632,0
沪市(1947),沪市,notion,0,2,2,0,2,2,0.020912,4,0.285589,0.312338,797.979389
沪江(1947),沪江,notion,0,1,1,0,1,1,0.013711,4,0.275027,0.295469,0
河内(1947),河内,notion,0,2,2,0,2,2,0.031034,4,0.30613,0.341707,2639.595687
河北(1947),河北,notion,0,1,1,0,1,1,0.014732,4,0.276453,0.297813,0
河南(1947),河南,notion,0,2,2,0,2,2,0.032055,4,0.30624,0.341853,2215.722594
河南大学(1947),河南大学,notion,0,1,1,0,1,1,0.013711,4,0.275027,0.295469,0
河大(1947),河大,notion,0,1,1,0,1,1,0.014081,4,0.275493,0.296238,0
河婆(1947),河婆,notion,0,1,1,0,1,1,0.011229,4,0.270366,0.287632,0
河底(1947),河底,notion,0,1,1,0,1,1,0.014081,4,0.275493,0.296238,0
河边(1947),河边,notion,0,1,1,0,1,1,0.014732,4,0.276453,0.297813,0
油农(1947),油农,notion,0,1,1,0,1,1,0.007422,4,0.26356,0.275695,0
油水(1947),油水,notion,0,1,1,0,1,1,0.014732,4,0.276453,0.297813,0
治下(1947),治下,notion,0,1,1,0,1,1,0.014732,4,0.276453,0.297813,0
治学(1947),治学,notion,0,1,1,0,1,1,0.014222,4,0.275404,0.296091,0
治安(1947),治安,notion,0,1,1,0,1,1,0.014732,4,0.276453,0.297813,0
治标(1947),治标,notion,0,1,1,0,1,1,0.014081,4,0.275493,0.296238,0
治民(1947),治民,notion,0,1,1,0,1,1,0.014732,4,0.276453,0.297813,0
治绩(1947),治绩,notion,0,1,1,0,1,1,0.011229,4,0.270366,0.287632,0
治虫(1947),治虫,notion,0,1,1,0,1,1,0.007422,4,0.26356,0.275695,0
沿路(1947),沿路,notion,0,1,1,0,1,1,0.017323,4,0.281723,0.306272,0
泉源(1947),泉源,notion,0,1,1,0,1,1,0.00981,4,0.267191,0.28214,0
法义(1947),法义,notion,0,2,2,0,2,2,0.024542,4,0.292264,0.322335,1826.657886
法令(1947),法令,notion,0,3,3,0,4,4,0.041355,4,0.320953,0.360627,5686.400693
法兰西(1947),法兰西,notion,0,3,3,0,8,8,0.032926,4,0.304301,0.339314,4558.531678
法利(1947),法利,notion,0,1,1,0,1,1,0.014732,4,0.276453,0.297813,0
法利赛(1947),法利赛,notion,0,1,1,0,1,1,0.014732,4,0.276453,0.297813,0
法制(1947),法制,notion,0,1,1,0,1,1,0.004749,4,0.257108,0.263793,0
法国共产党(1947),法国共产党,notion,0,2,2,0,3,3,0.018845,4,0.280243,0.303989,1083.402703
法律(1947),法律,notion,0,6,6,0,8,8,0.069729,4,0.366629,0.409331,21252.555448
法斯(1947),法斯,notion,0,1,1,0,1,1,0.007422,4,0.26356,0.275695,0
法案(1947),法案,notion,0,2,2,0,2,2,0.023521,4,0.291018,0.320504,1911.402908
法理(1947),法理,notion,0,1,1,0,1,1,0.014081,4,0.275493,0.296238,0
法西斯(1947),法西斯,notion,0,4,4,0,6,6,0.039342,4,0.314768,0.353035,6527.660337
法西斯主义(1947),法西斯主义,notion,0,2,2,0,3,3,0.027133,4,0.29671,0.328744,1770.9936
法西斯蒂(1947),法西斯蒂,notion,0,1,1,0,1,1,0.00981,4,0.267191,0.28214,0
法规(1947),法规,notion,0,1,1,0,1,1,0.014222,4,0.275404,0.296091,0
法越(1947),法越,notion,0,1,1,0,2,2,0.017323,4,0.281723,0.306272,0
泛滥(1947),泛滥,notion,0,1,1,0,1,1,0.017323,4,0.281723,0.306272,0
泛美(1947),泛美,notion,0,1,1,0,1,1,0.00981,4,0.267191,0.28214,0
泛美主义(1947),泛美主义,notion,0,1,1,0,2,2,0.00981,4,0.267191,0.28214,0
波兰(1947),波兰,notion,0,1,1,0,6,6,0.00981,4,0.267191,0.28214,0
波印(1947),波印,notion,0,1,1,0,1,1,0.017323,4,0.281723,0.306272,0
波浪(1947),波浪,notion,0,1,1,0,1,1,0.014081,4,0.275493,0.296238,0
波涛(1947),波涛,notion,0,1,1,0,1,1,0.009035,4,0.265075,0.278404,0
波茨坦(1947),波茨坦,notion,0,1,1,0,1,1,0.011229,4,0.270366,0.287632,0
泥淖(1947),泥淖,notion,0,1,1,0,1,1,0.013711,4,0.275027,0.295469,0
注意(1947),注意,notion,0,1,1,0,1,1,0.014732,4,0.276453,0.297813,0
注视(1947),注视,notion,0,1,1,0,1,1,0.011229,4,0.270366,0.287632,0
注音(1947),注音,notion,0,1,1,0,1,1,0.014222,4,0.275404,0.296091,0
泰戈尔(1947),泰戈尔,notion,0,1,1,0,1,1,0.014081,4,0.275493,0.296238,0
泰晤士报(1947),泰晤士报,notion,0,1,1,0,1,1,0.017323,4,0.281723,0.306272,0
洁泯(1947),洁泯,notion,0,1,1,0,1,1,0.003699,4,0.256009,0.261706,0
洁癖(1947),洁癖,notion,0,1,1,0,1,1,0.014732,4,0.276453,0.297813,0
洋婆(1947),洋婆,notion,0,1,1,0,1,1,0.014081,4,0.275493,0.296238,0
洋房(1947),洋房,notion,0,1,1,0,1,1,0.009035,4,0.265075,0.278404,0
洋船(1947),洋船,notion,0,1,1,0,1,1,0.014732,4,0.276453,0.297813,0
洋货(1947),洋货,notion,0,1,1,0,1,1,0.013711,4,0.275027,0.295469,0
洒下(1947),洒下,notion,0,1,1,0,1,1,0.014732,4,0.276453,0.297813,0
洗净(1947),洗净,notion,0,1,1,0,1,1,0.011229,4,0.270366,0.287632,0
洗劫(1947),洗劫,notion,0,1,1,0,1,1,0.011229,4,0.270366,0.287632,0
洗衣(1947),洗衣,notion,0,1,1,0,1,1,0.017323,4,0.281723,0.306272,0
洛吉倍(1947),洛吉倍,notion,0,1,1,0,1,1,0.009035,4,0.265075,0.278404,0
洛夫斯基(1947),洛夫斯基,notion,0,1,1,0,1,1,0.00981,4,0.267191,0.28214,0
洛斯(1947),洛斯,notion,0,1,1,0,1,1,0.00981,4,0.267191,0.28214,0
洪流(1947),洪流,notion,0,2,2,0,2,2,0.02531,4,0.2954,0.326876,2496.768821
洪门(1947),洪门,notion,0,1,1,0,1,1,0.017323,4,0.281723,0.306272,0
活下去(1947),活下去,notion,0,1,1,0,1,1,0.013711,4,0.275027,0.295469,0
活不下去(1947),活不下去,notion,0,2,2,0,3,3,0.02494,4,0.292941,0.323324,1747.290038
活剧(1947),活剧,notion,0,1,1,0,1,1,0.013711,4,0.275027,0.295469,0
活埋(1947),活埋,notion,0,1,1,0,1,1,0.014732,4,0.276453,0.297813,0
活生生(1947),活生生,notion,0,1,1,0,1,1,0.013711,4,0.275027,0.295469,0
活着(1947),活着,notion,0,2,2,0,2,2,0.023116,4,0.288412,0.316623,1358.22258
活跃(1947),活跃,notion,0,3,3,0,4,4,0.03475,4,0.309488,0.346199,5532.888574
派系(1947),派系,notion,0,1,1,0,1,1,0.014732,4,0.276453,0.297813,0
流亡(1947),流亡,notion,0,2,2,0,2,2,0.01948,4,0.281468,0.30593,668.20053
流动(1947),流动,notion,0,2,2,0,2,2,0.021502,4,0.288388,0.316586,2245.621531
流变(1947),流变,notion,0,1,1,0,1,1,0.014222,4,0.275404,0.296091,0
流星(1947),流星,notion,0,1,1,0,1,1,0.014081,4,0.275493,0.296238,0
流水帐(1947),流水帐,notion,0,1,1,0,1,1,0.007422,4,0.26356,0.275695,0
流浪(1947),流浪,notion,0,2,2,0,2,2,0.021132,4,0.288412,0.316623,2574.708611
流浪者(1947),流浪者,notion,0,1,1,0,1,1,0.00981,4,0.267191,0.28214,0
流血(1947),流血,notion,0,3,3,0,6,6,0.025208,4,0.29087,0.320346,2920.173389
流血政变(1947),流血政变,notion,0,1,1,0,1,1,0.017323,4,0.281723,0.306272,0
流行性(1947),流行性,notion,0,1,1,0,1,1,0.013711,4,0.275027,0.295469,0
浅谈(1947),浅谈,notion,0,1,1,0,1,1,0.011229,4,0.270366,0.287632,0
浅释(1947),浅释,notion,0,1,1,0,1,1,0.011229,4,0.270366,0.287632,0
浊流(1947),浊流,notion,0,1,1,0,1,1,0.003588,4,0.255396,0.260534,0
测验(1947),测验,notion,0,2,2,0,3,3,0.032055,4,0.30624,0.341853,2215.722594
济南(1947),济南,notion,0,3,3,0,4,4,0.037478,4,0.313669,0.351582,5215.620442
浓雾(1947),浓雾,notion,0,1,1,0,1,1,0.017323,4,0.281723,0.306272,0
浙东(1947),浙东,notion,0,2,2,0,2,2,0.018431,4,0.28119,0.30549,1040.874592
浙西(1947),浙西,notion,0,1,1,0,1,1,0.007422,4,0.26356,0.275695,0
浦斯(1947),浦斯,notion,0,1,1,0,2,2,0.017323,4,0.281723,0.306272,0
浩劫(1947),浩劫,notion,0,1,1,0,1,1,0.011229,4,0.270366,0.287632,0
浪子(1947),浪子,notion,0,1,1,0,1,1,0.014222,4,0.275404,0.296091,0
浪潮(1947),浪潮,notion,0,1,1,0,1,1,0.014732,4,0.276453,0.297813,0
浪费(1947),浪费,notion,0,1,1,0,1,1,0.014081,4,0.275493,0.296238,0
浮动(1947),浮动,notion,0,2,2,0,2,2,0.018829,4,0.280473,0.304355,655.354404
浮尸(1947),浮尸,notion,0,1,1,0,1,1,0.011229,4,0.270366,0.287632,0
浮沉(1947),浮沉,notion,0,1,1,0,1,1,0.013711,4,0.275027,0.295469,0
浮生六记(1947),浮生六记,notion,0,1,1,0,1,1,0.004749,4,0.257108,0.263793,0
浮雕(1947),浮雕,notion,0,1,1,0,1,1,0.00981,4,0.267191,0.28214,0
海上(1947),海上,notion,0,2,2,0,2,2,0.031545,4,0.305336,0.340645,2219.908318
海丰(1947),海丰,notion,0,1,1,0,1,1,0.011229,4,0.270366,0.287632,0
海关(1947),海关,notion,0,1,1,0,1,1,0.013711,4,0.275027,0.295469,0
海南岛(1947),海南岛,notion,0,2,2,0,2,2,0.028552,4,0.301506,0.335445,2588.539662
海外侨胞(1947),海外侨胞,notion,0,1,1,0,1,1,0.014222,4,0.275404,0.296091,0
海峡(1947),海峡,notion,0,1,1,0,1,1,0.00981,4,0.267191,0.28214,0
海洋(1947),海洋,notion,0,1,1,0,1,1,0.014732,4,0.276453,0.297813,0
海滨(1947),海滨,notion,0,1,1,0,1,1,0.014081,4,0.275493,0.296238,0
海礁(1947),海礁,notion,0,1,1,0,1,1,0.007422,4,0.26356,0.275695,0
海门(1947),海门,notion,0,1,1,0,2,2,0.014081,4,0.275493,0.296238,0
海防(1947),海防,notion,0,1,1,0,1,1,0.013711,4,0.275027,0.295469,0
消失(1947),消失,notion,0,1,1,0,1,1,0.007422,4,0.26356,0.275695,0
消弭(1947),消弭,notion,0,1,1,0,1,1,0.017323,4,0.281723,0.306272,0
消息(1947),消息,notion,0,3,3,0,4,4,0.045114,4,0.331456,0.372968,7474.911045
消息报(1947),消息报,notion,0,1,1,0,1,1,0.00981,4,0.267191,0.28214,0
消极(1947),消极,notion,0,1,1,0,1,1,0.014222,4,0.275404,0.296091,0
消灭(1947),消灭,notion,0,1,1,0,2,2,0.017323,4,0.281723,0.306272,0
消费(1947),消费,notion,0,2,2,0,2,2,0.017232,4,0.279944,0.303513,1791.004954
消费合作(1947),消费合作,notion,0,1,1,0,1,1,0.007422,4,0.26356,0.275695,0
消费者(1947),消费者,notion,0,1,1,0,1,1,0.014732,4,0.276453,0.297813,0
消除(1947),消除,notion,0,1,1,0,1,1,0.002092,4,0.25318,0.25625,0
涓涓(1947),涓涓,notion,0,1,1,0,1,1,0.002092,4,0.25318,0.25625,0
涨价(1947),涨价,notion,0,2,2,0,3,3,0.01948,4,0.281468,0.30593,668.20053
涨风(1947),涨风,notion,0,2,2,0,2,2,0.017299,4,0.278915,0.301865,688.562525
涵义(1947),涵义,notion,0,2,2,0,2,2,0.025451,4,0.295094,0.326437,2353.768712
淮阴(1947),淮阴,notion,0,1,1,0,1,1,0.003699,4,0.256009,0.261706,0
深入(1947),深入,notion,0,1,1,0,1,1,0.011229,4,0.270366,0.287632,0
深刻(1947),深刻,notion,0,1,1,0,1,1,0.007422,4,0.26356,0.275695,0
深恨(1947),深恨,notion,0,1,1,0,1,1,0.013711,4,0.275027,0.295469,0
深重(1947),深重,notion,0,1,1,0,1,1,0.011229,4,0.270366,0.287632,0
混乱(1947),混乱,notion,0,5,5,0,6,6,0.056886,4,0.351998,0.395098,19530.25534
混合经济(1947),混合经济,notion,0,1,1,0,1,1,0.014222,4,0.275404,0.296091,0
混同(1947),混同,notion,0,1,1,0,1,1,0.007422,4,0.26356,0.275695,0
混身(1947),混身,notion,0,1,1,0,1,1,0.014732,4,0.276453,0.297813,0
清一色(1947),清一色,notion,0,1,1,0,1,1,0.014732,4,0.276453,0.297813,0
清乡(1947),清乡,notion,0,1,1,0,1,1,0.011229,4,0.270366,0.287632,0
清儒(1947),清儒,notion,0,1,1,0,1,1,0.014222,4,0.275404,0.296091,0
清华大学(1947),清华大学,notion,0,2,2,0,2,2,0.028812,4,0.299917,0.333248,2025.61524
清明(1947),清明,notion,0,1,1,0,1,1,0.009035,4,0.265075,0.278404,0
清明节(1947),清明节,notion,0,1,1,0,1,1,0.014222,4,0.275404,0.296091,0
清流(1947),清流,notion,0,2,2,0,2,2,0.020912,4,0.285589,0.312338,797.979389
清理(1947),清理,notion,0,1,1,0,1,1,0.003699,4,0.256009,0.261706,0
清算(1947),清算,notion,0,2,2,0,2,2,0.014928,4,0.275516,0.296336,1118.339317
清远(1947),清远,notion,0,1,1,0,1,1,0.011229,4,0.270366,0.287632,0
清除(1947),清除,notion,0,1,1,0,1,1,0.011229,4,0.270366,0.287632,0
渐增(1947),渐增,notion,0,1,1,0,1,1,0.013711,4,0.275027,0.295469,0
渐愈(1947),渐愈,notion,0,1,1,0,1,1,0.017323,4,0.281723,0.306272,0
渔业(1947),渔业,notion,0,1,1,0,2,2,0.007422,4,0.26356,0.275695,0
渔区(1947),渔区,notion,0,1,1,0,1,1,0.007422,4,0.26356,0.275695,0
渔合(1947),渔合,notion,0,1,1,0,1,1,0.007422,4,0.26356,0.275695,0
渔夫(1947),渔夫,notion,0,1,1,0,1,1,0.00981,4,0.267191,0.28214,0
渔村(1947),渔村,notion,0,1,1,0,1,1,0.007422,4,0.26356,0.275695,0
渔民(1947),渔民,notion,0,1,1,0,2,2,0.013711,4,0.275027,0.295469,0
渔贷(1947),渔贷,notion,0,1,1,0,1,1,0.007422,4,0.26356,0.275695,0
渡海(1947),渡海,notion,0,1,1,0,1,1,0.007422,4,0.26356,0.275695,0
渡过(1947),渡过,notion,0,1,1,0,1,1,0.014732,4,0.276453,0.297813,0
渡过难关(1947),渡过难关,notion,0,1,1,0,1,1,0.014222,4,0.275404,0.296091,0
温床(1947),温床,notion,0,1,1,0,1,1,0.007422,4,0.26356,0.275695,0
温热(1947),温热,notion,0,1,1,0,1,1,0.014222,4,0.275404,0.296091,0
渴望(1947),渴望,notion,0,1,1,0,1,1,0.013711,4,0.275027,0.295469,0
游击(1947),游击,notion,0,1,1,0,1,1,0.017323,4,0.281723,0.306272,0
游击队(1947),游击队,notion,0,1,1,0,1,1,0.007422,4,0.26356,0.275695,0
游历(1947),游历,notion,0,1,1,0,1,1,0.014081,4,0.275493,0.296238,0
游民(1947),游民,notion,0,1,1,0,1,1,0.003699,4,0.256009,0.261706,0
游行(1947),游行,notion,0,2,2,0,2,2,0.007287,4,0.260642,0.270446,333.435821
游行示威(1947),游行示威,notion,0,1,1,0,1,1,0.014732,4,0.276453,0.297813,0
湖南人(1947),湖南人,notion,0,1,1,0,1,1,0.009035,4,0.265075,0.278404,0
湖南省政府(1947),湖南省政府,notion,0,1,1,0,1,1,0.014081,4,0.275493,0.296238,0
湘江(1947),湘江,notion,0,1,1,0,1,1,0.014081,4,0.275493,0.296238,0
湛江(1947),湛江,notion,0,1,1,0,2,2,0.011229,4,0.270366,0.287632,0
溃烂(1947),溃烂,notion,0,1,1,0,1,1,0.014081,4,0.275493,0.296238,0
溃败(1947),溃败,notion,0,1,1,0,1,1,0.011229,4,0.270366,0.287632,0
源泉(1947),源泉,notion,0,2,2,0,3,3,0.00829,4,0.264356,0.277184,414.958707
源源本本(1947),源源本本,notion,0,1,1,0,1,1,0.014081,4,0.275493,0.296238,0
滇西(1947),滇西,notion,0,2,2,0,2,2,0.022746,4,0.288631,0.316952,1575.703869
滇谣(1947),滇谣,notion,0,1,1,0,1,1,0.014081,4,0.275493,0.296238,0
滑头(1947),滑头,notion,0,1,1,0,1,1,0.013711,4,0.275027,0.295469,0
滑稽剧(1947),滑稽剧,notion,0,1,1,0,1,1,0.013711,4,0.275027,0.295469,0
滔天大罪(1947),滔天大罪,notion,0,1,1,0,1,1,0.013711,4,0.275027,0.295469,0
满城风雨(1947),满城风雨,notion,0,1,1,0,1,1,0.017323,4,0.281723,0.306272,0
满树(1947),满树,notion,0,1,1,0,1,1,0.011229,4,0.270366,0.287632,0
满门抄斩(1947),满门抄斩,notion,0,1,1,0,1,1,0.013711,4,0.275027,0.295469,0
漆黑(1947),漆黑,notion,0,1,1,0,1,1,0.014081,4,0.275493,0.296238,0
漏掉(1947),漏掉,notion,0,1,1,0,1,1,0.014732,4,0.276453,0.297813,0
漏题(1947),漏题,notion,0,1,1,0,1,1,0.014081,4,0.275493,0.296238,0
演义(1947),演义,notion,0,1,1,0,1,1,0.011229,4,0.270366,0.287632,0
演习(1947),演习,notion,0,1,1,0,1,1,0.013711,4,0.275027,0.295469,0
演出(1947),演出,notion,0,2,2,0,5,5,0.025961,4,0.295759,0.327389,2231.848602
演奏会(1947),演奏会,notion,0,1,1,0,1,1,0.014732,4,0.276453,0.297813,0
演讲(1947),演讲,notion,0,4,4,0,6,6,0.044943,4,0.324987,0.365522,7959.287529
漫图(1947),漫图,notion,0,1,1,0,1,1,0.004749,4,0.257108,0.263793,0
漫天(1947),漫天,notion,0,1,1,0,2,2,0.017323,4,0.281723,0.306272,0
漫谭(1947),漫谭,notion,0,1,1,0,1,1,0.014732,4,0.276453,0.297813,0
潘光旦(1947),潘光旦,notion,0,1,1,0,2,2,0.014081,4,0.275493,0.296238,0
潜势力(1947),潜势力,notion,0,1,1,0,1,1,0.009035,4,0.265075,0.278404,0
潮是(1947),潮是,notion,0,1,1,0,1,1,0.014732,4,0.276453,0.297813,0
潮汐(1947),潮汐,notion,0,1,1,0,1,1,0.017323,4,0.281723,0.306272,0
潮汕(1947),潮汕,notion,0,1,1,0,1,1,0.011229,4,0.270366,0.287632,0
潮流(1947),潮流,notion,0,2,2,0,2,2,0.014559,4,0.273463,0.29293,775.374504
澈底(1947),澈底,notion,0,2,2,0,2,2,0.022746,4,0.288631,0.316952,1575.703869
澳大利亚(1947),澳大利亚,notion,0,1,1,0,1,1,0.00981,4,0.267191,0.28214,0
激起(1947),激起,notion,0,1,1,0,1,1,0.009035,4,0.265075,0.278404,0
激辩(1947),激辩,notion,0,1,1,0,1,1,0.009035,4,0.265075,0.278404,0
灌溉(1947),灌溉,notion,0,1,1,0,1,1,0.014732,4,0.276453,0.297813,0
火山(1947),火山,notion,0,1,1,0,2,2,0.013711,4,0.275027,0.295469,0
火并(1947),火并,notion,0,1,1,0,1,1,0.014732,4,0.276453,0.297813,0
火急(1947),火急,notion,0,1,1,0,1,1,0.014081,4,0.275493,0.296238,0
火柴厂(1947),火柴厂,notion,0,1,1,0,1,1,0.011229,4,0.270366,0.287632,0
火点(1947),火点,notion,0,1,1,0,1,1,0.014732,4,0.276453,0.297813,0
火焰(1947),火焰,notion,0,1,1,0,1,1,0.00981,4,0.267191,0.28214,0
火燃遍(1947),火燃遍,notion,0,1,1,0,1,1,0.014732,4,0.276453,0.297813,0
火种(1947),火种,notion,0,1,1,0,1,1,0.011229,4,0.270366,0.287632,0
火线(1947),火线,notion,0,1,1,0,1,1,0.011229,4,0.270366,0.287632,0
火花(1947),火花,notion,0,1,1,0,2,2,0.013711,4,0.275027,0.295469,0
火车(1947),火车,notion,0,1,1,0,1,1,0.014081,4,0.275493,0.296238,0
灯街(1947),灯街,notion,0,1,1,0,1,1,0.011229,4,0.270366,0.287632,0
灰姑娘(1947),灰姑娘,notion,0,1,1,0,1,1,0.00981,4,0.267191,0.28214,0
灰尘(1947),灰尘,notion,0,1,1,0,1,1,0.014081,4,0.275493,0.296238,0
灵宝(1947),灵宝,notion,0,1,1,0,1,1,0.007422,4,0.26356,0.275695,0
灵山(1947),灵山,notion,0,1,1,0,1,1,0.011229,4,0.270366,0.287632,0
灵魂(1947),灵魂,notion,0,1,1,0,1,1,0.004749,4,0.257108,0.263793,0
灾情(1947),灾情,notion,0,2,2,0,2,2,0.027791,4,0.29968,0.332918,2405.290268
灾祸(1947),灾祸,notion,0,1,1,0,1,1,0.011229,4,0.270366,0.287632,0
灾难(1947),灾难,notion,0,4,4,0,9,9,0.056485,4,0.35247,0.395513,13992.557774
炸弹(1947),炸弹,notion,0,1,1,0,1,1,0.013711,4,0.275027,0.295469,0
点滴(1947),点滴,notion,0,1,1,0,1,1,0.014081,4,0.275493,0.296238,0
点点滴滴(1947),点点滴滴,notion,0,1,1,0,10,10,0.007422,4,0.26356,0.275695,0
点金术(1947),点金术,notion,0,1,1,0,1,1,0.014732,4,0.276453,0.297813,0
炼锁(1947),炼锁,notion,0,1,1,0,1,1,0.00981,4,0.267191,0.28214,0
烂污(1947),烂污,notion,0,1,1,0,1,1,0.003699,4,0.256009,0.261706,0
烈士(1947),烈士,notion,0,3,3,0,6,6,0.042263,4,0.32539,0.365937,6975.425387
烟台(1947),烟台,notion,0,1,1,0,2,2,0.013711,4,0.275027,0.295469,0
烟幕(1947),烟幕,notion,0,1,1,0,1,1,0.013711,4,0.275027,0.295469,0
烟霭(1947),烟霭,notion,0,1,1,0,1,1,0.017323,4,0.281723,0.306272,0
烦恼(1947),烦恼,notion,0,3,3,0,3,3,0.033561,4,0.304356,0.339388,3349.170174
热潮(1947),热潮,notion,0,2,2,0,4,4,0.02494,4,0.292941,0.323324,1747.290038
热烈(1947),热烈,notion,0,1,1,0,1,1,0.011229,4,0.270366,0.287632,0
热爱(1947),热爱,notion,0,1,1,0,1,1,0.007422,4,0.26356,0.275695,0
热病(1947),热病,notion,0,1,1,0,1,1,0.003588,4,0.255396,0.260534,0
烽烟(1947),烽烟,notion,0,2,2,0,2,2,0.023257,4,0.28761,0.315414,1169.271875
焦点(1947),焦点,notion,0,1,1,0,1,1,0.017323,4,0.281723,0.306272,0
焦煤(1947),焦煤,notion,0,1,1,0,1,1,0.014081,4,0.275493,0.296238,0
焦虑(1947),焦虑,notion,0,1,1,0,1,1,0.014081,4,0.275493,0.296238,0
煤矿工人(1947),煤矿工人,notion,0,1,1,0,1,1,0.013711,4,0.275027,0.295469,0
煤荒(1947),煤荒,notion,0,1,1,0,1,1,0.013711,4,0.275027,0.295469,0
照办(1947),照办,notion,0,1,1,0,1,1,0.011229,4,0.270366,0.287632,0
照明灯(1947),照明灯,notion,0,1,1,0,1,1,0.014222,4,0.275404,0.296091,0
照登(1947),照登,notion,0,1,1,0,1,1,0.013711,4,0.275027,0.295469,0
煽动(1947),煽动,notion,0,1,1,0,1,1,0.014732,4,0.276453,0.297813,0
熊伟(1947),熊伟,notion,0,1,1,0,1,1,0.014732,4,0.276453,0.297813,0
燃起(1947),燃起,notion,0,1,1,0,1,1,0.014222,4,0.275404,0.296091,0
燎原(1947),燎原,notion,0,1,1,0,1,1,0.002092,4,0.25318,0.25625,0
燎火(1947),燎火,notion,0,1,1,0,1,1,0.00981,4,0.267191,0.28214,0
燕京(1947),燕京,notion,0,1,1,0,2,2,0.013711,4,0.275027,0.295469,0
爆发(1947),爆发,notion,0,1,1,0,1,1,0.017323,4,0.281723,0.306272,0
爆炸(1947),爆炸,notion,0,1,1,0,1,1,0.011229,4,0.270366,0.287632,0
爱与死(1947),爱与死,notion,0,1,1,0,1,1,0.014081,4,0.275493,0.296238,0
爱伦堡(1947),爱伦堡,notion,0,1,1,0,1,1,0.00981,4,0.267191,0.28214,0
爱国(1947),爱国,notion,0,4,4,0,8,8,0.032227,4,0.301799,0.33597,5784.994949
爱国主义(1947),爱国主义,notion,0,1,1,0,1,1,0.009035,4,0.265075,0.278404,0
爱国运动(1947),爱国运动,notion,0,1,1,0,1,1,0.013711,4,0.275027,0.295469,0
爱好(1947),爱好,notion,0,1,1,0,3,3,0.014222,4,0.275404,0.296091,0
爱好文学(1947),爱好文学,notion,0,1,1,0,1,1,0.014222,4,0.275404,0.296091,0
爱好音乐(1947),爱好音乐,notion,0,1,1,0,1,1,0.014222,4,0.275404,0.296091,0
爱情(1947),爱情,notion,0,1,1,0,1,1,0.014081,4,0.275493,0.296238,0
爱惜(1947),爱惜,notion,0,1,1,0,1,1,0.014081,4,0.275493,0.296238,0
爱护(1947),爱护,notion,0,2,2,0,2,2,0.032055,4,0.30624,0.341853,2215.722594
爱沙尼亚(1947),爱沙尼亚,notion,0,1,1,0,1,1,0.00981,4,0.267191,0.28214,0
爱用(1947),爱用,notion,0,1,1,0,1,1,0.013711,4,0.275027,0.295469,0
爱莲(1947),爱莲,notion,0,1,1,0,1,1,0.014732,4,0.276453,0.297813,0
爲何(1947),爲何,notion,0,1,1,0,2,2,0.014081,4,0.275493,0.296238,0
父亲(1947),父亲,notion,0,1,1,0,1,1,0.014732,4,0.276453,0.297813,0
父女(1947),父女,notion,0,1,1,0,1,1,0.017323,4,0.281723,0.306272,0
父母(1947),父母,notion,0,1,1,0,1,1,0.014081,4,0.275493,0.296238,0
爸爸(1947),爸爸,notion,0,1,1,0,1,1,0.013711,4,0.275027,0.295469,0
片山(1947),片山,notion,0,2,2,0,2,2,0.027133,4,0.29671,0.328744,1770.9936
版画(1947),版画,notion,0,1,1,0,1,1,0.014732,4,0.276453,0.297813,0
牙齿(1947),牙齿,notion,0,1,1,0,1,1,0.014732,4,0.276453,0.297813,0
牛头不对马嘴(1947),牛头不对马嘴,notion,0,1,1,0,1,1,0.014732,4,0.276453,0.297813,0
牛泰真(1947),牛泰真,notion,0,1,1,0,1,1,0.017323,4,0.281723,0.306272,0
牛马生活(1947),牛马生活,notion,0,1,1,0,1,1,0.011229,4,0.270366,0.287632,0
牢门(1947),牢门,notion,0,1,1,0,1,1,0.013711,4,0.275027,0.295469,0
物价飞涨(1947),物价飞涨,notion,0,1,1,0,1,1,0.013711,4,0.275027,0.295469,0
物理(1947),物理,notion,0,1,1,0,1,1,0.014081,4,0.275493,0.296238,0
物质基础(1947),物质基础,notion,0,1,1,0,1,1,0.014732,4,0.276453,0.297813,0
特使(1947),特使,notion,0,1,1,0,1,1,0.004749,4,0.257108,0.263793,0
特写(1947),特写,notion,0,2,2,0,2,2,0.025451,4,0.295094,0.326437,2353.768712
特刊(1947),特刊,notion,0,1,1,0,6,6,0.014222,4,0.275404,0.296091,0
特务(1947),特务,notion,0,2,2,0,4,4,0.02494,4,0.292941,0.323324,1747.290038
特客(1947),特客,notion,0,1,1,0,1,1,0.017323,4,0.281723,0.306272,0
特征(1947),特征,notion,0,1,1,0,1,1,0.014732,4,0.276453,0.297813,0
特捐(1947),特捐,notion,0,1,1,0,1,1,0.014222,4,0.275404,0.296091,0
特曼(1947),特曼,notion,0,1,1,0,1,1,0.004749,4,0.257108,0.263793,0
特权(1947),特权,notion,0,1,1,0,1,1,0.014222,4,0.275404,0.296091,0
特殊(1947),特殊,notion,0,2,2,0,2,2,0.023767,4,0.289685,0.318527,1452.186204
特殊性(1947),特殊性,notion,0,1,1,0,1,1,0.017323,4,0.281723,0.306272,0
特港(1947),特港,notion,0,1,1,0,1,1,0.017323,4,0.281723,0.306272,0
特爲(1947),特爲,notion,0,1,1,0,1,1,0.013711,4,0.275027,0.295469,0
特种(1947),特种,notion,0,1,1,0,1,1,0.009035,4,0.265075,0.278404,0
特稿(1947),特稿,notion,0,1,1,0,3,3,0.014222,4,0.275404,0.296091,0
特约(1947),特约,notion,0,3,3,0,11,11,0.041865,4,0.321892,0.361762,5813.37408
特约记者(1947),特约记者,notion,0,1,1,0,1,1,0.014081,4,0.275493,0.296238,0
特色(1947),特色,notion,0,1,1,0,1,1,0.00981,4,0.267191,0.28214,0
特质(1947),特质,notion,0,1,1,0,1,1,0.007422,4,0.26356,0.275695,0
牺牲(1947),牺牲,notion,0,1,1,0,1,1,0.00981,4,0.267191,0.28214,0
犯人(1947),犯人,notion,0,1,1,0,1,1,0.014081,4,0.275493,0.296238,0
犯法(1947),犯法,notion,0,1,1,0,1,1,0.014081,4,0.275493,0.296238,0
状况(1947),状况,notion,0,1,1,0,2,2,0.00981,4,0.267191,0.28214,0
状态(1947),状态,notion,0,2,2,0,2,2,0.032055,4,0.30624,0.341853,2215.722594
犹炽(1947),犹炽,notion,0,1,1,0,1,1,0.017323,4,0.281723,0.306272,0
狂想曲(1947),狂想曲,notion,0,2,2,0,3,3,0.01948,4,0.281468,0.30593,668.20053
狂涨(1947),狂涨,notion,0,2,2,0,2,2,0.023767,4,0.289685,0.318527,1452.186204
狂潮(1947),狂潮,notion,0,1,1,0,1,1,0.014222,4,0.275404,0.296091,0
狂风暴雨(1947),狂风暴雨,notion,0,2,2,0,2,2,0.026359,4,0.294788,0.325997,1561.492709
狂飙(1947),狂飙,notion,0,1,1,0,1,1,0.002092,4,0.25318,0.25625,0
狄斯耐(1947),狄斯耐,notion,0,1,1,0,1,1,0.014732,4,0.276453,0.297813,0
狐狸尾巴(1947),狐狸尾巴,notion,0,1,1,0,1,1,0.014222,4,0.275404,0.296091,0
狗急跳墙(1947),狗急跳墙,notion,0,1,1,0,1,1,0.013711,4,0.275027,0.295469,0
狗逾千(1947),狗逾千,notion,0,1,1,0,1,1,0.014732,4,0.276453,0.297813,0
狡辩(1947),狡辩,notion,0,1,1,0,1,1,0.017323,4,0.281723,0.306272,0
独占(1947),独占,notion,0,1,1,0,2,2,0.00981,4,0.267191,0.28214,0
独夫(1947),独夫,notion,0,1,1,0,1,1,0.013711,4,0.275027,0.295469,0
独幕剧(1947),独幕剧,notion,0,1,1,0,2,2,0.013711,4,0.275027,0.295469,0
独眼(1947),独眼,notion,0,1,1,0,1,1,0.014222,4,0.275404,0.296091,0
独立(1947),独立,notion,0,7,7,0,19,19,0.079411,4,0.39121,0.430814,28540.575695
独立自主(1947),独立自主,notion,0,1,1,0,1,1,0.014222,4,0.275404,0.296091,0
独裁(1947),独裁,notion,0,2,2,0,4,4,0.020912,4,0.285589,0.312338,797.979389
独裁者(1947),独裁者,notion,0,2,2,0,2,2,0.017299,4,0.278915,0.301865,688.562525
狮爪录(1947),狮爪录,notion,0,1,1,0,1,1,0.014732,4,0.276453,0.297813,0
狼犬(1947),狼犬,notion,0,1,1,0,1,1,0.014732,4,0.276453,0.297813,0
狼群(1947),狼群,notion,0,2,2,0,2,2,0.025961,4,0.295759,0.327389,2231.848602
猎奇(1947),猎奇,notion,0,2,2,0,3,3,0.015978,4,0.276542,0.29802,897.171983
猖獗(1947),猖獗,notion,0,1,1,0,1,1,0.014222,4,0.275404,0.296091,0
猛战(1947),猛战,notion,0,1,1,0,1,1,0.013711,4,0.275027,0.295469,0
猜不透(1947),猜不透,notion,0,1,1,0,2,2,0.014081,4,0.275493,0.296238,0
猪羊(1947),猪羊,notion,0,1,1,0,1,1,0.013711,4,0.275027,0.295469,0
献词(1947),献词,notion,0,1,1,0,1,1,0.014222,4,0.275404,0.296091,0
猿啸(1947),猿啸,notion,0,1,1,0,1,1,0.009035,4,0.265075,0.278404,0
王凤喜(1947),王凤喜,notion,0,1,1,0,1,1,0.013711,4,0.275027,0.295469,0
王国(1947),王国,notion,0,1,1,0,1,1,0.013711,4,0.275027,0.295469,0
王朝(1947),王朝,notion,0,1,1,0,1,1,0.014222,4,0.275404,0.296091,0
王桂英(1947),王桂英,notion,0,1,1,0,1,1,0.011229,4,0.270366,0.287632,0
王牌(1947),王牌,notion,0,1,1,0,1,1,0.00981,4,0.267191,0.28214,0
王艮仲(1947),王艮仲,notion,0,1,1,0,1,1,0.007422,4,0.26356,0.275695,0
王震(1947),王震,notion,0,1,1,0,1,1,0.013711,4,0.275027,0.295469,0
王震将军(1947),王震将军,notion,0,1,1,0,1,1,0.013711,4,0.275027,0.295469,0
玩法(1947),玩法,notion,0,1,1,0,1,1,0.014732,4,0.276453,0.297813,0
玩火(1947),玩火,notion,0,1,1,0,1,1,0.00981,4,0.267191,0.28214,0
玩笑(1947),玩笑,notion,0,1,1,0,1,1,0.013711,4,0.275027,0.295469,0
环境(1947),环境,notion,0,1,1,0,1,1,0.014732,4,0.276453,0.297813,0
现在(1947),现在,notion,0,4,4,0,4,4,0.056855,4,0.352835,0.395879,14054.832805
现实(1947),现实,notion,0,4,4,0,4,4,0.025938,4,0.292389,0.32264,6261.265122
现实主义(1947),现实主义,notion,0,1,1,0,1,1,0.017323,4,0.281723,0.306272,0
现实意义(1947),现实意义,notion,0,1,1,0,1,1,0.011229,4,0.270366,0.287632,0
现形(1947),现形,notion,0,1,1,0,1,1,0.011229,4,0.270366,0.287632,0
现形记(1947),现形记,notion,0,1,1,0,1,1,0.017323,4,0.281723,0.306272,0
现状(1947),现状,notion,0,3,3,0,7,7,0.046135,4,0.331006,0.372455,6671.362925
现象(1947),现象,notion,0,1,1,0,2,2,0.014732,4,0.276453,0.297813,0
现阶段(1947),现阶段,notion,0,5,5,0,9,9,0.037869,4,0.309124,0.345845,5597.547704
珍珠港(1947),珍珠港,notion,0,2,2,0,2,2,0.031034,4,0.30613,0.341707,2639.595687
珍视(1947),珍视,notion,0,1,1,0,1,1,0.014222,4,0.275404,0.296091,0
珍贵(1947),珍贵,notion,0,1,1,0,1,1,0.011229,4,0.270366,0.287632,0
珞珈山(1947),珞珈山,notion,0,1,1,0,1,1,0.011229,4,0.270366,0.287632,0
珠江(1947),珠江,notion,0,1,1,0,1,1,0.013711,4,0.275027,0.295469,0
珠江三角洲(1947),珠江三角洲,notion,0,1,1,0,1,1,0.011229,4,0.270366,0.287632,0
班班(1947),班班,notion,0,1,1,0,1,1,0.017323,4,0.281723,0.306272,0
班长(1947),班长,notion,0,1,1,0,1,1,0.014732,4,0.276453,0.297813,0
理事(1947),理事,notion,0,1,1,0,1,1,0.009035,4,0.265075,0.278404,0
理性(1947),理性,notion,0,1,1,0,1,1,0.000578,4,0.250633,0.251233,0
理想(1947),理想,notion,0,3,3,0,8,8,0.035354,4,0.312692,0.350337,6765.831022
理由(1947),理由,notion,0,2,2,0,2,2,0.031545,4,0.305336,0.340645,2219.908318
理论(1947),理论,notion,0,1,1,0,2,2,0.014732,4,0.276453,0.297813,0
理论体系(1947),理论体系,notion,0,1,1,0,1,1,0.004749,4,0.257108,0.263793,0
琉球(1947),琉球,notion,0,2,2,0,3,3,0.031404,4,0.30602,0.34156,2430.025091
琐事(1947),琐事,notion,0,1,1,0,1,1,0.014732,4,0.276453,0.297813,0
琐记(1947),琐记,notion,0,1,1,0,1,1,0.014732,4,0.276453,0.297813,0
琐闻(1947),琐闻,notion,0,1,1,0,1,1,0.014081,4,0.275493,0.296238,0
瑞士(1947),瑞士,notion,0,2,2,0,2,2,0.018845,4,0.280243,0.303989,1083.402703
瓦尔(1947),瓦尔,notion,0,1,1,0,1,1,0.017323,4,0.281723,0.306272,0
甘苦谈(1947),甘苦谈,notion,0,1,1,0,1,1,0.007422,4,0.26356,0.275695,0
甘露(1947),甘露,notion,0,1,1,0,1,1,0.014732,4,0.276453,0.297813,0
甚多(1947),甚多,notion,0,1,1,0,1,1,0.014732,4,0.276453,0.297813,0
生产(1947),生产,notion,0,2,2,0,3,3,0.021502,4,0.288388,0.316586,2245.621531
生出(1947),生出,notion,0,1,1,0,1,1,0.00981,4,0.267191,0.28214,0
生命(1947),生命,notion,0,2,2,0,2,2,0.01741,4,0.280151,0.303843,1198.480437
生在(1947),生在,notion,0,1,1,0,1,1,0.014081,4,0.275493,0.296238,0
生威(1947),生威,notion,0,1,1,0,1,1,0.014732,4,0.276453,0.297813,0
生意人(1947),生意人,notion,0,1,1,0,1,1,0.00981,4,0.267191,0.28214,0
生效(1947),生效,notion,0,1,1,0,1,1,0.009035,4,0.265075,0.278404,0
生日(1947),生日,notion,0,1,1,0,1,1,0.017323,4,0.281723,0.306272,0
生根(1947),生根,notion,0,1,1,0,1,1,0.014732,4,0.276453,0.297813,0
生死(1947),生死,notion,0,1,1,0,1,1,0.013711,4,0.275027,0.295469,0
生活观念(1947),生活观念,notion,0,1,1,0,1,1,0.002092,4,0.25318,0.25625,0
生涯(1947),生涯,notion,0,1,1,0,1,1,0.014732,4,0.276453,0.297813,0
生物(1947),生物,notion,0,1,1,0,1,1,0.017323,4,0.281723,0.306272,0
生物学(1947),生物学,notion,0,1,1,0,1,1,0.014081,4,0.275493,0.296238,0
生疏(1947),生疏,notion,0,1,1,0,1,1,0.014732,4,0.276453,0.297813,0
生铁(1947),生铁,notion,0,1,1,0,1,1,0.014081,4,0.275493,0.296238,0
生长(1947),生长,notion,0,1,1,0,4,4,0.007422,4,0.26356,0.275695,0
用品(1947),用品,notion,0,1,1,0,1,1,0.007422,4,0.26356,0.275695,0
用意(1947),用意,notion,0,2,2,0,2,2,0.018829,4,0.280473,0.304355,655.354404
用纸(1947),用纸,notion,0,1,1,0,1,1,0.014081,4,0.275493,0.296238,0
用途(1947),用途,notion,0,1,1,0,1,1,0.00981,4,0.267191,0.28214,0
由北向南(1947),由北向南,notion,0,1,1,0,1,1,0.011229,4,0.270366,0.287632,0
由来(1947),由来,notion,0,2,2,0,2,2,0.028954,4,0.300154,0.333577,2064.821066
由衡(1947),由衡,notion,0,1,1,0,1,1,0.003588,4,0.255396,0.260534,0
甲胄(1947),甲胄,notion,0,1,1,0,1,1,0.013711,4,0.275027,0.295469,0
申明(1947),申明,notion,0,1,1,0,1,1,0.003588,4,0.255396,0.260534,0
申辩(1947),申辩,notion,0,1,1,0,1,1,0.014732,4,0.276453,0.297813,0
电力(1947),电力,notion,0,1,1,0,1,1,0.017323,4,0.281723,0.306272,0
电工(1947),电工,notion,0,1,1,0,1,1,0.013711,4,0.275027,0.295469,0
电影(1947),电影,notion,0,4,4,0,5,5,0.049976,4,0.33609,0.378229,10141.517331
电影剧本(1947),电影剧本,notion,0,2,2,0,2,2,0.024542,4,0.292264,0.322335,1826.657886
电白(1947),电白,notion,0,1,1,0,1,1,0.011229,4,0.270366,0.287632,0
电美(1947),电美,notion,0,1,1,0,1,1,0.017323,4,0.281723,0.306272,0
电话网(1947),电话网,notion,0,1,1,0,1,1,0.007422,4,0.26356,0.275695,0
电车(1947),电车,notion,0,1,1,0,1,1,0.013711,4,0.275027,0.295469,0
男女(1947),男女,notion,0,3,3,0,4,4,0.033702,4,0.304763,0.339937,3390.232489
画像(1947),画像,notion,0,1,1,0,1,1,0.00981,4,0.267191,0.28214,0
画家(1947),画家,notion,0,1,1,0,1,1,0.00981,4,0.267191,0.28214,0
畅谈(1947),畅谈,notion,0,1,1,0,1,1,0.014222,4,0.275404,0.296091,0
界限(1947),界限,notion,0,1,1,0,1,1,0.014081,4,0.275493,0.296238,0
畏怯(1947),畏怯,notion,0,1,1,0,1,1,0.007422,4,0.26356,0.275695,0
留学(1947),留学,notion,0,1,1,0,2,2,0.014081,4,0.275493,0.296238,0
留待(1947),留待,notion,0,1,1,0,1,1,0.014081,4,0.275493,0.296238,0
留美(1947),留美,notion,0,1,1,0,1,1,0.014081,4,0.275493,0.296238,0
留美学生(1947),留美学生,notion,0,1,1,0,1,1,0.017323,4,0.281723,0.306272,0
畜殖(1947),畜殖,notion,0,1,1,0,1,1,0.007422,4,0.26356,0.275695,0
略说(1947),略说,notion,0,1,1,0,1,1,0.009035,4,0.265075,0.278404,0
略谈(1947),略谈,notion,0,1,1,0,2,2,0.007422,4,0.26356,0.275695,0
略述(1947),略述,notion,0,1,1,0,1,1,0.011229,4,0.270366,0.287632,0
番茄(1947),番茄,notion,0,1,1,0,1,1,0.014732,4,0.276453,0.297813,0
畸形(1947),畸形,notion,0,1,1,0,1,1,0.007422,4,0.26356,0.275695,0
疑云(1947),疑云,notion,0,1,1,0,1,1,0.014222,4,0.275404,0.296091,0
疑问(1947),疑问,notion,0,1,1,0,2,2,0.014222,4,0.275404,0.296091,0
疑难(1947),疑难,notion,0,1,1,0,1,1,0.014222,4,0.275404,0.296091,0
疗饥(1947),疗饥,notion,0,1,1,0,1,1,0.011229,4,0.270366,0.287632,0
疯狂(1947),疯狂,notion,0,1,1,0,1,1,0.014081,4,0.275493,0.296238,0
疯狗(1947),疯狗,notion,0,1,1,0,1,1,0.011229,4,0.270366,0.287632,0
病体(1947),病体,notion,0,1,1,0,1,1,0.017323,4,0.281723,0.306272,0
病象(1947),病象,notion,0,2,2,0,2,2,0.028954,4,0.300154,0.333577,2064.821066
症结(1947),症结,notion,0,4,4,0,5,5,0.045839,4,0.323877,0.364203,7210.003045
痛切(1947),痛切,notion,0,1,1,0,1,1,0.017323,4,0.281723,0.306272,0
痛打(1947),痛打,notion,0,1,1,0,1,1,0.011229,4,0.270366,0.287632,0
痛苦(1947),痛苦,notion,0,1,1,0,1,1,0.013711,4,0.275027,0.295469,0
瘾君子(1947),瘾君子,notion,0,1,1,0,1,1,0.004749,4,0.257108,0.263793,0
登议(1947),登议,notion,0,1,1,0,1,1,0.014081,4,0.275493,0.296238,0
登记(1947),登记,notion,0,2,2,0,2,2,0.027932,4,0.299811,0.333101,2443.455357
白下(1947),白下,notion,0,1,1,0,1,1,0.017323,4,0.281723,0.306272,0
白天(1947),白天,notion,0,1,1,0,1,1,0.014081,4,0.275493,0.296238,0
白崇禧(1947),白崇禧,notion,0,1,1,0,1,1,0.014081,4,0.275493,0.296238,0
白报纸(1947),白报纸,notion,0,1,1,0,2,2,0.014081,4,0.275493,0.296238,0
白毛女(1947),白毛女,notion,0,1,1,0,1,1,0.003699,4,0.256009,0.261706,0
白白(1947),白白,notion,0,1,1,0,1,1,0.011229,4,0.270366,0.287632,0
白石(1947),白石,notion,0,1,1,0,1,1,0.011229,4,0.270366,0.287632,0
白祸(1947),白祸,notion,0,1,1,0,1,1,0.009035,4,0.265075,0.278404,0
白色恐怖(1947),白色恐怖,notion,0,1,1,0,1,1,0.014732,4,0.276453,0.297813,0
白话(1947),白话,notion,0,1,1,0,1,1,0.014732,4,0.276453,0.297813,0
百丑图(1947),百丑图,notion,0,1,1,0,1,1,0.011229,4,0.270366,0.287632,0
百侯续(1947),百侯续,notion,0,1,1,0,1,1,0.011229,4,0.270366,0.287632,0
百分表(1947),百分表,notion,0,1,1,0,1,1,0.007422,4,0.26356,0.275695,0
百哀园(1947),百哀园,notion,0,1,1,0,1,1,0.011229,4,0.270366,0.287632,0
百货(1947),百货,notion,0,1,1,0,1,1,0.013711,4,0.275027,0.295469,0
的人(1947),的人,notion,0,1,1,0,1,1,0.013711,4,0.275027,0.295469,0
的坚(1947),的坚,notion,0,1,1,0,1,1,0.014222,4,0.275404,0.296091,0
的士(1947),的士,notion,0,1,1,0,1,1,0.002092,4,0.25318,0.25625,0
的姓(1947),的姓,notion,0,1,1,0,1,1,0.014222,4,0.275404,0.296091,0
的手(1947),的手,notion,0,1,1,0,1,1,0.013711,4,0.275027,0.295469,0
的爱(1947),的爱,notion,0,1,1,0,1,1,0.003699,4,0.256009,0.261706,0
的话(1947),的话,notion,0,4,4,0,5,5,0.038386,4,0.312577,0.350251,6003.423311
的馀音(1947),的馀音,notion,0,1,1,0,1,1,0.014081,4,0.275493,0.296238,0
皇城(1947),皇城,notion,0,1,1,0,1,1,0.013711,4,0.275027,0.295469,0
皖省(1947),皖省,notion,0,1,1,0,1,1,0.014732,4,0.276453,0.297813,0
皮尔逊(1947),皮尔逊,notion,0,2,2,0,2,2,0.031404,4,0.30602,0.34156,2430.025091
益处(1947),益处,notion,0,1,1,0,1,1,0.011229,4,0.270366,0.287632,0
益形(1947),益形,notion,0,1,1,0,1,1,0.014222,4,0.275404,0.296091,0
盐政(1947),盐政,notion,0,1,1,0,1,1,0.014222,4,0.275404,0.296091,0
盐税(1947),盐税,notion,0,1,1,0,1,1,0.014081,4,0.275493,0.296238,0
监狱(1947),监狱,notion,0,1,1,0,1,1,0.011229,4,0.270366,0.287632,0
盗亦有道(1947),盗亦有道,notion,0,1,1,0,1,1,0.014222,4,0.275404,0.296091,0
盘谷(1947),盘谷,notion,0,1,1,0,1,1,0.017323,4,0.281723,0.306272,0
盛赞(1947),盛赞,notion,0,1,1,0,1,1,0.017323,4,0.281723,0.306272,0
盟务(1947),盟务,notion,0,1,1,0,1,1,0.017323,4,0.281723,0.306272,0
盟员(1947),盟员,notion,0,1,1,0,1,1,0.017323,4,0.281723,0.306272,0
盟国(1947),盟国,notion,0,1,1,0,1,1,0.00981,4,0.267191,0.28214,0
盟约(1947),盟约,notion,0,1,1,0,1,1,0.014222,4,0.275404,0.296091,0
盪漾(1947),盪漾,notion,0,1,1,0,1,1,0.014081,4,0.275493,0.296238,0
目击(1947),目击,notion,0,1,1,0,1,1,0.014081,4,0.275493,0.296238,0
目击记(1947),目击记,notion,0,1,1,0,1,1,0.011229,4,0.270366,0.287632,0
目标(1947),目标,notion,0,2,2,0,2,2,0.021132,4,0.288412,0.316623,2574.708611
目的(1947),目的,notion,0,3,3,0,7,7,0.032873,4,0.307536,0.343636,6118.645654
盲动(1947),盲动,notion,0,1,1,0,1,1,0.014081,4,0.275493,0.296238,0
盲肠炎(1947),盲肠炎,notion,0,1,1,0,1,1,0.004749,4,0.257108,0.263793,0
直到(1947),直到,notion,0,1,1,0,1,1,0.007422,4,0.26356,0.275695,0
直立(1947),直立,notion,0,1,1,0,1,1,0.014081,4,0.275493,0.296238,0
直觉(1947),直觉,notion,0,1,1,0,1,1,0.017323,4,0.281723,0.306272,0
相同(1947),相同,notion,0,1,1,0,1,1,0.007422,4,0.26356,0.275695,0
相待(1947),相待,notion,0,1,1,0,1,1,0.007422,4,0.26356,0.275695,0
相毕露(1947),相毕露,notion,0,1,1,0,1,1,0.011229,4,0.270366,0.287632,0
相濡以沫(1947),相濡以沫,notion,0,1,1,0,1,1,0.014732,4,0.276453,0.297813,0
相结合(1947),相结合,notion,0,1,1,0,1,1,0.011229,4,0.270366,0.287632,0
盼望(1947),盼望,notion,0,1,1,0,1,1,0.011229,4,0.270366,0.287632,0
省区(1947),省区,notion,0,1,1,0,2,2,0.014222,4,0.275404,0.296091,0
省县市(1947),省县市,notion,0,1,1,0,1,1,0.009035,4,0.265075,0.278404,0
省名(1947),省名,notion,0,1,1,0,1,1,0.014081,4,0.275493,0.296238,0
省旗(1947),省旗,notion,0,1,1,0,1,1,0.014081,4,0.275493,0.296238,0
省港(1947),省港,notion,0,1,1,0,1,1,0.011229,4,0.270366,0.287632,0
省训团(1947),省训团,notion,0,1,1,0,1,1,0.011229,4,0.270366,0.287632,0
看到(1947),看到,notion,0,1,1,0,1,1,0.013711,4,0.275027,0.295469,0
看南(1947),看南,notion,0,1,1,0,1,1,0.017323,4,0.281723,0.306272,0
看天(1947),看天,notion,0,1,1,0,1,1,0.007422,4,0.26356,0.275695,0
看新(1947),看新,notion,0,1,1,0,1,1,0.002092,4,0.25318,0.25625,0
看王(1947),看王,notion,0,1,1,0,1,1,0.017323,4,0.281723,0.306272,0
看看(1947),看看,notion,0,1,1,0,1,1,0.017323,4,0.281723,0.306272,0
看臺(1947),看臺,notion,0,1,1,0,1,1,0.014081,4,0.275493,0.296238,0
看齐(1947),看齐,notion,0,1,1,0,1,1,0.007422,4,0.26356,0.275695,0
真义(1947),真义,notion,0,1,1,0,1,1,0.009035,4,0.265075,0.278404,0
真人(1947),真人,notion,0,1,1,0,1,1,0.017323,4,0.281723,0.306272,0
真假(1947),真假,notion,0,1,1,0,1,1,0.003699,4,0.256009,0.261706,0
真凭实据(1947),真凭实据,notion,0,1,1,0,1,1,0.007422,4,0.26356,0.275695,0
真实(1947),真实,notion,0,3,3,0,3,3,0.032653,4,0.305036,0.340303,4361.637559
真实性(1947),真实性,notion,0,1,1,0,1,1,0.014732,4,0.276453,0.297813,0
真情(1947),真情,notion,0,1,1,0,1,1,0.007422,4,0.26356,0.275695,0
真正(1947),真正,notion,0,2,2,0,2,2,0.01741,4,0.280151,0.303843,1198.480437
真理(1947),真理,notion,0,3,3,0,3,3,0.041865,4,0.321892,0.361762,5813.37408
真理报(1947),真理报,notion,0,1,1,0,1,1,0.00981,4,0.267191,0.28214,0
真的(1947),真的,notion,0,1,1,0,1,1,0.014732,4,0.276453,0.297813,0
真纳(1947),真纳,notion,0,1,1,0,1,1,0.009035,4,0.265075,0.278404,0
真话(1947),真话,notion,0,1,1,0,1,1,0.017323,4,0.281723,0.306272,0
真谛(1947),真谛,notion,0,1,1,0,1,1,0.009035,4,0.265075,0.278404,0
真面目(1947),真面目,notion,0,2,2,0,2,2,0.028954,4,0.300154,0.333577,2064.821066
眼中(1947),眼中,notion,0,2,2,0,2,2,0.028302,4,0.298866,0.331783,1965.8222
眼光(1947),眼光,notion,0,2,2,0,2,2,0.020265,4,0.284375,0.310471,1611.931322
眼前(1947),眼前,notion,0,2,2,0,2,2,0.022072,4,0.287175,0.314755,862.424175
眼睛(1947),眼睛,notion,0,1,1,0,2,2,0.017323,4,0.281723,0.306272,0
眼福(1947),眼福,notion,0,1,1,0,1,1,0.013711,4,0.275027,0.295469,0
眼青(1947),眼青,notion,0,1,1,0,1,1,0.014081,4,0.275493,0.296238,0
着眼于(1947),着眼于,notion,0,1,1,0,1,1,0.00981,4,0.267191,0.28214,0
睥睨(1947),睥睨,notion,0,1,1,0,1,1,0.014222,4,0.275404,0.296091,0
瞎子(1947),瞎子,notion,0,1,1,0,1,1,0.014732,4,0.276453,0.297813,0
瞑目(1947),瞑目,notion,0,1,1,0,1,1,0.009035,4,0.265075,0.278404,0
瞬息万变(1947),瞬息万变,notion,0,1,1,0,1,1,0.013711,4,0.275027,0.295469,0
瞭解(1947),瞭解,notion,0,1,1,0,1,1,0.014222,4,0.275404,0.296091,0
瞻望(1947),瞻望,notion,0,1,1,0,1,1,0.00981,4,0.267191,0.28214,0
瞿秋白(1947),瞿秋白,notion,0,1,1,0,1,1,0.013711,4,0.275027,0.295469,0
知我者(1947),知我者,notion,0,1,1,0,1,1,0.017323,4,0.281723,0.306272,0
知识(1947),知识,notion,0,3,3,0,3,3,0.035724,4,0.311778,0.349165,5959.110786
知识分子(1947),知识分子,notion,0,1,1,0,1,1,0.017323,4,0.281723,0.306272,0
知道(1947),知道,notion,0,1,1,0,1,1,0.017323,4,0.281723,0.306272,0
知难行易(1947),知难行易,notion,0,2,2,0,2,2,0.022153,4,0.289808,0.31871,2534.094371
矫治(1947),矫治,notion,0,1,1,0,1,1,0.007422,4,0.26356,0.275695,0
短期(1947),短期,notion,0,1,1,0,1,1,0.011229,4,0.270366,0.287632,0
短简(1947),短简,notion,0,1,1,0,1,1,0.003699,4,0.256009,0.261706,0
短长(1947),短长,notion,0,1,1,0,1,1,0.013711,4,0.275027,0.295469,0
石头(1947),石头,notion,0,1,1,0,1,1,0.003699,4,0.256009,0.261706,0
石子(1947),石子,notion,0,1,1,0,1,1,0.017323,4,0.281723,0.306272,0
石家莊(1947),石家莊,notion,0,1,1,0,1,1,0.013711,4,0.275027,0.295469,0
石山(1947),石山,notion,0,1,1,0,1,1,0.013711,4,0.275027,0.295469,0
石油(1947),石油,notion,0,1,1,0,1,1,0.00981,4,0.267191,0.28214,0
石膏像(1947),石膏像,notion,0,1,1,0,1,1,0.00981,4,0.267191,0.28214,0
砒霜(1947),砒霜,notion,0,1,1,0,2,2,0.017323,4,0.281723,0.306272,0
研讨(1947),研讨,notion,0,1,1,0,1,1,0.014222,4,0.275404,0.296091,0
研读(1947),研读,notion,0,1,1,0,1,1,0.014222,4,0.275404,0.296091,0
砖石(1947),砖石,notion,0,1,1,0,1,1,0.00981,4,0.267191,0.28214,0
破产(1947),破产,notion,0,2,2,0,2,2,0.028442,4,0.300022,0.333394,2187.730369
破坏(1947),破坏,notion,0,4,4,0,4,4,0.055575,4,0.347944,0.390899,12552.103043
破裂(1947),破裂,notion,0,1,1,0,1,1,0.003699,4,0.256009,0.261706,0
硬骨头(1947),硬骨头,notion,0,1,1,0,1,1,0.013711,4,0.275027,0.295469,0
确立(1947),确立,notion,0,1,1,0,1,1,0.014222,4,0.275404,0.296091,0
碉堡(1947),碉堡,notion,0,1,1,0,1,1,0.009035,4,0.265075,0.278404,0
碧血(1947),碧血,notion,0,1,1,0,1,1,0.011229,4,0.270366,0.287632,0
碰壁(1947),碰壁,notion,0,1,1,0,1,1,0.013711,4,0.275027,0.295469,0
碰着(1947),碰着,notion,0,1,1,0,1,1,0.013711,4,0.275027,0.295469,0
示人(1947),示人,notion,0,1,1,0,1,1,0.014732,4,0.276453,0.297813,0
示威(1947),示威,notion,0,2,2,0,3,3,0.017669,4,0.279944,0.303513,871.280033
礼仪之邦(1947),礼仪之邦,notion,0,1,1,0,1,1,0.014732,4,0.276453,0.297813,0
礼物(1947),礼物,notion,0,1,1,0,1,1,0.014732,4,0.276453,0.297813,0
礼赞(1947),礼赞,notion,0,1,1,0,1,1,0.003699,4,0.256009,0.261706,0
社交(1947),社交,notion,0,1,1,0,1,1,0.014222,4,0.275404,0.296091,0
社会主义国家(1947),社会主义国家,notion,0,1,1,0,1,1,0.00981,4,0.267191,0.28214,0
社会党(1947),社会党,notion,0,1,1,0,1,1,0.013711,4,0.275027,0.295469,0
社会学(1947),社会学,notion,0,1,1,0,1,1,0.014222,4,0.275404,0.296091,0
社会安定(1947),社会安定,notion,0,1,1,0,1,1,0.009035,4,0.265075,0.278404,0
社会心理学(1947),社会心理学,notion,0,1,1,0,1,1,0.014222,4,0.275404,0.296091,0
社会民主党(1947),社会民主党,notion,0,1,1,0,1,1,0.00981,4,0.267191,0.28214,0
社会科学(1947),社会科学,notion,0,1,1,0,1,1,0.014222,4,0.275404,0.296091,0
社会秩序(1947),社会秩序,notion,0,1,1,0,2,2,0.014732,4,0.276453,0.297813,0
社会财富(1947),社会财富,notion,0,1,1,0,1,1,0.002092,4,0.25318,0.25625,0
社会贤达(1947),社会贤达,notion,0,1,1,0,1,1,0.014081,4,0.275493,0.296238,0
社会阶层(1947),社会阶层,notion,0,1,1,0,1,1,0.004749,4,0.257108,0.263793,0
社员(1947),社员,notion,0,1,1,0,1,1,0.007422,4,0.26356,0.275695,0
社团(1947),社团,notion,0,1,1,0,1,1,0.014732,4,0.276453,0.297813,0
社的(1947),社的,notion,0,1,1,0,1,1,0.002092,4,0.25318,0.25625,0
社评(1947),社评,notion,0,1,1,0,1,1,0.013711,4,0.275027,0.295469,0
祈祷(1947),祈祷,notion,0,1,1,0,1,1,0.014732,4,0.276453,0.297813,0
神圣(1947),神圣,notion,0,1,1,0,1,1,0.011229,4,0.270366,0.287632,0
神怪(1947),神怪,notion,0,1,1,0,1,1,0.00981,4,0.267191,0.28214,0
神明(1947),神明,notion,0,1,1,0,1,1,0.011229,4,0.270366,0.287632,0
神枪手(1947),神枪手,notion,0,1,1,0,1,1,0.013711,4,0.275027,0.295469,0
神舞(1947),神舞,notion,0,1,1,0,1,1,0.014732,4,0.276453,0.297813,0
神话(1947),神话,notion,0,2,2,0,2,2,0.02531,4,0.2954,0.326876,2496.768821
祸患(1947),祸患,notion,0,1,1,0,1,1,0.014081,4,0.275493,0.296238,0
祸省(1947),祸省,notion,0,1,1,0,1,1,0.011229,4,0.270366,0.287632,0
禁毒(1947),禁毒,notion,0,1,1,0,1,1,0.014222,4,0.275404,0.296091,0
禁烟(1947),禁烟,notion,0,1,1,0,1,1,0.014222,4,0.275404,0.296091,0
禁烟节(1947),禁烟节,notion,0,1,1,0,1,1,0.014222,4,0.275404,0.296091,0
禁用(1947),禁用,notion,0,1,1,0,1,1,0.014081,4,0.275493,0.296238,0
禄东赞(1947),禄东赞,notion,0,1,1,0,1,1,0.014222,4,0.275404,0.296091,0
福利事业(1947),福利事业,notion,0,2,2,0,2,2,0.021644,4,0.28732,0.314975,1747.667055
福州(1947),福州,notion,0,2,2,0,2,2,0.028442,4,0.300022,0.333394,2187.730369
福延(1947),福延,notion,0,1,1,0,1,1,0.014222,4,0.275404,0.296091,0
福建(1947),福建,notion,0,2,2,0,2,2,0.028812,4,0.299917,0.333248,2025.61524
福建省(1947),福建省,notion,0,1,1,0,1,1,0.017323,4,0.281723,0.306272,0
离华(1947),离华,notion,0,1,1,0,1,1,0.003699,4,0.256009,0.261706,0
离婚(1947),离婚,notion,0,1,1,0,1,1,0.014222,4,0.275404,0.296091,0
秀才(1947),秀才,notion,0,1,1,0,1,1,0.014081,4,0.275493,0.296238,0
私产(1947),私产,notion,0,1,1,0,3,3,0.014081,4,0.275493,0.296238,0
私享(1947),私享,notion,0,1,1,0,1,1,0.014222,4,0.275404,0.296091,0
私有(1947),私有,notion,0,1,1,0,1,1,0.014222,4,0.275404,0.296091,0
私有财产(1947),私有财产,notion,0,1,1,0,1,1,0.007422,4,0.26356,0.275695,0
私校(1947),私校,notion,0,1,1,0,1,1,0.017323,4,0.281723,0.306272,0
私立(1947),私立,notion,0,2,2,0,2,2,0.032055,4,0.30624,0.341853,2215.722594
私鬥(1947),私鬥,notion,0,1,1,0,1,1,0.014081,4,0.275493,0.296238,0
秋到(1947),秋到,notion,0,1,1,0,1,1,0.013711,4,0.275027,0.295469,0
秋天(1947),秋天,notion,0,1,1,0,1,1,0.014222,4,0.275404,0.296091,0
秋收(1947),秋收,notion,0,2,2,0,2,2,0.022153,4,0.289808,0.31871,2534.094371
秋梦(1947),秋梦,notion,0,1,1,0,1,1,0.014222,4,0.275404,0.296091,0
秋水(1947),秋水,notion,0,1,1,0,1,1,0.014732,4,0.276453,0.297813,0
秋深(1947),秋深,notion,0,1,1,0,1,1,0.014222,4,0.275404,0.296091,0
秋色(1947),秋色,notion,0,1,1,0,1,1,0.014732,4,0.276453,0.297813,0
秋风(1947),秋风,notion,0,3,3,0,3,3,0.037478,4,0.313669,0.351582,5215.620442
秋高(1947),秋高,notion,0,1,1,0,1,1,0.009035,4,0.265075,0.278404,0
种新(1947),种新,notion,0,1,1,0,1,1,0.00981,4,0.267191,0.28214,0
种族(1947),种族,notion,0,1,1,0,1,1,0.017323,4,0.281723,0.306272,0
种族歧视(1947),种族歧视,notion,0,1,1,0,1,1,0.00981,4,0.267191,0.28214,0
种种(1947),种种,notion,0,4,4,0,4,4,0.046583,4,0.332392,0.374091,12884.09966
种类(1947),种类,notion,0,1,1,0,1,1,0.004749,4,0.257108,0.263793,0
科举制(1947),科举制,notion,0,1,1,0,1,1,0.014732,4,0.276453,0.297813,0
科学家(1947),科学家,notion,0,3,3,0,5,5,0.041355,4,0.320953,0.360627,5686.400693
科学研究(1947),科学研究,notion,0,2,2,0,2,2,0.028302,4,0.298866,0.331783,1965.8222
科特(1947),科特,notion,0,1,1,0,1,1,0.017323,4,0.281723,0.306272,0
秘书长(1947),秘书长,notion,0,2,2,0,2,2,0.031034,4,0.30613,0.341707,2639.595687
秘奥(1947),秘奥,notion,0,1,1,0,1,1,0.017323,4,0.281723,0.306272,0
秘密(1947),秘密,notion,0,5,5,0,6,6,0.052419,4,0.340244,0.38283,15466.952049
秘闻(1947),秘闻,notion,0,1,1,0,1,1,0.011229,4,0.270366,0.287632,0
秦汉(1947),秦汉,notion,0,1,1,0,1,1,0.014222,4,0.275404,0.296091,0
秩序(1947),秩序,notion,0,1,1,0,2,2,0.014222,4,0.275404,0.296091,0
积极(1947),积极,notion,0,2,2,0,3,3,0.028552,4,0.301506,0.335445,2588.539662
移民(1947),移民,notion,0,2,2,0,2,2,0.028302,4,0.298866,0.331783,1965.8222
程序(1947),程序,notion,0,1,1,0,2,2,0.014222,4,0.275404,0.296091,0
程度(1947),程度,notion,0,2,2,0,2,2,0.028954,4,0.300154,0.333577,2064.821066
税制(1947),税制,notion,0,1,1,0,1,1,0.014732,4,0.276453,0.297813,0
税吏(1947),税吏,notion,0,1,1,0,1,1,0.009035,4,0.265075,0.278404,0
税重(1947),税重,notion,0,1,1,0,1,1,0.013711,4,0.275027,0.295469,0
稳健(1947),稳健,notion,0,1,1,0,1,1,0.007422,4,0.26356,0.275695,0
稳重(1947),稳重,notion,0,1,1,0,1,1,0.013711,4,0.275027,0.295469,0
究竟(1947),究竟,notion,0,2,2,0,4,4,0.026359,4,0.294788,0.325997,1561.492709
穷则变(1947),穷则变,notion,0,1,1,0,1,1,0.014081,4,0.275493,0.296238,0
穷根(1947),穷根,notion,0,1,1,0,1,1,0.013711,4,0.275027,0.295469,0
穷的(1947),穷的,notion,0,1,1,0,1,1,0.004749,4,0.257108,0.263793,0
穷途(1947),穷途,notion,0,2,2,0,2,2,0.016173,4,0.277984,0.300364,973.833262
穷途末路(1947),穷途末路,notion,0,1,1,0,1,1,0.013711,4,0.275027,0.295469,0
空作(1947),空作,notion,0,1,1,0,1,1,0.014222,4,0.275404,0.296091,0
空军(1947),空军,notion,0,1,1,0,1,1,0.013711,4,0.275027,0.295469,0
空前(1947),空前,notion,0,3,3,0,3,3,0.042664,4,0.32508,0.365571,6696.006793
空城计(1947),空城计,notion,0,1,1,0,1,1,0.013711,4,0.275027,0.295469,0
空白(1947),空白,notion,0,2,2,0,2,2,0.028812,4,0.299917,0.333248,2025.61524
突击(1947),突击,notion,0,1,1,0,1,1,0.007422,4,0.26356,0.275695,0
突告(1947),突告,notion,0,1,1,0,1,1,0.017323,4,0.281723,0.306272,0
突破(1947),突破,notion,0,1,1,0,1,1,0.011229,4,0.270366,0.287632,0
突紧(1947),突紧,notion,0,1,1,0,1,1,0.017323,4,0.281723,0.306272,0
突趋(1947),突趋,notion,0,1,1,0,1,1,0.017323,4,0.281723,0.306272,0
窟窿(1947),窟窿,notion,0,1,1,0,1,1,0.013711,4,0.275027,0.295469,0
立于(1947),立于,notion,0,1,1,0,1,1,0.013711,4,0.275027,0.295469,0
立促(1947),立促,notion,0,1,1,0,1,1,0.002092,4,0.25318,0.25625,0
立功(1947),立功,notion,0,2,2,0,3,3,0.02494,4,0.292941,0.323324,1747.290038
立国(1947),立国,notion,0,1,1,0,1,1,0.009035,4,0.265075,0.278404,0
立场(1947),立场,notion,0,6,6,0,9,9,0.071893,4,0.376454,0.418229,27354.832424
立委(1947),立委,notion,0,2,2,0,2,2,0.028302,4,0.298866,0.331783,1965.8222
立德(1947),立德,notion,0,2,2,0,2,2,0.032055,4,0.30624,0.341853,2215.722594
立法(1947),立法,notion,0,2,2,0,3,3,0.016457,4,0.27778,0.300034,1514.385671
立法委员(1947),立法委员,notion,0,1,1,0,1,1,0.017323,4,0.281723,0.306272,0
立法院(1947),立法院,notion,0,1,1,0,1,1,0.014081,4,0.275493,0.296238,0
立特(1947),立特,notion,0,1,1,0,1,1,0.014081,4,0.275493,0.296238,0
立言(1947),立言,notion,0,1,1,0,1,1,0.009035,4,0.265075,0.278404,0
立身(1947),立身,notion,0,1,1,0,1,1,0.014222,4,0.275404,0.296091,0
竖立起来(1947),竖立起来,notion,0,1,1,0,1,1,0.00981,4,0.267191,0.28214,0
竖起(1947),竖起,notion,0,1,1,0,1,1,0.00981,4,0.267191,0.28214,0
站上(1947),站上,notion,0,1,1,0,1,1,0.011229,4,0.270366,0.287632,0
竞赛(1947),竞赛,notion,0,5,5,0,6,6,0.043802,4,0.323662,0.364008,13216.784831
竞选(1947),竞选,notion,0,4,4,0,9,9,0.045188,4,0.323386,0.363617,7317.495793
童年(1947),童年,notion,0,1,1,0,1,1,0.007422,4,0.26356,0.275695,0
童心(1947),童心,notion,0,1,1,0,1,1,0.014732,4,0.276453,0.297813,0
笑声(1947),笑声,notion,0,1,1,0,1,1,0.003699,4,0.256009,0.261706,0
笔下(1947),笔下,notion,0,1,1,0,1,1,0.00981,4,0.267191,0.28214,0
笔和剑(1947),笔和剑,notion,0,1,1,0,1,1,0.003699,4,0.256009,0.261706,0
笛福(1947),笛福,notion,0,1,1,0,1,1,0.014732,4,0.276453,0.297813,0
第一个(1947),第一个,notion,0,2,2,0,3,3,0.027133,4,0.29671,0.328744,1770.9936
第一口(1947),第一口,notion,0,1,1,0,1,1,0.017323,4,0.281723,0.306272,0
第一声(1947),第一声,notion,0,1,1,0,1,1,0.017323,4,0.281723,0.306272,0
第一年(1947),第一年,notion,0,1,1,0,1,1,0.00981,4,0.267191,0.28214,0
第一次(1947),第一次,notion,0,4,4,0,4,4,0.042491,4,0.321225,0.361018,8400.309812
第一步(1947),第一步,notion,0,2,2,0,2,2,0.019415,4,0.284233,0.310251,1126.485279
第一段(1947),第一段,notion,0,1,1,0,1,1,0.009035,4,0.265075,0.278404,0
第一流(1947),第一流,notion,0,1,1,0,1,1,0.014081,4,0.275493,0.296238,0
第一线(1947),第一线,notion,0,1,1,0,1,1,0.017323,4,0.281723,0.306272,0
第一课(1947),第一课,notion,0,1,1,0,1,1,0.014222,4,0.275404,0.296091,0
第一週(1947),第一週,notion,0,1,1,0,1,1,0.014081,4,0.275493,0.296238,0
第一部(1947),第一部,notion,0,1,1,0,2,2,0.00981,4,0.267191,0.28214,0
第一面(1947),第一面,notion,0,1,1,0,1,1,0.014222,4,0.275404,0.296091,0
第一颗(1947),第一颗,notion,0,1,1,0,1,1,0.013711,4,0.275027,0.295469,0
第七章(1947),第七章,notion,0,1,1,0,1,1,0.014222,4,0.275404,0.296091,0
第三世界(1947),第三世界,notion,0,1,1,0,1,1,0.002092,4,0.25318,0.25625,0
第三度(1947),第三度,notion,0,1,1,0,1,1,0.014222,4,0.275404,0.296091,0
第三方面(1947),第三方面,notion,0,3,3,0,3,3,0.014827,4,0.272502,0.29138,1757.861817
第三次(1947),第三次,notion,0,3,3,0,5,5,0.035782,4,0.31155,0.348872,4419.387238
第三种(1947),第三种,notion,0,1,1,0,1,1,0.014732,4,0.276453,0.297813,0
第三章(1947),第三章,notion,0,1,1,0,1,1,0.014222,4,0.275404,0.296091,0
第九(1947),第九,notion,0,1,1,0,1,1,0.011229,4,0.270366,0.287632,0
第九章(1947),第九章,notion,0,1,1,0,1,1,0.014222,4,0.275404,0.296091,0
第二(1947),第二,notion,0,4,4,0,5,5,0.05207,4,0.336886,0.379107,10035.939165
第二十四(1947),第二十四,notion,0,1,1,0,1,1,0.013711,4,0.275027,0.295469,0
第二卷(1947),第二卷,notion,0,1,1,0,2,2,0.014081,4,0.275493,0.296238,0
第二届(1947),第二届,notion,0,1,1,0,1,1,0.00981,4,0.267191,0.28214,0
第二期(1947),第二期,notion,0,1,1,0,1,1,0.00981,4,0.267191,0.28214,0
第二次(1947),第二次,notion,0,1,1,0,1,1,0.004749,4,0.257108,0.263793,0
第二次世界大战(1947),第二次世界大战,notion,0,1,1,0,1,1,0.00981,4,0.267191,0.28214,0
第二章(1947),第二章,notion,0,1,1,0,1,1,0.014222,4,0.275404,0.296091,0
第二辑(1947),第二辑,notion,0,1,1,0,1,1,0.014732,4,0.276453,0.297813,0
第五章(1947),第五章,notion,0,1,1,0,1,1,0.014222,4,0.275404,0.296091,0
第八次(1947),第八次,notion,0,1,1,0,1,1,0.009035,4,0.265075,0.278404,0
第八章(1947),第八章,notion,0,1,1,0,1,1,0.014222,4,0.275404,0.296091,0
第六届(1947),第六届,notion,0,1,1,0,1,1,0.014222,4,0.275404,0.296091,0
第六章(1947),第六章,notion,0,1,1,0,1,1,0.014222,4,0.275404,0.296091,0
第十(1947),第十,notion,0,1,1,0,1,1,0.00981,4,0.267191,0.28214,0
第四十九(1947),第四十九,notion,0,1,1,0,1,1,0.00981,4,0.267191,0.28214,0
第四号(1947),第四号,notion,0,1,1,0,1,1,0.002092,4,0.25318,0.25625,0
第四次(1947),第四次,notion,0,2,2,0,2,2,0.023521,4,0.291018,0.320504,1911.402908
第四章(1947),第四章,notion,0,1,1,0,1,1,0.014222,4,0.275404,0.296091,0
第四阶段(1947),第四阶段,notion,0,1,1,0,1,1,0.011229,4,0.270366,0.287632,0
笼罩(1947),笼罩,notion,0,1,1,0,1,1,0.017323,4,0.281723,0.306272,0
等到(1947),等到,notion,0,1,1,0,1,1,0.014081,4,0.275493,0.296238,0
等校(1947),等校,notion,0,1,1,0,1,1,0.017323,4,0.281723,0.306272,0
等级(1947),等级,notion,0,1,1,0,1,1,0.014081,4,0.275493,0.296238,0
答傅(1947),答傅,notion,0,1,1,0,1,1,0.014732,4,0.276453,0.297813,0
答周(1947),答周,notion,0,1,1,0,1,1,0.007422,4,0.26356,0.275695,0
答复(1947),答复,notion,0,2,2,0,2,2,0.026359,4,0.294788,0.325997,1561.492709
答客(1947),答客,notion,0,1,1,0,1,1,0.009035,4,0.265075,0.278404,0
答客问(1947),答客问,notion,0,1,1,0,1,1,0.013711,4,0.275027,0.295469,0
答林布君(1947),答林布君,notion,0,1,1,0,1,1,0.014732,4,0.276453,0.297813,0
答辩(1947),答辩,notion,0,2,2,0,2,2,0.031404,4,0.30602,0.34156,2430.025091
答问(1947),答问,notion,0,2,2,0,2,2,0.027791,4,0.29968,0.332918,2405.290268
策略(1947),策略,notion,0,2,2,0,2,2,0.018651,4,0.283055,0.30842,2017.209887
筹办(1947),筹办,notion,0,1,1,0,1,1,0.013711,4,0.275027,0.295469,0
筹安会(1947),筹安会,notion,0,1,1,0,1,1,0.013711,4,0.275027,0.295469,0
筹集(1947),筹集,notion,0,1,1,0,1,1,0.009035,4,0.265075,0.278404,0
签名运动(1947),签名运动,notion,0,1,1,0,1,1,0.017323,4,0.281723,0.306272,0
签字(1947),签字,notion,0,1,1,0,1,1,0.014222,4,0.275404,0.296091,0
简单(1947),简单,notion,0,2,2,0,2,2,0.021502,4,0.288388,0.316586,2245.621531
简约(1947),简约,notion,0,1,1,0,1,1,0.014081,4,0.275493,0.296238,0
简编(1947),简编,notion,0,1,1,0,1,1,0.014222,4,0.275404,0.296091,0
算命(1947),算命,notion,0,1,1,0,1,1,0.011229,4,0.270366,0.287632,0
管理(1947),管理,notion,0,4,4,0,4,4,0.037021,4,0.31155,0.348933,5448.640557
管理局(1947),管理局,notion,0,1,1,0,1,1,0.014222,4,0.275404,0.296091,0
管见(1947),管见,notion,0,1,1,0,1,1,0.014222,4,0.275404,0.296091,0
箴言(1947),箴言,notion,0,1,1,0,1,1,0.017323,4,0.281723,0.306272,0
箴语(1947),箴语,notion,0,1,1,0,1,1,0.017323,4,0.281723,0.306272,0
篇幅(1947),篇幅,notion,0,1,1,0,1,1,0.014732,4,0.276453,0.297813,0
篡窃(1947),篡窃,notion,0,1,1,0,1,1,0.013711,4,0.275027,0.295469,0
米价(1947),米价,notion,0,1,1,0,1,1,0.011229,4,0.270366,0.287632,0
米克(1947),米克,notion,0,1,1,0,1,1,0.017323,4,0.281723,0.306272,0
米处(1947),米处,notion,0,1,1,0,1,1,0.014081,4,0.275493,0.296238,0
米蛀虫(1947),米蛀虫,notion,0,1,1,0,1,1,0.004749,4,0.257108,0.263793,0
粉碎(1947),粉碎,notion,0,3,3,0,4,4,0.042263,4,0.32539,0.365937,6975.425387
粤曲(1947),粤曲,notion,0,1,1,0,1,1,0.011229,4,0.270366,0.287632,0
粤桂(1947),粤桂,notion,0,1,1,0,1,1,0.017323,4,0.281723,0.306272,0
精神力量(1947),精神力量,notion,0,1,1,0,1,1,0.007422,4,0.26356,0.275695,0
精读(1947),精读,notion,0,1,1,0,1,1,0.011229,4,0.270366,0.287632,0
精通业务(1947),精通业务,notion,0,1,1,0,1,1,0.011229,4,0.270366,0.287632,0
精采(1947),精采,notion,0,1,1,0,1,1,0.014732,4,0.276453,0.297813,0
糟塌(1947),糟塌,notion,0,1,1,0,1,1,0.009035,4,0.265075,0.278404,0
系统(1947),系统,notion,0,1,1,0,1,1,0.014222,4,0.275404,0.296091,0
紊乱(1947),紊乱,notion,0,1,1,0,1,1,0.014222,4,0.275404,0.296091,0
素描(1947),素描,notion,0,3,3,0,4,4,0.042633,4,0.326885,0.367694,7515.333574
紧密联系(1947),紧密联系,notion,0,1,1,0,1,1,0.011229,4,0.270366,0.287632,0
紧急(1947),紧急,notion,0,1,1,0,2,2,0.017323,4,0.281723,0.306272,0
紧急措施(1947),紧急措施,notion,0,4,4,0,7,7,0.040667,4,0.317491,0.35644,8378.88556
紧要(1947),紧要,notion,0,1,1,0,1,1,0.014222,4,0.275404,0.296091,0
紫金山(1947),紫金山,notion,0,1,1,0,1,1,0.013711,4,0.275027,0.295469,0
繁华(1947),繁华,notion,0,1,1,0,1,1,0.017323,4,0.281723,0.306272,0
繁荣(1947),繁荣,notion,0,3,3,0,5,5,0.028461,4,0.299496,0.332723,5682.41047
纠纷(1947),纠纷,notion,0,1,1,0,1,1,0.014081,4,0.275493,0.296238,0
纠缠(1947),纠缠,notion,0,1,1,0,2,2,0.007422,4,0.26356,0.275695,0
纠葛(1947),纠葛,notion,0,1,1,0,1,1,0.009035,4,0.265075,0.278404,0
红军(1947),红军,notion,0,1,1,0,1,1,0.00981,4,0.267191,0.28214,0
红枪(1947),红枪,notion,0,1,1,0,1,1,0.013711,4,0.275027,0.295469,0
约会(1947),约会,notion,0,1,1,0,1,1,0.014081,4,0.275493,0.296238,0
约克夏(1947),约克夏,notion,0,1,1,0,1,1,0.007422,4,0.26356,0.275695,0
约束(1947),约束,notion,0,1,1,0,1,1,0.014081,4,0.275493,0.296238,0
约翰(1947),约翰,notion,0,1,1,0,1,1,0.014222,4,0.275404,0.296091,0
纪实(1947),纪实,notion,0,4,4,0,5,5,0.053557,4,0.346179,0.389068,14135.687794
纪录(1947),纪录,notion,0,1,1,0,2,2,0.017323,4,0.281723,0.306272,0
纪念日(1947),纪念日,notion,0,4,4,0,4,4,0.055575,4,0.347944,0.390899,12552.103043
纪念碑(1947),纪念碑,notion,0,1,1,0,1,1,0.00981,4,0.267191,0.28214,0
纪行(1947),纪行,notion,0,1,1,0,2,2,0.014081,4,0.275493,0.296238,0
纪要(1947),纪要,notion,0,1,1,0,2,2,0.017323,4,0.281723,0.306272,0
纪详(1947),纪详,notion,0,1,1,0,1,1,0.017323,4,0.281723,0.306272,0
纯粹(1947),纯粹,notion,0,1,1,0,1,1,0.014732,4,0.276453,0.297813,0
纲领(1947),纲领,notion,0,1,1,0,1,1,0.017323,4,0.281723,0.306272,0
纳粹(1947),纳粹,notion,0,2,2,0,5,5,0.027133,4,0.29671,0.328744,1770.9936
纵容(1947),纵容,notion,0,1,1,0,1,1,0.013711,4,0.275027,0.295469,0
纵横谈(1947),纵横谈,notion,0,1,1,0,1,1,0.017323,4,0.281723,0.306272,0
纵火(1947),纵火,notion,0,1,1,0,1,1,0.014222,4,0.275404,0.296091,0
纷争(1947),纷争,notion,0,1,1,0,1,1,0.011229,4,0.270366,0.287632,0
纷电(1947),纷电,notion,0,1,1,0,1,1,0.017323,4,0.281723,0.306272,0
纸厂(1947),纸厂,notion,0,1,1,0,1,1,0.007422,4,0.26356,0.275695,0
纸老虎(1947),纸老虎,notion,0,1,1,0,3,3,0.013711,4,0.275027,0.295469,0
纽约市(1947),纽约市,notion,0,1,1,0,1,1,0.017323,4,0.281723,0.306272,0
纽约时报(1947),纽约时报,notion,0,1,1,0,1,1,0.014222,4,0.275404,0.296091,0
组党(1947),组党,notion,0,1,1,0,1,1,0.017323,4,0.281723,0.306272,0
组曲(1947),组曲,notion,0,1,1,0,1,1,0.014732,4,0.276453,0.297813,0
组织法(1947),组织法,notion,0,1,1,0,1,1,0.014222,4,0.275404,0.296091,0
组织者(1947),组织者,notion,0,1,1,0,2,2,0.00981,4,0.267191,0.28214,0
绅士(1947),绅士,notion,0,1,1,0,1,1,0.014081,4,0.275493,0.296238,0
细查(1947),细查,notion,0,1,1,0,1,1,0.013711,4,0.275027,0.295469,0
细看(1947),细看,notion,0,1,1,0,1,1,0.014081,4,0.275493,0.296238,0
织布(1947),织布,notion,0,1,1,0,1,1,0.011229,4,0.270366,0.287632,0
终结(1947),终结,notion,0,1,1,0,1,1,0.011229,4,0.270366,0.287632,0
终身(1947),终身,notion,0,1,1,0,1,1,0.014081,4,0.275493,0.296238,0
经历(1947),经历,notion,0,1,1,0,1,1,0.013711,4,0.275027,0.295469,0
经委会(1947),经委会,notion,0,1,1,0,1,1,0.014222,4,0.275404,0.296091,0
经建(1947),经建,notion,0,1,1,0,1,1,0.011229,4,0.270366,0.287632,0
经济学(1947),经济学,notion,0,1,1,0,1,1,0.014222,4,0.275404,0.296091,0
经济恐慌(1947),经济恐慌,notion,0,3,3,0,3,3,0.036169,4,0.309685,0.346455,4415.889012
经济社会(1947),经济社会,notion,0,1,1,0,1,1,0.014081,4,0.275493,0.296238,0
经纬(1947),经纬,notion,0,1,1,0,1,1,0.004749,4,0.257108,0.263793,0
经营(1947),经营,notion,0,2,2,0,2,2,0.021644,4,0.28732,0.314975,1747.667055
经费(1947),经费,notion,0,2,2,0,3,3,0.031545,4,0.305336,0.340645,2219.908318
经过(1947),经过,notion,0,3,3,0,5,5,0.039162,4,0.318825,0.358027,6544.514107
经迟(1947),经迟,notion,0,1,1,0,1,1,0.013711,4,0.275027,0.295469,0
经验(1947),经验,notion,0,3,3,0,5,5,0.019519,4,0.283714,0.309506,2930.468094
经验教训(1947),经验教训,notion,0,1,1,0,1,1,0.009035,4,0.265075,0.278404,0
结交(1947),结交,notion,0,1,1,0,1,1,0.011229,4,0.270366,0.287632,0
结合(1947),结合,notion,0,2,2,0,2,2,0.027932,4,0.299811,0.333101,2443.455357
结局(1947),结局,notion,0,1,1,0,1,1,0.017323,4,0.281723,0.306272,0
结工(1947),结工,notion,0,1,1,0,1,1,0.007422,4,0.26356,0.275695,0
结束(1947),结束,notion,0,4,4,0,6,6,0.048707,4,0.333366,0.375189,10806.690404
结果(1947),结果,notion,0,5,5,0,7,7,0.059164,4,0.351635,0.394732,15490.412661
给与(1947),给与,notion,0,1,1,0,1,1,0.014222,4,0.275404,0.296091,0
给予(1947),给予,notion,0,1,1,0,1,1,0.00981,4,0.267191,0.28214,0
给大(1947),给大,notion,0,1,1,0,1,1,0.013711,4,0.275027,0.295469,0
给邓(1947),给邓,notion,0,1,1,0,1,1,0.013711,4,0.275027,0.295469,0
绝后(1947),绝后,notion,0,1,1,0,1,1,0.014732,4,0.276453,0.297813,0
绝望(1947),绝望,notion,0,2,2,0,2,2,0.02494,4,0.292941,0.323324,1747.290038
绝粮(1947),绝粮,notion,0,1,1,0,1,1,0.011229,4,0.270366,0.287632,0
绝顶(1947),绝顶,notion,0,1,1,0,1,1,0.014222,4,0.275404,0.296091,0
绞杀(1947),绞杀,notion,0,1,1,0,1,1,0.00981,4,0.267191,0.28214,0
统一(1947),统一,notion,0,8,8,0,17,17,0.096832,4,0.436425,0.463979,55594.693194
统一战线(1947),统一战线,notion,0,3,3,0,5,5,0.028528,4,0.296787,0.328915,3134.739374
统制(1947),统制,notion,0,2,2,0,2,2,0.028442,4,0.300022,0.333394,2187.730369
统帅(1947),统帅,notion,0,1,1,0,1,1,0.017323,4,0.281723,0.306272,0
统整性(1947),统整性,notion,0,1,1,0,1,1,0.014222,4,0.275404,0.296091,0
统治权(1947),统治权,notion,0,1,1,0,1,1,0.014222,4,0.275404,0.296091,0
统治者(1947),统治者,notion,0,2,2,0,2,2,0.028552,4,0.301506,0.335445,2588.539662
绥远(1947),绥远,notion,0,1,1,0,1,1,0.014081,4,0.275493,0.296238,0
绥靖(1947),绥靖,notion,0,2,2,0,3,3,0.02494,4,0.292941,0.323324,1747.290038
继以(1947),继以,notion,0,1,1,0,1,1,0.014081,4,0.275493,0.296238,0
继任(1947),继任,notion,0,1,1,0,1,1,0.014081,4,0.275493,0.296238,0
继往开来(1947),继往开来,notion,0,1,1,0,1,1,0.007422,4,0.26356,0.275695,0
继续(1947),继续,notion,0,3,3,0,3,3,0.042263,4,0.32539,0.365937,6975.425387
续七(1947),续七,notion,0,1,1,0,2,2,0.009035,4,0.265075,0.278404,0
续三一(1947),续三一,notion,0,1,1,0,1,1,0.009035,4,0.265075,0.278404,0
续三三(1947),续三三,notion,0,1,1,0,1,1,0.009035,4,0.265075,0.278404,0
续三二(1947),续三二,notion,0,1,1,0,1,1,0.009035,4,0.265075,0.278404,0
续三六(1947),续三六,notion,0,1,1,0,1,1,0.009035,4,0.265075,0.278404,0
续二(1947),续二,notion,0,1,1,0,1,1,0.009035,4,0.265075,0.278404,0
续五(1947),续五,notion,0,1,1,0,2,2,0.009035,4,0.265075,0.278404,0
续八(1947),续八,notion,0,1,1,0,1,1,0.009035,4,0.265075,0.278404,0
续六(1947),续六,notion,0,1,1,0,2,2,0.009035,4,0.265075,0.278404,0
续十(1947),续十,notion,0,1,1,0,1,1,0.009035,4,0.265075,0.278404,0
续四(1947),续四,notion,0,1,1,0,2,2,0.009035,4,0.265075,0.278404,0
续念(1947),续念,notion,0,1,1,0,1,1,0.009035,4,0.265075,0.278404,0
续稿(1947),续稿,notion,0,2,2,0,2,2,0.032055,4,0.30624,0.341853,2215.722594
维也纳(1947),维也纳,notion,0,1,1,0,1,1,0.014222,4,0.275404,0.296091,0
维克(1947),维克,notion,0,1,1,0,1,1,0.00981,4,0.267191,0.28214,0
维护(1947),维护,notion,0,1,1,0,1,1,0.017323,4,0.281723,0.306272,0
维持(1947),维持,notion,0,2,2,0,2,2,0.028812,4,0.299917,0.333248,2025.61524
维辛斯基(1947),维辛斯基,notion,0,2,2,0,2,2,0.018845,4,0.280243,0.303989,1083.402703
综报(1947),综报,notion,0,1,1,0,1,1,0.011229,4,0.270366,0.287632,0
缅甸(1947),缅甸,notion,0,5,5,0,10,10,0.069797,4,0.376123,0.417875,20975.78656
缓了(1947),缓了,notion,0,1,1,0,1,1,0.014222,4,0.275404,0.296091,0
缓兵之计(1947),缓兵之计,notion,0,1,1,0,1,1,0.013711,4,0.275027,0.295469,0
编导(1947),编导,notion,0,1,1,0,1,1,0.014732,4,0.276453,0.297813,0
编排(1947),编排,notion,0,1,1,0,1,1,0.014222,4,0.275404,0.296091,0
编译(1947),编译,notion,0,1,1,0,1,1,0.014222,4,0.275404,0.296091,0
编辑(1947),编辑,notion,0,2,2,0,3,3,0.027791,4,0.29968,0.332918,2405.290268
缘故(1947),缘故,notion,0,1,1,0,1,1,0.011229,4,0.270366,0.287632,0
缩小(1947),缩小,notion,0,2,2,0,3,3,0.017921,4,0.280658,0.304648,1255.9419
缺乏(1947),缺乏,notion,0,1,1,0,1,1,0.014081,4,0.275493,0.296238,0
缺点(1947),缺点,notion,0,1,1,0,1,1,0.014732,4,0.276453,0.297813,0
缺陷(1947),缺陷,notion,0,1,1,0,1,1,0.014081,4,0.275493,0.296238,0
网是(1947),网是,notion,0,1,1,0,1,1,0.013711,4,0.275027,0.295469,0
网领(1947),网领,notion,0,1,1,0,1,1,0.013711,4,0.275027,0.295469,0
罗努生(1947),罗努生,notion,0,1,1,0,1,1,0.009035,4,0.265075,0.278404,0
罗卓英(1947),罗卓英,notion,0,2,2,0,5,5,0.025961,4,0.295759,0.327389,2231.848602
罗城(1947),罗城,notion,0,1,1,0,1,1,0.017323,4,0.281723,0.306272,0
罗斯(1947),罗斯,notion,0,1,1,0,1,1,0.017323,4,0.281723,0.306272,0
罗曼罗兰(1947),罗曼罗兰,notion,0,1,1,0,1,1,0.014732,4,0.276453,0.297813,0
罗联辉(1947),罗联辉,notion,0,1,1,0,1,1,0.011229,4,0.270366,0.287632,0
罗马(1947),罗马,notion,0,3,3,0,3,3,0.036294,4,0.310219,0.347151,3739.543386
罗马尼亚(1947),罗马尼亚,notion,0,1,1,0,3,3,0.00981,4,0.267191,0.28214,0
罢免(1947),罢免,notion,0,1,1,0,1,1,0.011229,4,0.270366,0.287632,0
罢工(1947),罢工,notion,0,4,4,0,4,4,0.054924,4,0.348548,0.391521,13274.213948
罪人(1947),罪人,notion,0,2,2,0,2,2,0.017299,4,0.278915,0.301865,688.562525
罪恶(1947),罪恶,notion,0,2,2,0,2,2,0.014579,4,0.275783,0.296775,568.859546
罪行(1947),罪行,notion,0,2,2,0,5,5,0.014818,4,0.274563,0.294761,698.886811
罪言(1947),罪言,notion,0,1,1,0,1,1,0.009035,4,0.265075,0.278404,0
罪證(1947),罪證,notion,0,1,1,0,1,1,0.013711,4,0.275027,0.295469,0
美人(1947),美人,notion,0,1,1,0,1,1,0.017323,4,0.281723,0.306272,0
美以(1947),美以,notion,0,1,1,0,1,1,0.017323,4,0.281723,0.306272,0
美元(1947),美元,notion,0,3,3,0,4,4,0.036169,4,0.309685,0.346455,4415.889012
美共责(1947),美共责,notion,0,1,1,0,1,1,0.017323,4,0.281723,0.306272,0
美兵(1947),美兵,notion,0,3,3,0,5,5,0.04109,4,0.319332,0.358649,5229.401507
美军(1947),美军,notion,0,5,5,0,11,11,0.053423,4,0.34021,0.382794,13207.996843
美加(1947),美加,notion,0,1,1,0,1,1,0.00981,4,0.267191,0.28214,0
美商(1947),美商,notion,0,1,1,0,1,1,0.014081,4,0.275493,0.296238,0
美国共和党(1947),美国共和党,notion,0,1,1,0,1,1,0.009035,4,0.265075,0.278404,0
美国式(1947),美国式,notion,0,1,1,0,1,1,0.003699,4,0.256009,0.261706,0
美国民主党(1947),美国民主党,notion,0,1,1,0,1,1,0.009035,4,0.265075,0.278404,0
美女(1947),美女,notion,0,1,1,0,1,1,0.014081,4,0.275493,0.296238,0
美妙(1947),美妙,notion,0,1,1,0,1,1,0.017323,4,0.281723,0.306272,0
美式(1947),美式,notion,0,2,2,0,3,3,0.023521,4,0.291018,0.320504,1911.402908
美援(1947),美援,notion,0,1,1,0,1,1,0.017323,4,0.281723,0.306272,0
美日(1947),美日,notion,0,1,1,0,1,1,0.017323,4,0.281723,0.306272,0
美景(1947),美景,notion,0,1,1,0,1,1,0.014732,4,0.276453,0.297813,0
美术(1947),美术,notion,0,1,1,0,1,1,0.000869,4,0.251131,0.252222,0
美械(1947),美械,notion,0,1,1,0,1,1,0.013711,4,0.275027,0.295469,0
美洲(1947),美洲,notion,0,2,2,0,2,2,0.026359,4,0.294788,0.325997,1561.492709
美苏关系(1947),美苏关系,notion,0,4,4,0,4,4,0.024172,4,0.285828,0.312827,2513.216558
美英(1947),美英,notion,0,1,1,0,2,2,0.009035,4,0.265075,0.278404,0
美蒋(1947),美蒋,notion,0,1,1,0,1,1,0.013711,4,0.275027,0.295469,0
美资(1947),美资,notion,0,1,1,0,1,1,0.011229,4,0.270366,0.287632,0
美金(1947),美金,notion,0,4,4,0,5,5,0.048707,4,0.333366,0.375189,10806.690404
羡煞(1947),羡煞,notion,0,1,1,0,1,1,0.014732,4,0.276453,0.297813,0
羣育(1947),羣育,notion,0,1,1,0,1,1,0.014081,4,0.275493,0.296238,0
羣衆(1947),羣衆,notion,0,1,1,0,3,3,0.013711,4,0.275027,0.295469,0
群众观点(1947),群众观点,notion,0,1,1,0,2,2,0.011229,4,0.270366,0.287632,0
群众路线(1947),群众路线,notion,0,1,1,0,2,2,0.011229,4,0.270366,0.287632,0
群众运动(1947),群众运动,notion,0,1,1,0,1,1,0.011229,4,0.270366,0.287632,0
群宾座(1947),群宾座,notion,0,1,1,0,1,1,0.014732,4,0.276453,0.297813,0
翁源(1947),翁源,notion,0,1,1,0,2,2,0.011229,4,0.270366,0.287632,0
翦伯赞(1947),翦伯赞,notion,0,1,1,0,2,2,0.014222,4,0.275404,0.296091,0
翻案(1947),翻案,notion,0,1,1,0,1,1,0.014081,4,0.275493,0.296238,0
翻译(1947),翻译,notion,0,2,2,0,2,2,0.028812,4,0.299917,0.333248,2025.61524
翻身(1947),翻身,notion,0,4,4,0,4,4,0.048707,4,0.333366,0.375189,10806.690404
翻车(1947),翻车,notion,0,1,1,0,1,1,0.013711,4,0.275027,0.295469,0
老人(1947),老人,notion,0,3,3,0,4,4,0.030721,4,0.30063,0.334298,3225.341612
老子(1947),老子,notion,0,1,1,0,1,1,0.014732,4,0.276453,0.297813,0
老实(1947),老实,notion,0,1,1,0,1,1,0.011229,4,0.270366,0.287632,0
老师(1947),老师,notion,0,1,1,0,1,1,0.000869,4,0.251131,0.252222,0
老张(1947),老张,notion,0,1,1,0,1,1,0.014732,4,0.276453,0.297813,0
老怀德(1947),老怀德,notion,0,1,1,0,1,1,0.011229,4,0.270366,0.287632,0
老战士(1947),老战士,notion,0,1,1,0,1,1,0.003588,4,0.255396,0.260534,0
老把戏(1947),老把戏,notion,0,1,1,0,1,1,0.014081,4,0.275493,0.296238,0
老朋友(1947),老朋友,notion,0,1,1,0,1,1,0.014732,4,0.276453,0.297813,0
老母(1947),老母,notion,0,2,2,0,2,2,0.027791,4,0.29968,0.332918,2405.290268
老爷(1947),老爷,notion,0,1,1,0,1,1,0.013711,4,0.275027,0.295469,0
老百姓(1947),老百姓,notion,0,2,2,0,3,3,0.027791,4,0.29968,0.332918,2405.290268
老祖宗(1947),老祖宗,notion,0,1,1,0,1,1,0.013711,4,0.275027,0.295469,0
老虎(1947),老虎,notion,0,2,2,0,3,3,0.032055,4,0.30624,0.341853,2215.722594
老话(1947),老话,notion,0,1,1,0,1,1,0.013711,4,0.275027,0.295469,0
老调(1947),老调,notion,0,1,1,0,1,1,0.014222,4,0.275404,0.296091,0
考察(1947),考察,notion,0,2,2,0,2,2,0.021502,4,0.288388,0.316586,2245.621531
考察报告(1947),考察报告,notion,0,1,1,0,1,1,0.011229,4,0.270366,0.287632,0
考查(1947),考查,notion,0,1,1,0,1,1,0.007422,4,0.26356,0.275695,0
考生(1947),考生,notion,0,1,1,0,1,1,0.014081,4,0.275493,0.296238,0
考虑(1947),考虑,notion,0,1,1,0,1,1,0.017323,4,0.281723,0.306272,0
考评(1947),考评,notion,0,1,1,0,1,1,0.007422,4,0.26356,0.275695,0
考试(1947),考试,notion,0,2,2,0,2,2,0.028812,4,0.299917,0.333248,2025.61524
考试制度(1947),考试制度,notion,0,1,1,0,1,1,0.017323,4,0.281723,0.306272,0
考试院(1947),考试院,notion,0,1,1,0,1,1,0.014222,4,0.275404,0.296091,0
考验(1947),考验,notion,0,5,5,0,6,6,0.061685,4,0.361964,0.404875,21683.237486
而且(1947),而且,notion,0,1,1,0,1,1,0.017323,4,0.281723,0.306272,0
而作(1947),而作,notion,0,3,3,0,3,3,0.03475,4,0.309488,0.346199,5532.888574
而寒(1947),而寒,notion,0,1,1,0,1,1,0.014081,4,0.275493,0.296238,0
而己(1947),而己,notion,0,1,1,0,1,1,0.013711,4,0.275027,0.295469,0
而已(1947),而已,notion,0,3,3,0,3,3,0.03902,4,0.318676,0.357844,6649.349127
而战(1947),而战,notion,0,2,2,0,2,2,0.0148,4,0.275716,0.296665,130.073793
而是(1947),而是,notion,0,2,2,0,2,2,0.021039,4,0.286524,0.313766,1874.195629
而言(1947),而言,notion,0,1,1,0,1,1,0.003699,4,0.256009,0.261706,0
而鬥争(1947),而鬥争,notion,0,1,1,0,1,1,0.013711,4,0.275027,0.295469,0
耍什(1947),耍什,notion,0,1,1,0,1,1,0.013711,4,0.275027,0.295469,0
耕田(1947),耕田,notion,0,1,1,0,1,1,0.013711,4,0.275027,0.295469,0
耕种(1947),耕种,notion,0,1,1,0,1,1,0.00981,4,0.267191,0.28214,0
耕耘者(1947),耕耘者,notion,0,1,1,0,1,1,0.013711,4,0.275027,0.295469,0
耶稣基督(1947),耶稣基督,notion,0,1,1,0,1,1,0.014222,4,0.275404,0.296091,0
聂荣臻(1947),聂荣臻,notion,0,1,1,0,1,1,0.013711,4,0.275027,0.295469,0
职业(1947),职业,notion,0,4,4,0,8,8,0.041449,4,0.318438,0.357612,6528.225821
职业化(1947),职业化,notion,0,1,1,0,1,1,0.014081,4,0.275493,0.296238,0
职务(1947),职务,notion,0,1,1,0,1,1,0.014732,4,0.276453,0.297813,0
联军(1947),联军,notion,0,1,1,0,1,1,0.011229,4,0.270366,0.287632,0
联合国大会(1947),联合国大会,notion,0,2,2,0,2,2,0.024032,4,0.290894,0.320321,1695.498775
联合宣言(1947),联合宣言,notion,0,2,2,0,2,2,0.027133,4,0.29671,0.328744,1770.9936
联合政府(1947),联合政府,notion,0,2,2,0,3,3,0.023116,4,0.288412,0.316623,1358.22258
联名(1947),联名,notion,0,1,1,0,1,1,0.017323,4,0.281723,0.306272,0
联大(1947),联大,notion,0,1,1,0,1,1,0.00981,4,0.267191,0.28214,0
联姻(1947),联姻,notion,0,1,1,0,1,1,0.017323,4,0.281723,0.306272,0
联席会议(1947),联席会议,notion,0,1,1,0,1,1,0.014081,4,0.275493,0.296238,0
联总(1947),联总,notion,0,1,1,0,1,1,0.009035,4,0.265075,0.278404,0
联系(1947),联系,notion,0,1,1,0,1,1,0.017323,4,0.281723,0.306272,0
联络组(1947),联络组,notion,0,1,1,0,1,1,0.017323,4,0.281723,0.306272,0
联考(1947),联考,notion,0,1,1,0,1,1,0.014081,4,0.275493,0.296238,0
联谊会(1947),联谊会,notion,0,1,1,0,1,1,0.014081,4,0.275493,0.296238,0
联邦(1947),联邦,notion,0,1,1,0,2,2,0.00981,4,0.267191,0.28214,0
联防(1947),联防,notion,0,1,1,0,1,1,0.013711,4,0.275027,0.295469,0
聪明(1947),聪明,notion,0,2,2,0,2,2,0.032055,4,0.30624,0.341853,2215.722594
肃奸(1947),肃奸,notion,0,1,1,0,1,1,0.011229,4,0.270366,0.287632,0
肃清(1947),肃清,notion,0,4,4,0,4,4,0.046637,4,0.329377,0.370648,10450.928721
肇事(1947),肇事,notion,0,1,1,0,1,1,0.007422,4,0.26356,0.275695,0
肇基(1947),肇基,notion,0,1,1,0,1,1,0.014222,4,0.275404,0.296091,0
肚皮(1947),肚皮,notion,0,2,2,0,2,2,0.02494,4,0.292941,0.323324,1747.290038
股金(1947),股金,notion,0,1,1,0,1,1,0.007422,4,0.26356,0.275695,0
肥肉(1947),肥肉,notion,0,1,1,0,1,1,0.011229,4,0.270366,0.287632,0
肩负(1947),肩负,notion,0,1,1,0,1,1,0.017323,4,0.281723,0.306272,0
育才(1947),育才,notion,0,1,1,0,1,1,0.017323,4,0.281723,0.306272,0
胁诈(1947),胁诈,notion,0,1,1,0,1,1,0.013711,4,0.275027,0.295469,0
背景(1947),背景,notion,0,3,3,0,3,3,0.045626,4,0.330014,0.37132,6615.755609
胖子(1947),胖子,notion,0,1,1,0,1,1,0.013711,4,0.275027,0.295469,0
胡乱(1947),胡乱,notion,0,1,1,0,1,1,0.014732,4,0.276453,0.297813,0
胡宗南(1947),胡宗南,notion,0,1,1,0,1,1,0.013711,4,0.275027,0.295469,0
胡志明(1947),胡志明,notion,0,2,2,0,3,3,0.017901,4,0.281979,0.306736,139.132773
胡敦复(1947),胡敦复,notion,0,1,1,0,1,1,0.017323,4,0.281723,0.306272,0
胡白华(1947),胡白华,notion,0,1,1,0,1,1,0.017323,4,0.281723,0.306272,0
胰子(1947),胰子,notion,0,1,1,0,1,1,0.003699,4,0.256009,0.261706,0
胶济(1947),胶济,notion,0,1,1,0,1,1,0.013711,4,0.275027,0.295469,0
胸像(1947),胸像,notion,0,1,1,0,2,2,0.00981,4,0.267191,0.28214,0
胸襟(1947),胸襟,notion,0,1,1,0,1,1,0.007422,4,0.26356,0.275695,0
能力(1947),能力,notion,0,1,1,0,1,1,0.017323,4,0.281723,0.306272,0
能受(1947),能受,notion,0,1,1,0,1,1,0.017323,4,0.281723,0.306272,0
能否(1947),能否,notion,0,2,2,0,2,2,0.023257,4,0.28761,0.315414,1169.271875
能够(1947),能够,notion,0,2,2,0,2,2,0.021132,4,0.288412,0.316623,2574.708611
脆弱(1947),脆弱,notion,0,1,1,0,1,1,0.014081,4,0.275493,0.296238,0
脉络(1947),脉络,notion,0,1,1,0,1,1,0.003699,4,0.256009,0.261706,0
脑筋(1947),脑筋,notion,0,1,1,0,2,2,0.014081,4,0.275493,0.296238,0
脚下(1947),脚下,notion,0,1,1,0,1,1,0.011229,4,0.270366,0.287632,0
脱离(1947),脱离,notion,0,1,1,0,1,1,0.013711,4,0.275027,0.295469,0
腐蚀(1947),腐蚀,notion,0,1,1,0,1,1,0.007422,4,0.26356,0.275695,0
腾出(1947),腾出,notion,0,1,1,0,1,1,0.014081,4,0.275493,0.296238,0
臧克家(1947),臧克家,notion,0,1,1,0,1,1,0.003699,4,0.256009,0.261706,0
臧大咬子(1947),臧大咬子,notion,0,1,1,0,1,1,0.003699,4,0.256009,0.261706,0
自力(1947),自力,notion,0,1,1,0,1,1,0.00981,4,0.267191,0.28214,0
自力更生(1947),自力更生,notion,0,2,2,0,3,3,0.031034,4,0.30613,0.341707,2639.595687
自动(1947),自动,notion,0,2,2,0,2,2,0.022072,4,0.287175,0.314755,862.424175
自华(1947),自华,notion,0,1,1,0,1,1,0.017323,4,0.281723,0.306272,0
自卫(1947),自卫,notion,0,1,1,0,5,5,0.011229,4,0.270366,0.287632,0
自卫战争(1947),自卫战争,notion,0,2,2,0,3,3,0.018459,4,0.281051,0.305271,917.367375
自卫队(1947),自卫队,notion,0,1,1,0,1,1,0.014732,4,0.276453,0.297813,0
自叹(1947),自叹,notion,0,1,1,0,1,1,0.014732,4,0.276453,0.297813,0
自处(1947),自处,notion,0,1,1,0,1,1,0.009035,4,0.265075,0.278404,0
自学(1947),自学,notion,0,2,2,0,2,2,0.031545,4,0.305336,0.340645,2219.908318
自平(1947),自平,notion,0,1,1,0,1,1,0.017323,4,0.281723,0.306272,0
自录(1947),自录,notion,0,1,1,0,1,1,0.014732,4,0.276453,0.297813,0
自律(1947),自律,notion,0,1,1,0,1,1,0.014081,4,0.275493,0.296238,0
自慰(1947),自慰,notion,0,1,1,0,1,1,0.013711,4,0.275027,0.295469,0
自我批评(1947),自我批评,notion,0,1,1,0,1,1,0.011229,4,0.270366,0.287632,0
自我检讨(1947),自我检讨,notion,0,1,1,0,1,1,0.017323,4,0.281723,0.306272,0
自救(1947),自救,notion,0,3,3,0,4,4,0.032141,4,0.305063,0.34034,4085.405862
自杀(1947),自杀,notion,0,2,2,0,3,3,0.028442,4,0.300022,0.333394,2187.730369
自来(1947),自来,notion,0,1,1,0,1,1,0.014732,4,0.276453,0.297813,0
自欺欺人(1947),自欺欺人,notion,0,1,1,0,1,1,0.017323,4,0.281723,0.306272,0
自求(1947),自求,notion,0,1,1,0,1,1,0.017323,4,0.281723,0.306272,0
自然法则(1947),自然法则,notion,0,1,1,0,1,1,0.00981,4,0.267191,0.28214,0
自由思想(1947),自由思想,notion,0,1,1,0,1,1,0.014081,4,0.275493,0.296238,0
自白(1947),自白,notion,0,4,4,0,5,5,0.051558,4,0.338691,0.381085,11004.748529
自自(1947),自自,notion,0,1,1,0,1,1,0.017323,4,0.281723,0.306272,0
自解(1947),自解,notion,0,1,1,0,1,1,0.007422,4,0.26356,0.275695,0
自责(1947),自责,notion,0,1,1,0,1,1,0.007422,4,0.26356,0.275695,0
自费留学(1947),自费留学,notion,0,1,1,0,1,1,0.014081,4,0.275493,0.296238,0
自身(1947),自身,notion,0,1,1,0,1,1,0.007422,4,0.26356,0.275695,0
自述(1947),自述,notion,0,1,1,0,1,1,0.014732,4,0.276453,0.297813,0
自食其果(1947),自食其果,notion,0,2,2,0,2,2,0.028442,4,0.300022,0.333394,2187.730369
至今(1947),至今,notion,0,1,1,0,1,1,0.014222,4,0.275404,0.296091,0
至性(1947),至性,notion,0,1,1,0,1,1,0.007422,4,0.26356,0.275695,0
致一(1947),致一,notion,0,1,1,0,1,1,0.014732,4,0.276453,0.297813,0
致书(1947),致书,notion,0,1,1,0,1,1,0.017323,4,0.281723,0.306272,0
致伍(1947),致伍,notion,0,1,1,0,1,1,0.009035,4,0.265075,0.278404,0
致公党(1947),致公党,notion,0,1,1,0,1,1,0.017323,4,0.281723,0.306272,0
致命(1947),致命,notion,0,1,1,0,1,1,0.017323,4,0.281723,0.306272,0
致大美(1947),致大美,notion,0,1,1,0,1,1,0.017323,4,0.281723,0.306272,0
致敬(1947),致敬,notion,0,4,4,0,5,5,0.048844,4,0.335067,0.377093,9608.040099
致电(1947),致电,notion,0,1,1,0,1,1,0.017323,4,0.281723,0.306272,0
致词(1947),致词,notion,0,2,2,0,2,2,0.031545,4,0.305336,0.340645,2219.908318
舆论(1947),舆论,notion,0,5,5,0,5,5,0.064981,4,0.362041,0.404948,17841.225001
舆论界(1947),舆论界,notion,0,2,2,0,2,2,0.032055,4,0.30624,0.341853,2215.722594
舍桐花(1947),舍桐花,notion,0,1,1,0,1,1,0.003588,4,0.255396,0.260534,0
舒尔达(1947),舒尔达,notion,0,1,1,0,1,1,0.003588,4,0.255396,0.260534,0
舞剧(1947),舞剧,notion,0,1,1,0,1,1,0.00981,4,0.267191,0.28214,0
舞台(1947),舞台,notion,0,1,1,0,1,1,0.007422,4,0.26356,0.275695,0
舞弊(1947),舞弊,notion,0,2,2,0,2,2,0.027932,4,0.299811,0.333101,2443.455357
舞曲(1947),舞曲,notion,0,1,1,0,1,1,0.014732,4,0.276453,0.297813,0
舞蹈(1947),舞蹈,notion,0,1,1,0,1,1,0.014732,4,0.276453,0.297813,0
舞车(1947),舞车,notion,0,1,1,0,1,1,0.004749,4,0.257108,0.263793,0
航业(1947),航业,notion,0,1,1,0,1,1,0.013711,4,0.275027,0.295469,0
航稿(1947),航稿,notion,0,1,1,0,1,1,0.009035,4,0.265075,0.278404,0
航空(1947),航空,notion,0,1,1,0,1,1,0.00981,4,0.267191,0.28214,0
舵手(1947),舵手,notion,0,1,1,0,1,1,0.013711,4,0.275027,0.295469,0
船头(1947),船头,notion,0,1,1,0,1,1,0.013711,4,0.275027,0.295469,0
良心(1947),良心,notion,0,3,3,0,4,4,0.046135,4,0.331006,0.372455,6671.362925
艰苦(1947),艰苦,notion,0,1,1,0,1,1,0.007422,4,0.26356,0.275695,0
艰难(1947),艰难,notion,0,2,2,0,2,2,0.023891,4,0.292014,0.321969,2116.906395
艺人(1947),艺人,notion,0,1,1,0,4,4,0.00981,4,0.267191,0.28214,0
艺文(1947),艺文,notion,0,2,2,0,8,8,0.028954,4,0.300154,0.333577,2064.821066
艺文志(1947),艺文志,notion,0,1,1,0,1,1,0.014732,4,0.276453,0.297813,0
艺术(1947),艺术,notion,0,3,3,0,13,13,0.040041,4,0.320772,0.360407,6754.232663
艺术家(1947),艺术家,notion,0,1,1,0,2,2,0.00981,4,0.267191,0.28214,0
节制资本(1947),节制资本,notion,0,1,1,0,1,1,0.014222,4,0.275404,0.296091,0
节约(1947),节约,notion,0,3,3,0,3,3,0.045114,4,0.331456,0.372968,7474.911045
花样(1947),花样,notion,0,1,1,0,1,1,0.014081,4,0.275493,0.296238,0
花烛(1947),花烛,notion,0,1,1,0,1,1,0.014732,4,0.276453,0.297813,0
花瓶(1947),花瓶,notion,0,1,1,0,1,1,0.014081,4,0.275493,0.296238,0
花盆(1947),花盆,notion,0,1,1,0,1,1,0.013711,4,0.275027,0.295469,0
芸香(1947),芸香,notion,0,1,1,0,1,1,0.014732,4,0.276453,0.297813,0
苏中(1947),苏中,notion,0,1,1,0,1,1,0.011229,4,0.270366,0.287632,0
苏乎(1947),苏乎,notion,0,1,1,0,1,1,0.009035,4,0.265075,0.278404,0
苏兆征(1947),苏兆征,notion,0,1,1,0,1,1,0.011229,4,0.270366,0.287632,0
苏军(1947),苏军,notion,0,1,1,0,1,1,0.00981,4,0.267191,0.28214,0
苏北(1947),苏北,notion,0,6,6,0,8,8,0.06282,4,0.358957,0.402043,24605.544352
苏南(1947),苏南,notion,0,1,1,0,1,1,0.007422,4,0.26356,0.275695,0
苏州(1947),苏州,notion,0,1,1,0,1,1,0.013711,4,0.275027,0.295469,0
苏式(1947),苏式,notion,0,1,1,0,1,1,0.013711,4,0.275027,0.295469,0
苏皖(1947),苏皖,notion,0,1,1,0,1,1,0.003699,4,0.256009,0.261706,0
苏鲁(1947),苏鲁,notion,0,1,1,0,1,1,0.003699,4,0.256009,0.261706,0
苗得雨(1947),苗得雨,notion,0,1,1,0,1,1,0.013711,4,0.275027,0.295469,0
苗民(1947),苗民,notion,0,1,1,0,1,1,0.014732,4,0.276453,0.297813,0
苗芽(1947),苗芽,notion,0,1,1,0,1,1,0.013711,4,0.275027,0.295469,0
苛杂(1947),苛杂,notion,0,1,1,0,1,1,0.013711,4,0.275027,0.295469,0
若干(1947),若干,notion,0,2,2,0,2,2,0.028954,4,0.300154,0.333577,2064.821066
若要人不知(1947),若要人不知,notion,0,1,1,0,1,1,0.017323,4,0.281723,0.306272,0
苦恼(1947),苦恼,notion,0,1,1,0,1,1,0.014732,4,0.276453,0.297813,0
苦斗(1947),苦斗,notion,0,2,2,0,2,2,0.028552,4,0.301506,0.335445,2588.539662
苦旅(1947),苦旅,notion,0,1,1,0,1,1,0.007422,4,0.26356,0.275695,0
苦痛(1947),苦痛,notion,0,1,1,0,1,1,0.011229,4,0.270366,0.287632,0
苦笑(1947),苦笑,notion,0,1,1,0,1,1,0.014732,4,0.276453,0.297813,0
苦闷(1947),苦闷,notion,0,3,3,0,6,6,0.032681,4,0.30509,0.340376,4018.033625
苦难(1947),苦难,notion,0,4,4,0,8,8,0.053893,4,0.345513,0.388372,13028.914145
英军(1947),英军,notion,0,1,1,0,2,2,0.00981,4,0.267191,0.28214,0
英勇(1947),英勇,notion,0,3,3,0,3,3,0.035771,4,0.311949,0.349385,5932.702117
英商(1947),英商,notion,0,1,1,0,1,1,0.013711,4,0.275027,0.295469,0
英国人(1947),英国人,notion,0,2,2,0,3,3,0.032055,4,0.30624,0.341853,2215.722594
英国工党(1947),英国工党,notion,0,4,4,0,4,4,0.035018,4,0.30679,0.342708,6856.575911
英德(1947),英德,notion,0,2,2,0,2,2,0.02494,4,0.292941,0.323324,1747.290038
英文(1947),英文,notion,0,4,4,0,6,6,0.060357,4,0.356893,0.399907,12921.914509
英法(1947),英法,notion,0,3,3,0,3,3,0.033067,4,0.303059,0.33763,3948.173354
英灵(1947),英灵,notion,0,2,2,0,2,2,0.031545,4,0.305336,0.340645,2219.908318
英烈(1947),英烈,notion,0,1,1,0,1,1,0.014081,4,0.275493,0.296238,0
英镑(1947),英镑,notion,0,1,1,0,1,1,0.00981,4,0.267191,0.28214,0
英雄(1947),英雄,notion,0,4,4,0,8,8,0.053094,4,0.343393,0.386138,12507.957973
英雄主义(1947),英雄主义,notion,0,1,1,0,1,1,0.011229,4,0.270366,0.287632,0
茁长(1947),茁长,notion,0,1,1,0,1,1,0.013711,4,0.275027,0.295469,0
范型(1947),范型,notion,0,1,1,0,1,1,0.007422,4,0.26356,0.275695,0
范文澜(1947),范文澜,notion,0,1,1,0,1,1,0.014222,4,0.275404,0.296091,0
范朴(1947),范朴,notion,0,1,1,0,1,1,0.017323,4,0.281723,0.306272,0
茅盾(1947),茅盾,notion,0,1,1,0,1,1,0.017323,4,0.281723,0.306272,0
茶业(1947),茶业,notion,0,1,1,0,1,1,0.00981,4,0.267191,0.28214,0
草原(1947),草原,notion,0,1,1,0,1,1,0.014732,4,0.276453,0.297813,0
草台(1947),草台,notion,0,1,1,0,1,1,0.014222,4,0.275404,0.296091,0
草拟(1947),草拟,notion,0,1,1,0,1,1,0.00981,4,0.267191,0.28214,0
草根(1947),草根,notion,0,1,1,0,2,2,0.014081,4,0.275493,0.296238,0
草案(1947),草案,notion,0,2,2,0,3,3,0.021502,4,0.288388,0.316586,2245.621531
荒唐(1947),荒唐,notion,0,1,1,0,1,1,0.013711,4,0.275027,0.295469,0
荡漾(1947),荡漾,notion,0,1,1,0,1,1,0.007422,4,0.26356,0.275695,0
荣报(1947),荣报,notion,0,1,1,0,1,1,0.004749,4,0.257108,0.263793,0
药方(1947),药方,notion,0,2,2,0,2,2,0.031545,4,0.305336,0.340645,2219.908318
荷三大(1947),荷三大,notion,0,1,1,0,1,1,0.009035,4,0.265075,0.278404,0
荷兰(1947),荷兰,notion,0,1,1,0,1,1,0.00981,4,0.267191,0.28214,0
荷军(1947),荷军,notion,0,1,1,0,2,2,0.017323,4,0.281723,0.306272,0
荷印(1947),荷印,notion,0,1,1,0,1,1,0.017323,4,0.281723,0.306272,0
荷对(1947),荷对,notion,0,1,1,0,1,1,0.017323,4,0.281723,0.306272,0
荷花淀(1947),荷花淀,notion,0,1,1,0,1,1,0.014732,4,0.276453,0.297813,0
莊严(1947),莊严,notion,0,1,1,0,1,1,0.013711,4,0.275027,0.295469,0
莊稼人(1947),莊稼人,notion,0,1,1,0,1,1,0.014081,4,0.275493,0.296238,0
莎士比亚(1947),莎士比亚,notion,0,1,1,0,1,1,0.014081,4,0.275493,0.296238,0
莎翁(1947),莎翁,notion,0,1,1,0,1,1,0.014081,4,0.275493,0.296238,0
莫再(1947),莫再,notion,0,1,1,0,1,1,0.014732,4,0.276453,0.297813,0
莫斯科市(1947),莫斯科市,notion,0,1,1,0,2,2,0.00981,4,0.267191,0.28214,0
莫泊桑(1947),莫泊桑,notion,0,1,1,0,1,1,0.014081,4,0.275493,0.296238,0
莫知(1947),莫知,notion,0,1,1,0,1,1,0.014222,4,0.275404,0.296091,0
莫要(1947),莫要,notion,0,1,1,0,1,1,0.014732,4,0.276453,0.297813,0
莫过(1947),莫过,notion,0,1,1,0,1,1,0.014222,4,0.275404,0.296091,0
莫迦茨基(1947),莫迦茨基,notion,0,1,1,0,2,2,0.00981,4,0.267191,0.28214,0
莱芜战役(1947),莱芜战役,notion,0,1,1,0,1,1,0.011229,4,0.270366,0.287632,0
莱茵河(1947),莱茵河,notion,0,1,1,0,1,1,0.014732,4,0.276453,0.297813,0
获取(1947),获取,notion,0,1,1,0,1,1,0.00981,4,0.267191,0.28214,0
获奖(1947),获奖,notion,0,1,1,0,8,8,0.014222,4,0.275404,0.296091,0
获得(1947),获得,notion,0,1,1,0,1,1,0.009035,4,0.265075,0.278404,0
获得成功(1947),获得成功,notion,0,1,1,0,1,1,0.017323,4,0.281723,0.306272,0
获致(1947),获致,notion,0,1,1,0,1,1,0.014732,4,0.276453,0.297813,0
获释(1947),获释,notion,0,1,1,0,1,1,0.014732,4,0.276453,0.297813,0
菜单(1947),菜单,notion,0,1,1,0,1,1,0.011229,4,0.270366,0.287632,0
菜园(1947),菜园,notion,0,1,1,0,1,1,0.007422,4,0.26356,0.275695,0
菲列宾(1947),菲列宾,notion,0,1,1,0,1,1,0.00981,4,0.267191,0.28214,0
菲尔(1947),菲尔,notion,0,1,1,0,1,1,0.014732,4,0.276453,0.297813,0
菲律宾(1947),菲律宾,notion,0,1,1,0,1,1,0.00981,4,0.267191,0.28214,0
菲政府(1947),菲政府,notion,0,1,1,0,1,1,0.013711,4,0.275027,0.295469,0
萌芽(1947),萌芽,notion,0,1,1,0,1,1,0.014222,4,0.275404,0.296091,0
营养(1947),营养,notion,0,1,1,0,1,1,0.007422,4,0.26356,0.275695,0
营口(1947),营口,notion,0,1,1,0,1,1,0.007422,4,0.26356,0.275695,0
营救(1947),营救,notion,0,2,2,0,2,2,0.032055,4,0.30624,0.341853,2215.722594
萧伯纳(1947),萧伯纳,notion,0,1,1,0,1,1,0.017323,4,0.281723,0.306272,0
萧红(1947),萧红,notion,0,2,2,0,2,2,0.018431,4,0.28119,0.30549,1040.874592
萧邦(1947),萧邦,notion,0,1,1,0,1,1,0.014732,4,0.276453,0.297813,0
萨洛扬(1947),萨洛扬,notion,0,1,1,0,1,1,0.014732,4,0.276453,0.297813,0
萨空了(1947),萨空了,notion,0,1,1,0,1,1,0.009035,4,0.265075,0.278404,0
落地(1947),落地,notion,0,1,1,0,1,1,0.007422,4,0.26356,0.275695,0
葛罗米柯(1947),葛罗米柯,notion,0,1,1,0,1,1,0.009035,4,0.265075,0.278404,0
葡萄糖(1947),葡萄糖,notion,0,1,1,0,1,1,0.014732,4,0.276453,0.297813,0
董显光(1947),董显光,notion,0,1,1,0,1,1,0.017323,4,0.281723,0.306272,0
葫芦(1947),葫芦,notion,0,1,1,0,1,1,0.017323,4,0.281723,0.306272,0
葬送(1947),葬送,notion,0,1,1,0,1,1,0.014732,4,0.276453,0.297813,0
蒋区(1947),蒋区,notion,0,1,1,0,2,2,0.013711,4,0.275027,0.295469,0
蒋后(1947),蒋后,notion,0,1,1,0,1,1,0.011229,4,0.270366,0.287632,0
蒋后战(1947),蒋后战,notion,0,1,1,0,1,1,0.013711,4,0.275027,0.295469,0
蒋宋(1947),蒋宋,notion,0,1,1,0,1,1,0.013711,4,0.275027,0.295469,0
蒋家(1947),蒋家,notion,0,1,1,0,1,1,0.011229,4,0.270366,0.287632,0
蒋府(1947),蒋府,notion,0,1,1,0,1,1,0.013711,4,0.275027,0.295469,0
蒋朝(1947),蒋朝,notion,0,1,1,0,1,1,0.013711,4,0.275027,0.295469,0
蒋美(1947),蒋美,notion,0,1,1,0,1,1,0.013711,4,0.275027,0.295469,0
蒙古(1947),蒙古,notion,0,1,1,0,1,1,0.017323,4,0.281723,0.306272,0
蒙混(1947),蒙混,notion,0,1,1,0,1,1,0.014732,4,0.276453,0.297813,0
蒙高茂莱(1947),蒙高茂莱,notion,0,1,1,0,1,1,0.00981,4,0.267191,0.28214,0
蒲剑(1947),蒲剑,notion,0,1,1,0,1,1,0.014732,4,0.276453,0.297813,0
蓝色(1947),蓝色,notion,0,2,2,0,2,2,0.024542,4,0.292264,0.322335,1826.657886
蓬勃(1947),蓬勃,notion,0,1,1,0,1,1,0.017323,4,0.281723,0.306272,0
蔡劲(1947),蔡劲,notion,0,1,1,0,1,1,0.011229,4,0.270366,0.287632,0
蔡劲军(1947),蔡劲军,notion,0,1,1,0,1,1,0.011229,4,0.270366,0.287632,0
薇拉(1947),薇拉,notion,0,1,1,0,1,1,0.00981,4,0.267191,0.28214,0
薛众(1947),薛众,notion,0,1,1,0,1,1,0.017323,4,0.281723,0.306272,0
藉以(1947),藉以,notion,0,1,1,0,1,1,0.014081,4,0.275493,0.296238,0
虎胆(1947),虎胆,notion,0,1,1,0,1,1,0.014732,4,0.276453,0.297813,0
虐政(1947),虐政,notion,0,1,1,0,1,1,0.013711,4,0.275027,0.295469,0
虐杀(1947),虐杀,notion,0,1,1,0,1,1,0.017323,4,0.281723,0.306272,0
虚空(1947),虚空,notion,0,1,1,0,1,1,0.009035,4,0.265075,0.278404,0
虽然(1947),虽然,notion,0,1,1,0,1,1,0.014081,4,0.275493,0.296238,0
蚌埠(1947),蚌埠,notion,0,1,1,0,1,1,0.014081,4,0.275493,0.296238,0
蚕妇(1947),蚕妇,notion,0,1,1,0,1,1,0.017323,4,0.281723,0.306272,0
蚕灾(1947),蚕灾,notion,0,1,1,0,1,1,0.014081,4,0.275493,0.296238,0
蛇鼠(1947),蛇鼠,notion,0,1,1,0,1,1,0.013711,4,0.275027,0.295469,0
蜂起(1947),蜂起,notion,0,1,1,0,1,1,0.011229,4,0.270366,0.287632,0
蜉蝣(1947),蜉蝣,notion,0,1,1,0,1,1,0.013711,4,0.275027,0.295469,0
蜕变(1947),蜕变,notion,0,2,2,0,2,2,0.023767,4,0.289685,0.318527,1452.186204
蠡测(1947),蠡测,notion,0,1,1,0,1,1,0.009035,4,0.265075,0.278404,0
蠢猪(1947),蠢猪,notion,0,1,1,0,1,1,0.013711,4,0.275027,0.295469,0
血债(1947),血债,notion,0,3,3,0,4,4,0.03475,4,0.309488,0.346199,5532.888574
血偿(1947),血偿,notion,0,1,1,0,1,1,0.011229,4,0.270366,0.287632,0
血手(1947),血手,notion,0,1,1,0,1,1,0.011229,4,0.270366,0.287632,0
血案(1947),血案,notion,0,1,1,0,1,1,0.013711,4,0.275027,0.295469,0
血汗钱(1947),血汗钱,notion,0,1,1,0,1,1,0.011229,4,0.270366,0.287632,0
血泪(1947),血泪,notion,0,4,4,0,5,5,0.053752,4,0.345374,0.388226,13094.543338
血洗(1947),血洗,notion,0,1,1,0,1,1,0.011229,4,0.270366,0.287632,0
血海深仇(1947),血海深仇,notion,0,1,1,0,1,1,0.011229,4,0.270366,0.287632,0
血腥(1947),血腥,notion,0,2,2,0,2,2,0.028552,4,0.301506,0.335445,2588.539662
血迹(1947),血迹,notion,0,1,1,0,1,1,0.011229,4,0.270366,0.287632,0
行为(1947),行为,notion,0,1,1,0,3,3,0.014222,4,0.275404,0.296091,0
行列(1947),行列,notion,0,3,3,0,4,4,0.023179,4,0.286187,0.313315,2162.134623
行动(1947),行动,notion,0,5,5,0,8,8,0.055661,4,0.345723,0.388653,15373.814871
行动者(1947),行动者,notion,0,1,1,0,2,2,0.009035,4,0.265075,0.278404,0
行役(1947),行役,notion,0,1,1,0,1,1,0.014222,4,0.275404,0.296091,0
行径(1947),行径,notion,0,1,1,0,1,1,0.011229,4,0.270366,0.287632,0
行止(1947),行止,notion,0,1,1,0,1,1,0.014222,4,0.275404,0.296091,0
行爲(1947),行爲,notion,0,1,1,0,1,1,0.014081,4,0.275493,0.296238,0
行矣(1947),行矣,notion,0,1,1,0,1,1,0.017323,4,0.281723,0.306272,0
行知(1947),行知,notion,0,1,1,0,1,1,0.003588,4,0.255396,0.260534,0
行车(1947),行车,notion,0,1,1,0,1,1,0.007422,4,0.26356,0.275695,0
街之战(1947),街之战,notion,0,1,1,0,1,1,0.014081,4,0.275493,0.296238,0
街头诗(1947),街头诗,notion,0,1,1,0,2,2,0.013711,4,0.275027,0.295469,0
街战(1947),街战,notion,0,1,1,0,1,1,0.00981,4,0.267191,0.28214,0
衡山(1947),衡山,notion,0,2,2,0,2,2,0.018845,4,0.280243,0.303989,1083.402703
衣冠冢(1947),衣冠冢,notion,0,1,1,0,1,1,0.014081,4,0.275493,0.296238,0
衣包(1947),衣包,notion,0,1,1,0,1,1,0.017323,4,0.281723,0.306272,0
补充(1947),补充,notion,0,1,1,0,2,2,0.014081,4,0.275493,0.296238,0
补救(1947),补救,notion,0,2,2,0,2,2,0.021644,4,0.28732,0.314975,1747.667055
补正(1947),补正,notion,0,1,1,0,1,1,0.014081,4,0.275493,0.296238,0
补漏(1947),补漏,notion,0,1,1,0,1,1,0.014081,4,0.275493,0.296238,0
补遗(1947),补遗,notion,0,1,1,0,1,1,0.014081,4,0.275493,0.296238,0
表扬(1947),表扬,notion,0,1,1,0,1,1,0.014222,4,0.275404,0.296091,0
表明态度(1947),表明态度,notion,0,1,1,0,1,1,0.014081,4,0.275493,0.296238,0
表现(1947),表现,notion,0,4,4,0,5,5,0.04479,4,0.325483,0.366108,8974.959581
表示(1947),表示,notion,0,3,3,0,5,5,0.045626,4,0.330014,0.37132,6615.755609
表象(1947),表象,notion,0,1,1,0,1,1,0.014732,4,0.276453,0.297813,0
衰亡(1947),衰亡,notion,0,1,1,0,1,1,0.014732,4,0.276453,0.297813,0
衰落(1947),衰落,notion,0,1,1,0,1,1,0.017323,4,0.281723,0.306272,0
袁世凯(1947),袁世凯,notion,0,1,1,0,1,1,0.013711,4,0.275027,0.295469,0
袁俊(1947),袁俊,notion,0,1,1,0,1,1,0.014732,4,0.276453,0.297813,0
袁雪芬(1947),袁雪芬,notion,0,1,1,0,1,1,0.014732,4,0.276453,0.297813,0
袒护(1947),袒护,notion,0,1,1,0,1,1,0.009035,4,0.265075,0.278404,0
袖手旁观(1947),袖手旁观,notion,0,1,1,0,1,1,0.011229,4,0.270366,0.287632,0
袜厂(1947),袜厂,notion,0,1,1,0,1,1,0.007422,4,0.26356,0.275695,0
被俘(1947),被俘,notion,0,1,1,0,2,2,0.011229,4,0.270366,0.287632,0
被封(1947),被封,notion,0,1,1,0,1,1,0.013711,4,0.275027,0.295469,0
被歼(1947),被歼,notion,0,1,1,0,1,1,0.011229,4,0.270366,0.287632,0
被禁(1947),被禁,notion,0,1,1,0,1,1,0.017323,4,0.281723,0.306272,0
被释(1947),被释,notion,0,1,1,0,1,1,0.017323,4,0.281723,0.306272,0
袭击(1947),袭击,notion,0,2,2,0,2,2,0.02494,4,0.292941,0.323324,1747.290038
裁军(1947),裁军,notion,0,3,3,0,3,3,0.024627,4,0.290548,0.31987,3229.451063
装备(1947),装备,notion,0,1,1,0,2,2,0.013711,4,0.275027,0.295469,0
装得(1947),装得,notion,0,1,1,0,1,1,0.013711,4,0.275027,0.295469,0
装束(1947),装束,notion,0,1,1,0,1,1,0.014732,4,0.276453,0.297813,0
装穷(1947),装穷,notion,0,1,1,0,1,1,0.013711,4,0.275027,0.295469,0
装饰(1947),装饰,notion,0,1,1,0,1,1,0.00981,4,0.267191,0.28214,0
装饰画(1947),装饰画,notion,0,1,1,0,1,1,0.014732,4,0.276453,0.297813,0
裤子(1947),裤子,notion,0,1,1,0,1,1,0.013711,4,0.275027,0.295469,0
製造(1947),製造,notion,0,1,1,0,2,2,0.013711,4,0.275027,0.295469,0
製造家(1947),製造家,notion,0,1,1,0,1,1,0.014222,4,0.275404,0.296091,0
西亚(1947),西亚,notion,0,1,1,0,1,1,0.00981,4,0.267191,0.28214,0
西伯利亚(1947),西伯利亚,notion,0,1,1,0,1,1,0.014222,4,0.275404,0.296091,0
西化(1947),西化,notion,0,1,1,0,1,1,0.014081,4,0.275493,0.296238,0
西北(1947),西北,notion,0,3,3,0,3,3,0.042774,4,0.326479,0.367218,7162.216692
西半球(1947),西半球,notion,0,1,1,0,1,1,0.017323,4,0.281723,0.306272,0
西南(1947),西南,notion,0,2,2,0,2,2,0.028442,4,0.300022,0.333394,2187.730369
西南航空(1947),西南航空,notion,0,1,1,0,1,1,0.014081,4,0.275493,0.296238,0
西大(1947),西大,notion,0,1,1,0,1,1,0.011229,4,0.270366,0.287632,0
西安(1947),西安,notion,0,3,3,0,5,5,0.031379,4,0.303544,0.338289,3965.132825
西方(1947),西方,notion,0,1,1,0,1,1,0.007422,4,0.26356,0.275695,0
西欧(1947),西欧,notion,0,3,3,0,4,4,0.041214,4,0.322074,0.361982,6317.925086
西段(1947),西段,notion,0,1,1,0,1,1,0.014081,4,0.275493,0.296238,0
西江(1947),西江,notion,0,1,1,0,11,11,0.011229,4,0.270366,0.287632,0
西洋(1947),西洋,notion,0,1,1,0,1,1,0.014222,4,0.275404,0.296091,0
西班牙(1947),西班牙,notion,0,1,1,0,1,1,0.017323,4,0.281723,0.306272,0
西蒙诺夫(1947),西蒙诺夫,notion,0,1,1,0,1,1,0.014732,4,0.276453,0.297813,0
西部(1947),西部,notion,0,1,1,0,1,1,0.014081,4,0.275493,0.296238,0
要事(1947),要事,notion,0,1,1,0,1,1,0.011229,4,0.270366,0.287632,0
要人推(1947),要人推,notion,0,1,1,0,1,1,0.014081,4,0.275493,0.296238,0
要件(1947),要件,notion,0,1,1,0,1,1,0.007422,4,0.26356,0.275695,0
要务(1947),要务,notion,0,1,1,0,1,1,0.014222,4,0.275404,0.296091,0
要合(1947),要合,notion,0,1,1,0,1,1,0.004749,4,0.257108,0.263793,0
要点(1947),要点,notion,0,1,1,0,3,3,0.007422,4,0.26356,0.275695,0
要素(1947),要素,notion,0,2,2,0,3,3,0.021644,4,0.28732,0.314975,1747.667055
要钱(1947),要钱,notion,0,1,1,0,1,1,0.014732,4,0.276453,0.297813,0
要顺(1947),要顺,notion,0,1,1,0,1,1,0.004749,4,0.257108,0.263793,0
要饭(1947),要饭,notion,0,1,1,0,1,1,0.013711,4,0.275027,0.295469,0
覆减(1947),覆减,notion,0,1,1,0,1,1,0.011229,4,0.270366,0.287632,0
覆判(1947),覆判,notion,0,1,1,0,1,1,0.017323,4,0.281723,0.306272,0
覆文(1947),覆文,notion,0,1,1,0,1,1,0.00981,4,0.267191,0.28214,0
覆没(1947),覆没,notion,0,1,1,0,1,1,0.011229,4,0.270366,0.287632,0
覆辙(1947),覆辙,notion,0,1,1,0,1,1,0.014222,4,0.275404,0.296091,0
见的(1947),见的,notion,0,1,1,0,1,1,0.000869,4,0.251131,0.252222,0
见解(1947),见解,notion,0,1,1,0,1,1,0.014222,4,0.275404,0.296091,0
见闻(1947),见闻,notion,0,5,5,0,7,7,0.057962,4,0.352289,0.395391,17907.216594
见闻录(1947),见闻录,notion,0,1,1,0,1,1,0.017323,4,0.281723,0.306272,0
观众(1947),观众,notion,0,1,1,0,1,1,0.014732,4,0.276453,0.297813,0
观念(1947),观念,notion,0,4,4,0,4,4,0.03726,4,0.30946,0.346223,6196.520409
观日华(1947),观日华,notion,0,1,1,0,1,1,0.014222,4,0.275404,0.296091,0
观测(1947),观测,notion,0,1,1,0,1,1,0.014222,4,0.275404,0.296091,0
规定(1947),规定,notion,0,1,1,0,1,1,0.014081,4,0.275493,0.296238,0
视察(1947),视察,notion,0,1,1,0,1,1,0.014222,4,0.275404,0.296091,0
觉得(1947),觉得,notion,0,1,1,0,1,1,0.013711,4,0.275027,0.295469,0
觉悟(1947),觉悟,notion,0,2,2,0,2,2,0.012624,4,0.269533,0.286265,548.418626
觉醒(1947),觉醒,notion,0,1,1,0,1,1,0.017323,4,0.281723,0.306272,0
角逐(1947),角逐,notion,0,1,1,0,1,1,0.009035,4,0.265075,0.278404,0
解决问题(1947),解决问题,notion,0,1,1,0,1,1,0.007422,4,0.26356,0.275695,0
解冻(1947),解冻,notion,0,1,1,0,1,1,0.014732,4,0.276453,0.297813,0
解放军(1947),解放军,notion,0,1,1,0,1,1,0.011229,4,0.270366,0.287632,0
解放战争(1947),解放战争,notion,0,1,1,0,1,1,0.017323,4,0.281723,0.306272,0
解放运动(1947),解放运动,notion,0,3,3,0,3,3,0.035771,4,0.311949,0.349385,5932.702117
解放阵线(1947),解放阵线,notion,0,1,1,0,1,1,0.017323,4,0.281723,0.306272,0
解救(1947),解救,notion,0,3,3,0,3,3,0.025013,4,0.289685,0.318588,2959.080139
解散(1947),解散,notion,0,4,4,0,8,8,0.059987,4,0.358354,0.401335,13771.233391
解民倒悬(1947),解民倒悬,notion,0,1,1,0,1,1,0.004749,4,0.257108,0.263793,0
解答(1947),解答,notion,0,3,3,0,3,3,0.042774,4,0.326479,0.367218,7162.216692
解聘(1947),解聘,notion,0,2,2,0,2,2,0.032055,4,0.30624,0.341853,2215.722594
解除(1947),解除,notion,0,2,2,0,2,2,0.01897,4,0.280427,0.304282,657.210893
触礁(1947),触礁,notion,0,1,1,0,1,1,0.00981,4,0.267191,0.28214,0
言行(1947),言行,notion,0,1,1,0,1,1,0.014222,4,0.275404,0.296091,0
言论自由(1947),言论自由,notion,0,2,2,0,3,3,0.027791,4,0.29968,0.332918,2405.290268
誓师(1947),誓师,notion,0,1,1,0,1,1,0.011229,4,0.270366,0.287632,0
證实(1947),證实,notion,0,1,1,0,1,1,0.014081,4,0.275493,0.296238,0
警宪(1947),警宪,notion,0,1,1,0,1,1,0.017323,4,0.281723,0.306272,0
警察(1947),警察,notion,0,2,2,0,2,2,0.022746,4,0.288631,0.316952,1575.703869
警惕(1947),警惕,notion,0,1,1,0,1,1,0.014732,4,0.276453,0.297813,0
警戒(1947),警戒,notion,0,1,1,0,1,1,0.017323,4,0.281723,0.306272,0
警报(1947),警报,notion,0,2,2,0,2,2,0.032055,4,0.30624,0.341853,2215.722594
警觉(1947),警觉,notion,0,1,1,0,1,1,0.007422,4,0.26356,0.275695,0
计画(1947),计画,notion,0,2,2,0,2,2,0.028812,4,0.299917,0.333248,2025.61524
订正(1947),订正,notion,0,1,1,0,1,1,0.014732,4,0.276453,0.297813,0
讨价还价(1947),讨价还价,notion,0,1,1,0,1,1,0.00981,4,0.267191,0.28214,0
让给(1947),让给,notion,0,1,1,0,1,1,0.014081,4,0.275493,0.296238,0
训政(1947),训政,notion,0,1,1,0,1,1,0.009035,4,0.265075,0.278404,0
训练团(1947),训练团,notion,0,1,1,0,1,1,0.011229,4,0.270366,0.287632,0
议会选举(1947),议会选举,notion,0,1,1,0,1,1,0.013711,4,0.275027,0.295469,0
议员(1947),议员,notion,0,1,1,0,1,1,0.017323,4,0.281723,0.306272,0
议案(1947),议案,notion,0,1,1,0,1,1,0.014081,4,0.275493,0.296238,0
议程(1947),议程,notion,0,1,1,0,1,1,0.014222,4,0.275404,0.296091,0
记历(1947),记历,notion,0,1,1,0,1,1,0.007422,4,0.26356,0.275695,0
记取(1947),记取,notion,0,1,1,0,1,1,0.007422,4,0.26356,0.275695,0
记录(1947),记录,notion,0,1,1,0,1,1,0.014081,4,0.275493,0.296238,0
记教电(1947),记教电,notion,0,1,1,0,1,1,0.007422,4,0.26356,0.275695,0
记新(1947),记新,notion,0,1,1,0,1,1,0.002092,4,0.25318,0.25625,0
记泛(1947),记泛,notion,0,1,1,0,1,1,0.017323,4,0.281723,0.306272,0
记燕大(1947),记燕大,notion,0,1,1,0,3,3,0.013711,4,0.275027,0.295469,0
记者会(1947),记者会,notion,0,1,1,0,1,1,0.017323,4,0.281723,0.306272,0
记载(1947),记载,notion,0,2,2,0,2,2,0.031404,4,0.30602,0.34156,2430.025091
记陈达(1947),记陈达,notion,0,1,1,0,1,1,0.014081,4,0.275493,0.296238,0
讲学(1947),讲学,notion,0,1,1,0,1,1,0.014081,4,0.275493,0.296238,0
讲座(1947),讲座,notion,0,1,1,0,6,6,0.007422,4,0.26356,0.275695,0
讲演(1947),讲演,notion,0,2,2,0,4,4,0.028954,4,0.300154,0.333577,2064.821066
讲话(1947),讲话,notion,0,1,1,0,1,1,0.013711,4,0.275027,0.295469,0
许寿棠(1947),许寿棠,notion,0,1,1,0,1,1,0.014732,4,0.276453,0.297813,0
论争(1947),论争,notion,0,1,1,0,1,1,0.014732,4,0.276453,0.297813,0
论坛(1947),论坛,notion,0,2,2,0,2,2,0.028302,4,0.298866,0.331783,1965.8222
论坛报(1947),论坛报,notion,0,1,1,0,1,1,0.003588,4,0.255396,0.260534,0
论战(1947),论战,notion,0,2,2,0,2,2,0.028812,4,0.299917,0.333248,2025.61524
论文(1947),论文,notion,0,1,1,0,1,1,0.014222,4,0.275404,0.296091,0
论辩(1947),论辩,notion,0,1,1,0,1,1,0.011229,4,0.270366,0.287632,0
论述(1947),论述,notion,0,1,1,0,1,1,0.013711,4,0.275027,0.295469,0
讽刺(1947),讽刺,notion,0,2,2,0,2,2,0.028442,4,0.300022,0.333394,2187.730369
讽刺诗(1947),讽刺诗,notion,0,1,1,0,1,1,0.00981,4,0.267191,0.28214,0
设施(1947),设施,notion,0,1,1,0,1,1,0.014222,4,0.275404,0.296091,0
设计(1947),设计,notion,0,1,1,0,1,1,0.014222,4,0.275404,0.296091,0
设防(1947),设防,notion,0,1,1,0,1,1,0.017323,4,0.281723,0.306272,0
访加(1947),访加,notion,0,1,1,0,1,1,0.017323,4,0.281723,0.306272,0
访华(1947),访华,notion,0,3,3,0,3,3,0.037848,4,0.312921,0.35063,4836.024023
访华团(1947),访华团,notion,0,1,1,0,1,1,0.017323,4,0.281723,0.306272,0
访欧(1947),访欧,notion,0,1,1,0,1,1,0.011229,4,0.270366,0.287632,0
访英(1947),访英,notion,0,1,1,0,1,1,0.009035,4,0.265075,0.278404,0
访问(1947),访问,notion,0,2,2,0,2,2,0.02531,4,0.2954,0.326876,2496.768821
访问记(1947),访问记,notion,0,4,4,0,7,7,0.045054,4,0.326541,0.367353,9292.492648
证据(1947),证据,notion,0,1,1,0,1,1,0.00981,4,0.267191,0.28214,0
诃德(1947),诃德,notion,0,1,1,0,1,1,0.014732,4,0.276453,0.297813,0
评中(1947),评中,notion,0,1,1,0,1,1,0.014081,4,0.275493,0.296238,0
评介(1947),评介,notion,0,2,2,0,2,2,0.025961,4,0.295759,0.327389,2231.848602
评刘大中(1947),评刘大中,notion,0,1,1,0,1,1,0.004749,4,0.257108,0.263793,0
评判(1947),评判,notion,0,1,1,0,1,1,0.014081,4,0.275493,0.296238,0
评熊伟(1947),评熊伟,notion,0,1,1,0,1,1,0.014732,4,0.276453,0.297813,0
评省(1947),评省,notion,0,1,1,0,1,1,0.011229,4,0.270366,0.287632,0
评蒲(1947),评蒲,notion,0,1,1,0,1,1,0.014081,4,0.275493,0.296238,0
评论家(1947),评论家,notion,0,1,1,0,1,1,0.014732,4,0.276453,0.297813,0
评论界(1947),评论界,notion,0,1,1,0,1,1,0.011229,4,0.270366,0.287632,0
评语(1947),评语,notion,0,1,1,0,1,1,0.009035,4,0.265075,0.278404,0
评述(1947),评述,notion,0,1,1,0,2,2,0.014222,4,0.275404,0.296091,0
识时务(1947),识时务,notion,0,1,1,0,1,1,0.003588,4,0.255396,0.260534,0
识货者(1947),识货者,notion,0,1,1,0,1,1,0.013711,4,0.275027,0.295469,0
诊疗(1947),诊疗,notion,0,1,1,0,1,1,0.007422,4,0.26356,0.275695,0
译名(1947),译名,notion,0,1,1,0,1,1,0.014081,4,0.275493,0.296238,0
译自(1947),译自,notion,0,2,2,0,2,2,0.013398,4,0.271635,0.289854,656.368623
试探(1947),试探,notion,0,2,2,0,5,5,0.028812,4,0.299917,0.333248,2025.61524
试炼(1947),试炼,notion,0,1,1,0,1,1,0.013711,4,0.275027,0.295469,0
试练(1947),试练,notion,0,1,1,0,1,1,0.007422,4,0.26356,0.275695,0
试题(1947),试题,notion,0,1,1,0,1,1,0.014732,4,0.276453,0.297813,0
试验(1947),试验,notion,0,1,1,0,1,1,0.017323,4,0.281723,0.306272,0
诗与画(1947),诗与画,notion,0,1,1,0,2,2,0.013711,4,0.275027,0.295469,0
诗二首(1947),诗二首,notion,0,2,2,0,2,2,0.018431,4,0.28119,0.30549,1040.874592
诗人(1947),诗人,notion,0,5,5,0,7,7,0.055921,4,0.346074,0.389019,15485.213326
诗文(1947),诗文,notion,0,1,1,0,1,1,0.014222,4,0.275404,0.296091,0
诗赋(1947),诗赋,notion,0,1,1,0,1,1,0.009035,4,0.265075,0.278404,0
诗辑(1947),诗辑,notion,0,1,1,0,1,1,0.014732,4,0.276453,0.297813,0
诗钞(1947),诗钞,notion,0,1,1,0,1,1,0.011229,4,0.270366,0.287632,0
诗集(1947),诗集,notion,0,1,1,0,1,1,0.014732,4,0.276453,0.297813,0
诚挚(1947),诚挚,notion,0,1,1,0,1,1,0.014222,4,0.275404,0.296091,0
话题(1947),话题,notion,0,1,1,0,1,1,0.011229,4,0.270366,0.287632,0
诞育(1947),诞育,notion,0,1,1,0,1,1,0.007422,4,0.26356,0.275695,0
诞辰(1947),诞辰,notion,0,2,2,0,5,5,0.027133,4,0.29671,0.328744,1770.9936
诤告(1947),诤告,notion,0,1,1,0,1,1,0.009035,4,0.265075,0.278404,0
该不该(1947),该不该,notion,0,1,1,0,1,1,0.014222,4,0.275404,0.296091,0
详情(1947),详情,notion,0,1,1,0,1,1,0.009035,4,0.265075,0.278404,0
详记(1947),详记,notion,0,1,1,0,1,1,0.014081,4,0.275493,0.296238,0
语录(1947),语录,notion,0,1,1,0,1,1,0.014081,4,0.275493,0.296238,0
语文(1947),语文,notion,0,1,1,0,1,1,0.014732,4,0.276453,0.297813,0
语言(1947),语言,notion,0,1,1,0,1,1,0.009035,4,0.265075,0.278404,0
误会(1947),误会,notion,0,1,1,0,1,1,0.014081,4,0.275493,0.296238,0
误解(1947),误解,notion,0,2,2,0,2,2,0.01217,4,0.269981,0.287034,858.702851
诱导(1947),诱导,notion,0,1,1,0,1,1,0.014222,4,0.275404,0.296091,0
说教(1947),说教,notion,0,1,1,0,1,1,0.011229,4,0.270366,0.287632,0
说明书(1947),说明书,notion,0,1,1,0,1,1,0.014222,4,0.275404,0.296091,0
说话(1947),说话,notion,0,1,1,0,1,1,0.017323,4,0.281723,0.306272,0
请勿(1947),请勿,notion,0,1,1,0,1,1,0.017323,4,0.281723,0.306272,0
请君一(1947),请君一,notion,0,1,1,0,1,1,0.013711,4,0.275027,0.295469,0
请求(1947),请求,notion,0,1,1,0,1,1,0.017323,4,0.281723,0.306272,0
请进来(1947),请进来,notion,0,1,1,0,1,1,0.013711,4,0.275027,0.295469,0
请问(1947),请问,notion,0,1,1,0,1,1,0.013711,4,0.275027,0.295469,0
诸公(1947),诸公,notion,0,1,1,0,1,1,0.009035,4,0.265075,0.278404,0
诸君(1947),诸君,notion,0,1,1,0,1,1,0.014732,4,0.276453,0.297813,0
诸氏(1947),诸氏,notion,0,1,1,0,1,1,0.004749,4,0.257108,0.263793,0
诺文斯克(1947),诺文斯克,notion,0,1,1,0,1,1,0.00981,4,0.267191,0.28214,0
读了(1947),读了,notion,0,1,1,0,1,1,0.011229,4,0.270366,0.287632,0
读傅(1947),读傅,notion,0,1,1,0,1,1,0.00981,4,0.267191,0.28214,0
读后(1947),读后,notion,0,4,4,0,5,5,0.029507,4,0.298814,0.331832,5330.607499
读后感(1947),读后感,notion,0,1,1,0,1,1,0.017323,4,0.281723,0.306272,0
读孙(1947),读孙,notion,0,1,1,0,1,1,0.009035,4,0.265075,0.278404,0
读报(1947),读报,notion,0,2,2,0,2,2,0.027791,4,0.29968,0.332918,2405.290268
读物(1947),读物,notion,0,1,1,0,1,1,0.007422,4,0.26356,0.275695,0
课题(1947),课题,notion,0,3,3,0,3,3,0.032873,4,0.307536,0.343636,6118.645654
谁是(1947),谁是,notion,0,1,1,0,1,1,0.011229,4,0.270366,0.287632,0
谁知(1947),谁知,notion,0,1,1,0,1,1,0.017323,4,0.281723,0.306272,0
调和(1947),调和,notion,0,3,3,0,3,3,0.030058,4,0.299601,0.332869,3641.773691
调处(1947),调处,notion,0,2,2,0,2,2,0.012624,4,0.269533,0.286265,548.418626
调整(1947),调整,notion,0,2,2,0,3,3,0.018431,4,0.28119,0.30549,1040.874592
调查团(1947),调查团,notion,0,2,2,0,2,2,0.018829,4,0.280473,0.304355,655.354404
调解(1947),调解,notion,0,1,1,0,1,1,0.009035,4,0.265075,0.278404,0
谈中印(1947),谈中印,notion,0,1,1,0,1,1,0.014222,4,0.275404,0.296091,0
谈为学(1947),谈为学,notion,0,1,1,0,1,1,0.014222,4,0.275404,0.296091,0
谈伍(1947),谈伍,notion,0,1,1,0,1,1,0.014081,4,0.275493,0.296238,0
谈其(1947),谈其,notion,0,1,1,0,1,1,0.004749,4,0.257108,0.263793,0
谈到(1947),谈到,notion,0,4,4,0,4,4,0.053187,4,0.346953,0.389874,14836.460598
谈国(1947),谈国,notion,0,1,1,0,1,1,0.017323,4,0.281723,0.306272,0
谈援(1947),谈援,notion,0,1,1,0,1,1,0.017323,4,0.281723,0.306272,0
谈片(1947),谈片,notion,0,1,1,0,3,3,0.014222,4,0.275404,0.296091,0
谈生(1947),谈生,notion,0,1,1,0,1,1,0.011229,4,0.270366,0.287632,0
谈话录(1947),谈话录,notion,0,1,1,0,1,1,0.017323,4,0.281723,0.306272,0
谈谈(1947),谈谈,notion,0,3,3,0,3,3,0.023964,4,0.289292,0.318002,3466.302762
谈起(1947),谈起,notion,0,4,4,0,5,5,0.04275,4,0.322774,0.362885,8750.502266
谈选(1947),谈选,notion,0,1,1,0,1,1,0.009035,4,0.265075,0.278404,0
谋取(1947),谋取,notion,0,1,1,0,1,1,0.007422,4,0.26356,0.275695,0
谋求(1947),谋求,notion,0,1,1,0,1,1,0.017323,4,0.281723,0.306272,0
谜一样(1947),谜一样,notion,0,1,1,0,1,1,0.017323,4,0.281723,0.306272,0
谣传(1947),谣传,notion,0,1,1,0,1,1,0.017323,4,0.281723,0.306272,0
谦逊(1947),谦逊,notion,0,1,1,0,1,1,0.013711,4,0.275027,0.295469,0
谨慎(1947),谨慎,notion,0,1,1,0,1,1,0.007422,4,0.26356,0.275695,0
谨防(1947),谨防,notion,0,1,1,0,1,1,0.014222,4,0.275404,0.296091,0
谬论(1947),谬论,notion,0,2,2,0,2,2,0.024032,4,0.290894,0.320321,1695.498775
豆饼(1947),豆饼,notion,0,1,1,0,1,1,0.007422,4,0.26356,0.275695,0
象徵(1947),象徵,notion,0,1,1,0,1,1,0.014081,4,0.275493,0.296238,0
象棋(1947),象棋,notion,0,1,1,0,1,1,0.00981,4,0.267191,0.28214,0
豪富(1947),豪富,notion,0,1,1,0,1,1,0.014081,4,0.275493,0.296238,0
豪门(1947),豪门,notion,0,3,3,0,6,6,0.027865,4,0.292891,0.323312,2463.553817
豫北(1947),豫北,notion,0,1,1,0,1,1,0.013711,4,0.275027,0.295469,0
豫皖(1947),豫皖,notion,0,1,1,0,1,1,0.003699,4,0.256009,0.261706,0
豫西(1947),豫西,notion,0,1,1,0,1,1,0.014081,4,0.275493,0.296238,0
贝文(1947),贝文,notion,0,2,2,0,2,2,0.025451,4,0.295094,0.326437,2353.768712
贝柏提(1947),贝柏提,notion,0,1,1,0,1,1,0.017323,4,0.281723,0.306272,0
负责(1947),负责,notion,0,2,2,0,2,2,0.02531,4,0.2954,0.326876,2496.768821
负责人(1947),负责人,notion,0,1,1,0,1,1,0.014732,4,0.276453,0.297813,0
贡献(1947),贡献,notion,0,1,1,0,1,1,0.014222,4,0.275404,0.296091,0
财与(1947),财与,notion,0,1,1,0,1,1,0.014732,4,0.276453,0.297813,0
财产(1947),财产,notion,0,2,2,0,2,2,0.031034,4,0.30613,0.341707,2639.595687
财产税(1947),财产税,notion,0,1,1,0,1,1,0.002092,4,0.25318,0.25625,0
财富(1947),财富,notion,0,1,1,0,2,2,0.014081,4,0.275493,0.296238,0
财政政策(1947),财政政策,notion,0,2,2,0,2,2,0.031404,4,0.30602,0.34156,2430.025091
财阀(1947),财阀,notion,0,1,1,0,1,1,0.00981,4,0.267191,0.28214,0
责任内阁(1947),责任内阁,notion,0,1,1,0,1,1,0.014081,4,0.275493,0.296238,0
责任制(1947),责任制,notion,0,1,1,0,1,1,0.014222,4,0.275404,0.296091,0
贤明(1947),贤明,notion,0,1,1,0,1,1,0.009035,4,0.265075,0.278404,0
败类(1947),败类,notion,0,1,1,0,1,1,0.013711,4,0.275027,0.295469,0
货将(1947),货将,notion,0,1,1,0,1,1,0.017323,4,0.281723,0.306272,0
货币(1947),货币,notion,0,1,1,0,1,1,0.014732,4,0.276453,0.297813,0
质询(1947),质询,notion,0,2,2,0,2,2,0.031545,4,0.305336,0.340645,2219.908318
质难(1947),质难,notion,0,1,1,0,1,1,0.014732,4,0.276453,0.297813,0
贩卖(1947),贩卖,notion,0,1,1,0,1,1,0.011229,4,0.270366,0.287632,0
贪功(1947),贪功,notion,0,1,1,0,1,1,0.011229,4,0.270366,0.287632,0
贪官(1947),贪官,notion,0,1,1,0,1,1,0.014081,4,0.275493,0.296238,0
贪污(1947),贪污,notion,0,6,6,0,7,7,0.067677,4,0.365217,0.408012,22427.93503
贫困(1947),贫困,notion,0,1,1,0,3,3,0.007422,4,0.26356,0.275695,0
贫济富(1947),贫济富,notion,0,1,1,0,1,1,0.013711,4,0.275027,0.295469,0
贯澈(1947),贯澈,notion,0,1,1,0,1,1,0.011229,4,0.270366,0.287632,0
贵刊(1947),贵刊,notion,0,2,2,0,2,2,0.027791,4,0.29968,0.332918,2405.290268
贵州(1947),贵州,notion,0,1,1,0,1,1,0.009035,4,0.265075,0.278404,0
贵族化(1947),贵族化,notion,0,1,1,0,1,1,0.014732,4,0.276453,0.297813,0
贵阳(1947),贵阳,notion,0,1,1,0,1,1,0.014081,4,0.275493,0.296238,0
贷放(1947),贷放,notion,0,1,1,0,1,1,0.007422,4,0.26356,0.275695,0
费孝通(1947),费孝通,notion,0,2,2,0,2,2,0.031404,4,0.30602,0.34156,2430.025091
费用(1947),费用,notion,0,1,1,0,2,2,0.014081,4,0.275493,0.296238,0
费边主义(1947),费边主义,notion,0,1,1,0,2,2,0.002092,4,0.25318,0.25625,0
费边社(1947),费边社,notion,0,1,1,0,2,2,0.002092,4,0.25318,0.25625,0
贺新年(1947),贺新年,notion,0,1,1,0,1,1,0.011229,4,0.270366,0.287632,0
贺龙(1947),贺龙,notion,0,1,1,0,1,1,0.011229,4,0.270366,0.287632,0
贼营(1947),贼营,notion,0,1,1,0,1,1,0.011229,4,0.270366,0.287632,0
资产(1947),资产,notion,0,1,1,0,1,1,0.014081,4,0.275493,0.296238,0
资共(1947),资共,notion,0,1,1,0,1,1,0.002092,4,0.25318,0.25625,0
资料(1947),资料,notion,0,1,1,0,1,1,0.007422,4,0.26356,0.275695,0
资本(1947),资本,notion,0,4,4,0,8,8,0.047658,4,0.329314,0.370575,9862.991008
资本主义(1947),资本主义,notion,0,5,5,0,5,5,0.058038,4,0.351129,0.394219,16278.000481
资本主义国家(1947),资本主义国家,notion,0,1,1,0,3,3,0.00981,4,0.267191,0.28214,0
资本家(1947),资本家,notion,0,1,1,0,1,1,0.00981,4,0.267191,0.28214,0
资金(1947),资金,notion,0,1,1,0,1,1,0.009035,4,0.265075,0.278404,0
赈米(1947),赈米,notion,0,1,1,0,1,1,0.011229,4,0.270366,0.287632,0
赋诗(1947),赋诗,notion,0,1,1,0,1,1,0.011229,4,0.270366,0.287632,0
赋谷(1947),赋谷,notion,0,1,1,0,1,1,0.011229,4,0.270366,0.287632,0
赏罚(1947),赏罚,notion,0,1,1,0,1,1,0.014081,4,0.275493,0.296238,0
赔款(1947),赔款,notion,0,2,2,0,2,2,0.024032,4,0.290894,0.320321,1695.498775
赖马迪(1947),赖马迪,notion,0,1,1,0,1,1,0.014732,4,0.276453,0.297813,0
赛叶夫(1947),赛叶夫,notion,0,1,1,0,1,1,0.00981,4,0.267191,0.28214,0
赛望(1947),赛望,notion,0,1,1,0,1,1,0.00981,4,0.267191,0.28214,0
赛跑(1947),赛跑,notion,0,1,1,0,1,1,0.013711,4,0.275027,0.295469,0
赞成(1947),赞成,notion,0,2,2,0,3,3,0.028812,4,0.299917,0.333248,2025.61524
赞扬(1947),赞扬,notion,0,1,1,0,1,1,0.017323,4,0.281723,0.306272,0
赠给(1947),赠给,notion,0,1,1,0,1,1,0.007422,4,0.26356,0.275695,0
赤区(1947),赤区,notion,0,1,1,0,1,1,0.014222,4,0.275404,0.296091,0
走上(1947),走上,notion,0,1,1,0,1,1,0.002092,4,0.25318,0.25625,0
走下坡(1947),走下坡,notion,0,1,1,0,1,1,0.011229,4,0.270366,0.287632,0
走下坡路(1947),走下坡路,notion,0,1,1,0,2,2,0.013711,4,0.275027,0.295469,0
走出(1947),走出,notion,0,1,1,0,1,1,0.013711,4,0.275027,0.295469,0
走到(1947),走到,notion,0,1,1,0,1,1,0.011229,4,0.270366,0.287632,0
走向(1947),走向,notion,0,8,8,0,10,10,0.08634,4,0.40712,0.443362,45767.993539
走漏(1947),走漏,notion,0,1,1,0,1,1,0.014732,4,0.276453,0.297813,0
走狗(1947),走狗,notion,0,1,1,0,1,1,0.013711,4,0.275027,0.295469,0
走私(1947),走私,notion,0,3,3,0,3,3,0.040041,4,0.320772,0.360407,6754.232663
赴京(1947),赴京,notion,0,2,2,0,2,2,0.031034,4,0.30613,0.341707,2639.595687
赵金林(1947),赵金林,notion,0,1,1,0,1,1,0.007422,4,0.26356,0.275695,0
赶出去(1947),赶出去,notion,0,1,1,0,1,1,0.003699,4,0.256009,0.261706,0
起义(1947),起义,notion,0,1,1,0,1,1,0.014081,4,0.275493,0.296238,0
起伏(1947),起伏,notion,0,1,1,0,1,1,0.017323,4,0.281723,0.306272,0
起来(1947),起来,notion,0,12,12,0,22,22,0.111612,4,0.459081,0.478358,85516.687451
起步(1947),起步,notion,0,1,1,0,1,1,0.007422,4,0.26356,0.275695,0
起源(1947),起源,notion,0,1,1,0,2,2,0.014222,4,0.275404,0.296091,0
起点(1947),起点,notion,0,1,1,0,1,1,0.007422,4,0.26356,0.275695,0
起码(1947),起码,notion,0,1,1,0,1,1,0.014081,4,0.275493,0.296238,0
起至(1947),起至,notion,0,1,1,0,1,1,0.009035,4,0.265075,0.278404,0
起身(1947),起身,notion,0,1,1,0,1,1,0.011229,4,0.270366,0.287632,0
超然(1947),超然,notion,0,1,1,0,1,1,0.013711,4,0.275027,0.295469,0
越剧(1947),越剧,notion,0,1,1,0,1,1,0.014732,4,0.276453,0.297813,0
越南民主共和国(1947),越南民主共和国,notion,0,2,2,0,2,2,0.010388,4,0.267505,0.28275,95.456676
越督(1947),越督,notion,0,1,1,0,1,1,0.017323,4,0.281723,0.306272,0
趋势(1947),趋势,notion,0,4,4,0,6,6,0.03392,4,0.304166,0.339192,4607.93053
趋向(1947),趋向,notion,0,2,2,0,5,5,0.031545,4,0.305336,0.340645,2219.908318
趣剧(1947),趣剧,notion,0,1,1,0,1,1,0.00981,4,0.267191,0.28214,0
趣味(1947),趣味,notion,0,1,1,0,1,1,0.003699,4,0.256009,0.261706,0
趣闻(1947),趣闻,notion,0,1,1,0,1,1,0.014732,4,0.276453,0.297813,0
足以自豪(1947),足以自豪,notion,0,1,1,0,1,1,0.004749,4,0.257108,0.263793,0
足球(1947),足球,notion,0,1,1,0,1,1,0.009035,4,0.265075,0.278404,0
跋一多(1947),跋一多,notion,0,1,1,0,1,1,0.014081,4,0.275493,0.296238,0
跑马(1947),跑马,notion,0,1,1,0,1,1,0.013711,4,0.275027,0.295469,0
距离(1947),距离,notion,0,1,1,0,1,1,0.014732,4,0.276453,0.297813,0
跟着(1947),跟着,notion,0,1,1,0,1,1,0.011229,4,0.270366,0.287632,0
跨过(1947),跨过,notion,0,1,1,0,2,2,0.013711,4,0.275027,0.295469,0
路上(1947),路上,notion,0,3,3,0,3,3,0.029225,4,0.299207,0.33232,3633.572303
路不拾遗(1947),路不拾遗,notion,0,1,1,0,1,1,0.017323,4,0.281723,0.306272,0
路子(1947),路子,notion,0,1,1,0,1,1,0.013711,4,0.275027,0.295469,0
路易(1947),路易,notion,0,1,1,0,1,1,0.00981,4,0.267191,0.28214,0
路线(1947),路线,notion,0,5,5,0,5,5,0.063946,4,0.361274,0.404216,16205.111834
路走(1947),路走,notion,0,1,1,0,1,1,0.014081,4,0.275493,0.296238,0
路透社(1947),路透社,notion,0,1,1,0,1,1,0.017323,4,0.281723,0.306272,0
跳舞(1947),跳舞,notion,0,1,1,0,1,1,0.014732,4,0.276453,0.297813,0
踊剧(1947),踊剧,notion,0,1,1,0,1,1,0.011229,4,0.270366,0.287632,0
踏着(1947),踏着,notion,0,1,1,0,1,1,0.011229,4,0.270366,0.287632,0
踏进(1947),踏进,notion,0,2,2,0,2,2,0.028442,4,0.300022,0.333394,2187.730369
身边(1947),身边,notion,0,1,1,0,1,1,0.003588,4,0.255396,0.260534,0
车务(1947),车务,notion,0,1,1,0,1,1,0.007422,4,0.26356,0.275695,0
车站(1947),车站,notion,0,1,1,0,1,1,0.007422,4,0.26356,0.275695,0
转形期(1947),转形期,notion,0,1,1,0,1,1,0.014081,4,0.275493,0.296238,0
转捩(1947),转捩,notion,0,1,1,0,1,1,0.017323,4,0.281723,0.306272,0
转捩点(1947),转捩点,notion,0,1,1,0,1,1,0.017323,4,0.281723,0.306272,0
转赠(1947),转赠,notion,0,1,1,0,1,1,0.013711,4,0.275027,0.295469,0
转载(1947),转载,notion,0,2,2,0,2,2,0.028812,4,0.299917,0.333248,2025.61524
轮姦(1947),轮姦,notion,0,1,1,0,2,2,0.014081,4,0.275493,0.296238,0
轮廓(1947),轮廓,notion,0,2,2,0,2,2,0.02531,4,0.2954,0.326876,2496.768821
轻视(1947),轻视,notion,0,1,1,0,1,1,0.013711,4,0.275027,0.295469,0
较场口(1947),较场口,notion,0,1,1,0,2,2,0.003699,4,0.256009,0.261706,0
辅导(1947),辅导,notion,0,1,1,0,1,1,0.007422,4,0.26356,0.275695,0
输入(1947),输入,notion,0,2,2,0,2,2,0.018845,4,0.280243,0.303989,1083.402703
辛勤(1947),辛勤,notion,0,1,1,0,1,1,0.014081,4,0.275493,0.296238,0
辛格(1947),辛格,notion,0,2,2,0,2,2,0.021022,4,0.286837,0.314242,1344.24886
辞典(1947),辞典,notion,0,1,1,0,2,2,0.014081,4,0.275493,0.296238,0
辞职(1947),辞职,notion,0,1,1,0,1,1,0.003588,4,0.255396,0.260534,0
辨别是非(1947),辨别是非,notion,0,1,1,0,1,1,0.011229,4,0.270366,0.287632,0
辩护(1947),辩护,notion,0,2,2,0,2,2,0.01832,4,0.280681,0.304685,795.39908
辩论(1947),辩论,notion,0,1,1,0,1,1,0.014222,4,0.275404,0.296091,0
边情(1947),边情,notion,0,1,1,0,1,1,0.014222,4,0.275404,0.296091,0
边教(1947),边教,notion,0,1,1,0,1,1,0.014222,4,0.275404,0.296091,0
边民(1947),边民,notion,0,1,1,0,1,1,0.014222,4,0.275404,0.296091,0
边界(1947),边界,notion,0,1,1,0,1,1,0.014081,4,0.275493,0.296238,0
边疆(1947),边疆,notion,0,1,1,0,3,3,0.014222,4,0.275404,0.296091,0
边缘(1947),边缘,notion,0,1,1,0,1,1,0.007422,4,0.26356,0.275695,0
边锋(1947),边锋,notion,0,1,1,0,1,1,0.017323,4,0.281723,0.306272,0
达夫(1947),达夫,notion,0,1,1,0,1,1,0.014732,4,0.276453,0.297813,0
达姆弹(1947),达姆弹,notion,0,1,1,0,1,1,0.014081,4,0.275493,0.296238,0
迂拙(1947),迂拙,notion,0,1,1,0,1,1,0.014081,4,0.275493,0.296238,0
迅速(1947),迅速,notion,0,1,1,0,1,1,0.013711,4,0.275027,0.295469,0
过份(1947),过份,notion,0,1,1,0,1,1,0.009035,4,0.265075,0.278404,0
过去(1947),过去,notion,0,4,4,0,4,4,0.048369,4,0.333398,0.375226,9535.625473
过日子(1947),过日子,notion,0,1,1,0,1,1,0.013711,4,0.275027,0.295469,0
过河(1947),过河,notion,0,1,1,0,1,1,0.014732,4,0.276453,0.297813,0
过渡阶段(1947),过渡阶段,notion,0,1,1,0,1,1,0.003588,4,0.255396,0.260534,0
迎向(1947),迎向,notion,0,1,1,0,1,1,0.003699,4,0.256009,0.261706,0
迎春(1947),迎春,notion,0,1,1,0,1,1,0.003588,4,0.255396,0.260534,0
迎浅予(1947),迎浅予,notion,0,1,1,0,1,1,0.014732,4,0.276453,0.297813,0
运日(1947),运日,notion,0,1,1,0,1,1,0.014081,4,0.275493,0.296238,0
运煤(1947),运煤,notion,0,1,1,0,1,1,0.014081,4,0.275493,0.296238,0
运用(1947),运用,notion,0,2,2,0,2,2,0.023257,4,0.28761,0.315414,1169.271875
近东(1947),近东,notion,0,1,1,0,1,1,0.00981,4,0.267191,0.28214,0
近代(1947),近代,notion,0,1,1,0,1,1,0.014222,4,0.275404,0.296091,0
近作(1947),近作,notion,0,1,1,0,1,1,0.014732,4,0.276453,0.297813,0
近况(1947),近况,notion,0,2,2,0,5,5,0.024032,4,0.290894,0.320321,1695.498775
近影(1947),近影,notion,0,1,1,0,1,1,0.013711,4,0.275027,0.295469,0
近情(1947),近情,notion,0,2,2,0,2,2,0.031404,4,0.30602,0.34156,2430.025091
近来(1947),近来,notion,0,1,1,0,1,1,0.011229,4,0.270366,0.287632,0
近百年来(1947),近百年来,notion,0,1,1,0,1,1,0.014222,4,0.275404,0.296091,0
近貌(1947),近貌,notion,0,7,7,0,7,7,0.079553,4,0.390896,0.430558,30771.546927
近郊(1947),近郊,notion,0,1,1,0,1,1,0.00981,4,0.267191,0.28214,0
返乡(1947),返乡,notion,0,1,1,0,1,1,0.011229,4,0.270366,0.287632,0
返国(1947),返国,notion,0,1,1,0,1,1,0.009035,4,0.265075,0.278404,0
返美(1947),返美,notion,0,1,1,0,1,1,0.017323,4,0.281723,0.306272,0
返魂(1947),返魂,notion,0,1,1,0,1,1,0.014732,4,0.276453,0.297813,0
还命(1947),还命,notion,0,1,1,0,1,1,0.013711,4,0.275027,0.295469,0
还是(1947),还是,notion,0,2,2,0,2,2,0.031404,4,0.30602,0.34156,2430.025091
还有(1947),还有,notion,0,2,2,0,2,2,0.028442,4,0.300022,0.333394,2187.730369
还要(1947),还要,notion,0,2,2,0,2,2,0.01741,4,0.280151,0.303843,1198.480437
这一(1947),这一,notion,0,1,1,0,1,1,0.011229,4,0.270366,0.287632,0
这个(1947),这个,notion,0,3,3,0,3,3,0.032141,4,0.304709,0.339864,4427.085399
这些(1947),这些,notion,0,1,1,0,1,1,0.013711,4,0.275027,0.295469,0
这块(1947),这块,notion,0,1,1,0,1,1,0.011229,4,0.270366,0.287632,0
这是(1947),这是,notion,0,2,2,0,3,3,0.02494,4,0.292941,0.323324,1747.290038
这条(1947),这条,notion,0,1,1,0,1,1,0.013711,4,0.275027,0.295469,0
这次(1947),这次,notion,0,3,3,0,4,4,0.03512,4,0.312206,0.349714,6487.870845
这算(1947),这算,notion,0,1,1,0,1,1,0.014222,4,0.275404,0.296091,0
这类(1947),这类,notion,0,1,1,0,1,1,0.014222,4,0.275404,0.296091,0
这辆(1947),这辆,notion,0,1,1,0,1,1,0.014222,4,0.275404,0.296091,0
进一步(1947),进一步,notion,0,1,1,0,1,1,0.007422,4,0.26356,0.275695,0
进一言(1947),进一言,notion,0,1,1,0,1,1,0.014081,4,0.275493,0.296238,0
进入(1947),进入,notion,0,2,2,0,2,2,0.028954,4,0.300154,0.333577,2064.821066
进出口(1947),进出口,notion,0,1,1,0,1,1,0.014732,4,0.276453,0.297813,0
进占(1947),进占,notion,0,1,1,0,1,1,0.013711,4,0.275027,0.295469,0
进攻(1947),进攻,notion,0,1,1,0,1,1,0.013711,4,0.275027,0.295469,0
进来(1947),进来,notion,0,2,2,0,2,2,0.028442,4,0.300022,0.333394,2187.730369
进步人士(1947),进步人士,notion,0,1,1,0,1,1,0.00981,4,0.267191,0.28214,0
进步性(1947),进步性,notion,0,1,1,0,1,1,0.00981,4,0.267191,0.28214,0
进行(1947),进行,notion,0,1,1,0,1,1,0.013711,4,0.275027,0.295469,0
进言(1947),进言,notion,0,1,1,0,1,1,0.017323,4,0.281723,0.306272,0
进路(1947),进路,notion,0,1,1,0,14,14,0.007422,4,0.26356,0.275695,0
进驻(1947),进驻,notion,0,1,1,0,1,1,0.017323,4,0.281723,0.306272,0
远点(1947),远点,notion,0,1,1,0,1,1,0.009035,4,0.265075,0.278404,0
连接(1947),连接,notion,0,1,1,0,1,1,0.011229,4,0.270366,0.287632,0
连环(1947),连环,notion,0,1,1,0,1,1,0.013711,4,0.275027,0.295469,0
连环图画(1947),连环图画,notion,0,1,1,0,1,1,0.013711,4,0.275027,0.295469,0
连锁(1947),连锁,notion,0,1,1,0,1,1,0.00981,4,0.267191,0.28214,0
迪化(1947),迪化,notion,0,1,1,0,1,1,0.014081,4,0.275493,0.296238,0
迫不及待(1947),迫不及待,notion,0,1,1,0,1,1,0.014081,4,0.275493,0.296238,0
迫害(1947),迫害,notion,0,1,1,0,1,1,0.013711,4,0.275027,0.295469,0
迷乱(1947),迷乱,notion,0,1,1,0,1,1,0.014732,4,0.276453,0.297813,0
迷魂阵(1947),迷魂阵,notion,0,1,1,0,1,1,0.003699,4,0.256009,0.261706,0
追念(1947),追念,notion,0,4,4,0,4,4,0.051558,4,0.338691,0.381085,11004.748529
追怀(1947),追怀,notion,0,1,1,0,1,1,0.013711,4,0.275027,0.295469,0
追悼(1947),追悼,notion,0,3,3,0,4,4,0.042633,4,0.326885,0.367694,7515.333574
追悼会(1947),追悼会,notion,0,2,2,0,2,2,0.032055,4,0.30624,0.341853,2215.722594
追索(1947),追索,notion,0,1,1,0,1,1,0.014081,4,0.275493,0.296238,0
追述(1947),追述,notion,0,2,2,0,2,2,0.023891,4,0.292014,0.321969,2116.906395
退伍(1947),退伍,notion,0,1,1,0,1,1,0.014081,4,0.275493,0.296238,0
退伍军人(1947),退伍军人,notion,0,1,1,0,1,1,0.017323,4,0.281723,0.306272,0
退出(1947),退出,notion,0,2,2,0,2,2,0.018431,4,0.28119,0.30549,1040.874592
退步(1947),退步,notion,0,1,1,0,1,1,0.00981,4,0.267191,0.28214,0
送别(1947),送别,notion,0,1,1,0,1,1,0.017323,4,0.281723,0.306272,0
送行(1947),送行,notion,0,1,1,0,1,1,0.017323,4,0.281723,0.306272,0
适应(1947),适应,notion,0,1,1,0,1,1,0.007422,4,0.26356,0.275695,0
适用(1947),适用,notion,0,1,1,0,1,1,0.017323,4,0.281723,0.306272,0
逃不了(1947),逃不了,notion,0,1,1,0,1,1,0.011229,4,0.270366,0.287632,0
逃犯(1947),逃犯,notion,0,1,1,0,1,1,0.00981,4,0.267191,0.28214,0
逃生(1947),逃生,notion,0,1,1,0,1,1,0.013711,4,0.275027,0.295469,0
逆流(1947),逆流,notion,0,1,1,0,1,1,0.013711,4,0.275027,0.295469,0
逆转(1947),逆转,notion,0,1,1,0,1,1,0.014732,4,0.276453,0.297813,0
选县(1947),选县,notion,0,1,1,0,1,1,0.014222,4,0.275404,0.296091,0
选拔(1947),选拔,notion,0,1,1,0,1,1,0.014222,4,0.275404,0.296091,0
选择(1947),选择,notion,0,2,2,0,2,2,0.031545,4,0.305336,0.340645,2219.908318
选民(1947),选民,notion,0,2,2,0,3,3,0.023257,4,0.28761,0.315414,1169.271875
选票(1947),选票,notion,0,2,2,0,2,2,0.023257,4,0.28761,0.315414,1169.271875
选载(1947),选载,notion,0,1,1,0,1,1,0.014222,4,0.275404,0.296091,0
选辑(1947),选辑,notion,0,1,1,0,5,5,0.014732,4,0.276453,0.297813,0
透视(1947),透视,notion,0,5,5,0,8,8,0.069393,4,0.370771,0.413078,18463.087877
透露(1947),透露,notion,0,2,2,0,2,2,0.020912,4,0.285589,0.312338,797.979389
逐一(1947),逐一,notion,0,1,1,0,1,1,0.014222,4,0.275404,0.296091,0
逐渐(1947),逐渐,notion,0,2,2,0,2,2,0.027932,4,0.299811,0.333101,2443.455357
途径(1947),途径,notion,0,3,3,0,3,3,0.028006,4,0.292339,0.322506,2276.459601
途穷(1947),途穷,notion,0,1,1,0,1,1,0.014732,4,0.276453,0.297813,0
逗耍(1947),逗耍,notion,0,1,1,0,1,1,0.013711,4,0.275027,0.295469,0
通令(1947),通令,notion,0,1,1,0,1,1,0.017323,4,0.281723,0.306272,0
通俗化(1947),通俗化,notion,0,1,1,0,1,1,0.004749,4,0.257108,0.263793,0
通则(1947),通则,notion,0,1,1,0,1,1,0.009035,4,0.265075,0.278404,0
通力合作(1947),通力合作,notion,0,1,1,0,1,1,0.007422,4,0.26356,0.275695,0
通吃(1947),通吃,notion,0,1,1,0,1,1,0.009035,4,0.265075,0.278404,0
通汛(1947),通汛,notion,0,1,1,0,1,1,0.011229,4,0.270366,0.287632,0
通牒(1947),通牒,notion,0,1,1,0,1,1,0.00981,4,0.267191,0.28214,0
通益(1947),通益,notion,0,1,1,0,3,3,0.007422,4,0.26356,0.275695,0
通讯社(1947),通讯社,notion,0,1,1,0,1,1,0.009035,4,0.265075,0.278404,0
通论(1947),通论,notion,0,1,1,0,2,2,0.014222,4,0.275404,0.296091,0
通货(1947),通货,notion,0,1,1,0,1,1,0.004749,4,0.257108,0.263793,0
通货膨胀(1947),通货膨胀,notion,0,2,2,0,4,4,0.01948,4,0.281468,0.30593,668.20053
通过(1947),通过,notion,0,3,3,0,3,3,0.041355,4,0.320953,0.360627,5686.400693
逝世(1947),逝世,notion,0,5,5,0,12,12,0.066805,4,0.370127,0.412492,20993.976974
逝者(1947),逝者,notion,0,1,1,0,1,1,0.003588,4,0.255396,0.260534,0
造书(1947),造书,notion,0,1,1,0,1,1,0.00981,4,0.267191,0.28214,0
造人(1947),造人,notion,0,1,1,0,1,1,0.017323,4,0.281723,0.306272,0
造就人才(1947),造就人才,notion,0,1,1,0,1,1,0.017323,4,0.281723,0.306272,0
造成(1947),造成,notion,0,2,2,0,3,3,0.022746,4,0.288631,0.316952,1575.703869
造谣(1947),造谣,notion,0,1,1,0,1,1,0.014732,4,0.276453,0.297813,0
造谣中伤(1947),造谣中伤,notion,0,1,1,0,1,1,0.014732,4,0.276453,0.297813,0
週刊(1947),週刊,notion,0,1,1,0,1,1,0.014081,4,0.275493,0.296238,0
逼上梁山(1947),逼上梁山,notion,0,1,1,0,1,1,0.013711,4,0.275027,0.295469,0
逼成(1947),逼成,notion,0,1,1,0,1,1,0.014732,4,0.276453,0.297813,0
逼死(1947),逼死,notion,0,1,1,0,1,1,0.013711,4,0.275027,0.295469,0
逼近(1947),逼近,notion,0,1,1,0,1,1,0.00981,4,0.267191,0.28214,0
遇见(1947),遇见,notion,0,1,1,0,1,1,0.014081,4,0.275493,0.296238,0
遇难(1947),遇难,notion,0,2,2,0,2,2,0.012734,4,0.270087,0.287217,736.032122
遊行(1947),遊行,notion,0,2,2,0,5,5,0.027791,4,0.29968,0.332918,2405.290268
遏制(1947),遏制,notion,0,1,1,0,1,1,0.011229,4,0.270366,0.287632,0
道袍(1947),道袍,notion,0,1,1,0,1,1,0.013711,4,0.275027,0.295469,0
道路(1947),道路,notion,0,7,7,0,20,20,0.075194,4,0.387788,0.427994,37872.165124
遗书(1947),遗书,notion,0,1,1,0,1,1,0.017323,4,0.281723,0.306272,0
遗像(1947),遗像,notion,0,1,1,0,1,1,0.017323,4,0.281723,0.306272,0
遗集(1947),遗集,notion,0,1,1,0,1,1,0.014081,4,0.275493,0.296238,0
遥祭(1947),遥祭,notion,0,1,1,0,1,1,0.011229,4,0.270366,0.287632,0
遥远(1947),遥远,notion,0,1,1,0,1,1,0.003699,4,0.256009,0.261706,0
遭遇(1947),遭遇,notion,0,1,1,0,1,1,0.011229,4,0.270366,0.287632,0
遮眼法(1947),遮眼法,notion,0,1,1,0,1,1,0.013711,4,0.275027,0.295469,0
避免(1947),避免,notion,0,2,2,0,2,2,0.018651,4,0.283055,0.30842,2017.209887
避难(1947),避难,notion,0,1,1,0,1,1,0.014732,4,0.276453,0.297813,0
那儿(1947),那儿,notion,0,1,1,0,1,1,0.013711,4,0.275027,0.295469,0
那条(1947),那条,notion,0,1,1,0,1,1,0.014081,4,0.275493,0.296238,0
那裏(1947),那裏,notion,0,2,2,0,3,3,0.027791,4,0.29968,0.332918,2405.290268
那边(1947),那边,notion,0,1,1,0,1,1,0.017323,4,0.281723,0.306272,0
那里(1947),那里,notion,0,6,6,0,8,8,0.072033,4,0.37989,0.421232,29323.691102
邦交(1947),邦交,notion,0,1,1,0,2,2,0.014222,4,0.275404,0.296091,0
邮电(1947),邮电,notion,0,1,1,0,1,1,0.017323,4,0.281723,0.306272,0
邱吉尔(1947),邱吉尔,notion,0,2,2,0,2,2,0.018845,4,0.280243,0.303989,1083.402703
邵从(1947),邵从,notion,0,1,1,0,5,5,0.017323,4,0.281723,0.306272,0
邵元冲(1947),邵元冲,notion,0,1,1,0,1,1,0.014081,4,0.275493,0.296238,0
邵阳(1947),邵阳,notion,0,1,1,0,1,1,0.013711,4,0.275027,0.295469,0
邹月(1947),邹月,notion,0,1,1,0,1,1,0.013711,4,0.275027,0.295469,0
邹李闻(1947),邹李闻,notion,0,1,1,0,3,3,0.003588,4,0.255396,0.260534,0
郎中(1947),郎中,notion,0,1,1,0,1,1,0.013711,4,0.275027,0.295469,0
郝逆(1947),郝逆,notion,0,1,1,0,1,1,0.011229,4,0.270366,0.287632,0
郝钦斯(1947),郝钦斯,notion,0,1,1,0,1,1,0.017323,4,0.281723,0.306272,0
部份(1947),部份,notion,0,1,1,0,1,1,0.011229,4,0.270366,0.287632,0
部署(1947),部署,notion,0,2,2,0,2,2,0.021132,4,0.288412,0.316623,2574.708611
部长(1947),部长,notion,0,1,1,0,1,1,0.00981,4,0.267191,0.28214,0
部队(1947),部队,notion,0,2,2,0,4,4,0.02494,4,0.292941,0.323324,1747.290038
郭尔基(1947),郭尔基,notion,0,1,1,0,1,1,0.00981,4,0.267191,0.28214,0
郭沫若(1947),郭沫若,notion,0,1,1,0,1,1,0.017323,4,0.281723,0.306272,0
都市(1947),都市,notion,0,2,2,0,2,2,0.028954,4,0.300154,0.333577,2064.821066
鄂东(1947),鄂东,notion,0,1,1,0,1,1,0.014081,4,0.275493,0.296238,0
鄂尔多斯(1947),鄂尔多斯,notion,0,1,1,0,1,1,0.014732,4,0.276453,0.297813,0
配合(1947),配合,notion,0,2,2,0,4,4,0.021644,4,0.28732,0.314975,1747.667055
配种(1947),配种,notion,0,1,1,0,1,1,0.007422,4,0.26356,0.275695,0
配给(1947),配给,notion,0,1,1,0,1,1,0.014222,4,0.275404,0.296091,0
酝酿(1947),酝酿,notion,0,3,3,0,3,3,0.033301,4,0.307066,0.343013,4348.135821
酬劳(1947),酬劳,notion,0,1,1,0,1,1,0.007422,4,0.26356,0.275695,0
醜剧(1947),醜剧,notion,0,1,1,0,3,3,0.013711,4,0.275027,0.295469,0
醜妇(1947),醜妇,notion,0,1,1,0,1,1,0.013711,4,0.275027,0.295469,0
醜恶(1947),醜恶,notion,0,1,1,0,1,1,0.014222,4,0.275404,0.296091,0
采取(1947),采取,notion,0,2,2,0,2,2,0.02531,4,0.2954,0.326876,2496.768821
采地(1947),采地,notion,0,1,1,0,1,1,0.017323,4,0.281723,0.306272,0
采桑子(1947),采桑子,notion,0,1,1,0,1,1,0.014081,4,0.275493,0.296238,0
采用(1947),采用,notion,0,1,1,0,1,1,0.009035,4,0.265075,0.278404,0
采行(1947),采行,notion,0,1,1,0,1,1,0.004749,4,0.257108,0.263793,0
采访(1947),采访,notion,0,1,1,0,1,1,0.003588,4,0.255396,0.260534,0
释义(1947),释义,notion,0,1,1,0,1,1,0.009035,4,0.265075,0.278404,0
释放(1947),释放,notion,0,1,1,0,1,1,0.017323,4,0.281723,0.306272,0
释迦牟尼(1947),释迦牟尼,notion,0,1,1,0,1,1,0.017323,4,0.281723,0.306272,0
里夫(1947),里夫,notion,0,1,1,0,1,1,0.00981,4,0.267191,0.28214,0
里茨(1947),里茨,notion,0,1,1,0,1,1,0.00981,4,0.267191,0.28214,0
里面(1947),里面,notion,0,1,1,0,1,1,0.017323,4,0.281723,0.306272,0
重于(1947),重于,notion,0,2,2,0,2,2,0.023257,4,0.28761,0.315414,1169.271875
重任(1947),重任,notion,0,1,1,0,1,1,0.009035,4,0.265075,0.278404,0
重建(1947),重建,notion,0,2,2,0,2,2,0.021502,4,0.288388,0.316586,2245.621531
重心(1947),重心,notion,0,1,1,0,1,1,0.007422,4,0.26356,0.275695,0
重提(1947),重提,notion,0,1,1,0,1,1,0.017323,4,0.281723,0.306272,0
重新(1947),重新,notion,0,3,3,0,3,3,0.033561,4,0.304356,0.339388,3349.170174
重新估价(1947),重新估价,notion,0,1,1,0,1,1,0.004749,4,0.257108,0.263793,0
重於(1947),重於,notion,0,1,1,0,1,1,0.014222,4,0.275404,0.296091,0
重来(1947),重来,notion,0,1,1,0,1,1,0.014081,4,0.275493,0.296238,0
重游(1947),重游,notion,0,1,1,0,1,1,0.014732,4,0.276453,0.297813,0
重演(1947),重演,notion,0,1,1,0,1,1,0.014732,4,0.276453,0.297813,0
重点(1947),重点,notion,0,1,1,0,1,1,0.014222,4,0.275404,0.296091,0
重申(1947),重申,notion,0,1,1,0,1,1,0.017323,4,0.281723,0.306272,0
重禁(1947),重禁,notion,0,1,1,0,1,1,0.014081,4,0.275493,0.296238,0
重要性(1947),重要性,notion,0,1,1,0,2,2,0.007422,4,0.26356,0.275695,0
重要文件(1947),重要文件,notion,0,1,1,0,2,2,0.011229,4,0.270366,0.287632,0
重视(1947),重视,notion,0,3,3,0,3,3,0.046135,4,0.331006,0.372455,6671.362925
重调(1947),重调,notion,0,1,1,0,1,1,0.014222,4,0.275404,0.296091,0
重返(1947),重返,notion,0,1,1,0,1,1,0.017323,4,0.281723,0.306272,0
重重(1947),重重,notion,0,1,1,0,1,1,0.007422,4,0.26356,0.275695,0
重重的(1947),重重的,notion,0,1,1,0,1,1,0.003588,4,0.255396,0.260534,0
重量(1947),重量,notion,0,1,1,0,1,1,0.007422,4,0.26356,0.275695,0
重金礼聘(1947),重金礼聘,notion,0,1,1,0,1,1,0.014732,4,0.276453,0.297813,0
野火烧(1947),野火烧,notion,0,1,1,0,1,1,0.013711,4,0.275027,0.295469,0
野火烧不尽(1947),野火烧不尽,notion,0,1,1,0,2,2,0.013711,4,0.275027,0.295469,0
野老(1947),野老,notion,0,1,1,0,1,1,0.017323,4,0.281723,0.306272,0
野蛮(1947),野蛮,notion,0,1,1,0,1,1,0.00981,4,0.267191,0.28214,0
金元外交(1947),金元外交,notion,0,1,1,0,1,1,0.011229,4,0.270366,0.287632,0
金属(1947),金属,notion,0,1,1,0,1,1,0.014081,4,0.275493,0.296238,0
金平(1947),金平,notion,0,1,1,0,1,1,0.007422,4,0.26356,0.275695,0
金库(1947),金库,notion,0,1,1,0,2,2,0.011229,4,0.270366,0.287632,0
金敦作(1947),金敦作,notion,0,1,1,0,1,1,0.017323,4,0.281723,0.306272,0
金法(1947),金法,notion,0,2,2,0,2,2,0.01897,4,0.280427,0.304282,657.210893
金潮(1947),金潮,notion,0,1,1,0,1,1,0.014081,4,0.275493,0.296238,0
金融(1947),金融,notion,0,4,4,0,5,5,0.041908,4,0.320893,0.360615,10414.234523
金融机构(1947),金融机构,notion,0,1,1,0,1,1,0.007422,4,0.26356,0.275695,0
金贻荪(1947),金贻荪,notion,0,1,1,0,1,1,0.00981,4,0.267191,0.28214,0
金顶(1947),金顶,notion,0,1,1,0,1,1,0.014222,4,0.275404,0.296091,0
鏖兵(1947),鏖兵,notion,0,1,1,0,1,1,0.017323,4,0.281723,0.306272,0
钞票(1947),钞票,notion,0,2,2,0,2,2,0.032055,4,0.30624,0.341853,2215.722594
钟超武(1947),钟超武,notion,0,1,1,0,1,1,0.011229,4,0.270366,0.287632,0
钢铁(1947),钢铁,notion,0,1,1,0,2,2,0.014081,4,0.275493,0.296238,0
钧儒(1947),钧儒,notion,0,1,1,0,1,1,0.00981,4,0.267191,0.28214,0
钱玄同(1947),钱玄同,notion,0,1,1,0,1,1,0.014732,4,0.276453,0.297813,0
钱端升(1947),钱端升,notion,0,1,1,0,1,1,0.014081,4,0.275493,0.296238,0
钱粮(1947),钱粮,notion,0,1,1,0,1,1,0.011229,4,0.270366,0.287632,0
铁幕(1947),铁幕,notion,0,1,1,0,2,2,0.009035,4,0.265075,0.278404,0
铁桶(1947),铁桶,notion,0,1,1,0,1,1,0.011229,4,0.270366,0.287632,0
铁流(1947),铁流,notion,0,1,1,0,1,1,0.003588,4,0.255396,0.260534,0
铁炉(1947),铁炉,notion,0,1,1,0,1,1,0.00981,4,0.267191,0.28214,0
铁胆(1947),铁胆,notion,0,1,1,0,1,1,0.011229,4,0.270366,0.287632,0
铁路(1947),铁路,notion,0,2,2,0,2,2,0.028812,4,0.299917,0.333248,2025.61524
铁道(1947),铁道,notion,0,1,1,0,1,1,0.013711,4,0.275027,0.295469,0
铜像(1947),铜像,notion,0,1,1,0,1,1,0.00981,4,0.267191,0.28214,0
铜元(1947),铜元,notion,0,1,1,0,1,1,0.014732,4,0.276453,0.297813,0
银河(1947),银河,notion,0,1,1,0,1,1,0.017323,4,0.281723,0.306272,0
银行(1947),银行,notion,0,3,3,0,3,3,0.038967,4,0.318528,0.357661,6652.184339
铸成(1947),铸成,notion,0,1,1,0,1,1,0.014222,4,0.275404,0.296091,0
锋烟到(1947),锋烟到,notion,0,1,1,0,1,1,0.017323,4,0.281723,0.306272,0
错误(1947),错误,notion,0,2,2,0,3,3,0.028954,4,0.300154,0.333577,2064.821066
错路(1947),错路,notion,0,1,1,0,1,1,0.011229,4,0.270366,0.287632,0
锯齿(1947),锯齿,notion,0,1,1,0,1,1,0.014081,4,0.275493,0.296238,0
锻炼(1947),锻炼,notion,0,1,1,0,2,2,0.007422,4,0.26356,0.275695,0
镜头(1947),镜头,notion,0,1,1,0,1,1,0.013711,4,0.275027,0.295469,0
镜子(1947),镜子,notion,0,2,2,0,3,3,0.026359,4,0.294788,0.325997,1561.492709
长夜(1947),长夜,notion,0,1,1,0,1,1,0.011229,4,0.270366,0.287632,0
长大(1947),长大,notion,0,1,1,0,1,1,0.014222,4,0.275404,0.296091,0
长成(1947),长成,notion,0,1,1,0,1,1,0.002092,4,0.25318,0.25625,0
长明灯(1947),长明灯,notion,0,1,1,0,1,1,0.00981,4,0.267191,0.28214,0
长春(1947),长春,notion,0,2,2,0,2,2,0.027932,4,0.299811,0.333101,2443.455357
长期(1947),长期,notion,0,1,1,0,1,1,0.013711,4,0.275027,0.295469,0
长江(1947),长江,notion,0,2,2,0,2,2,0.032055,4,0.30624,0.341853,2215.722594
长蛇(1947),长蛇,notion,0,1,1,0,1,1,0.011229,4,0.270366,0.287632,0
长路(1947),长路,notion,0,1,1,0,1,1,0.014081,4,0.275493,0.296238,0
长长地(1947),长长地,notion,0,1,1,0,1,1,0.017323,4,0.281723,0.306272,0
関总(1947),関总,notion,0,1,1,0,1,1,0.014222,4,0.275404,0.296091,0
门可罗雀(1947),门可罗雀,notion,0,1,1,0,1,1,0.014222,4,0.275404,0.296091,0
门罗主义(1947),门罗主义,notion,0,2,2,0,2,2,0.015978,4,0.276542,0.29802,897.171983
门阀(1947),门阀,notion,0,1,1,0,1,1,0.014732,4,0.276453,0.297813,0
闪烁(1947),闪烁,notion,0,1,1,0,1,1,0.00981,4,0.267191,0.28214,0
闭上(1947),闭上,notion,0,1,1,0,1,1,0.017323,4,0.281723,0.306272,0
问谁(1947),问谁,notion,0,1,1,0,1,1,0.013711,4,0.275027,0.295469,0
闲暇(1947),闲暇,notion,0,1,1,0,6,6,0.007422,4,0.26356,0.275695,0
闲话(1947),闲话,notion,0,2,2,0,2,2,0.013784,4,0.270451,0.28784,449.976833
间谍案(1947),间谍案,notion,0,1,1,0,1,1,0.017323,4,0.281723,0.306272,0
闷药(1947),闷药,notion,0,1,1,0,1,1,0.014081,4,0.275493,0.296238,0
闻得(1947),闻得,notion,0,1,1,0,1,1,0.017323,4,0.281723,0.306272,0
闽中(1947),闽中,notion,0,1,1,0,1,1,0.011229,4,0.270366,0.287632,0
闽南(1947),闽南,notion,0,1,1,0,1,1,0.013711,4,0.275027,0.295469,0
闽粤(1947),闽粤,notion,0,1,1,0,1,1,0.011229,4,0.270366,0.287632,0
阅报(1947),阅报,notion,0,1,1,0,1,1,0.014732,4,0.276453,0.297813,0
阎锡山(1947),阎锡山,notion,0,1,1,0,1,1,0.013711,4,0.275027,0.295469,0
阐微(1947),阐微,notion,0,1,1,0,1,1,0.017323,4,0.281723,0.306272,0
阐扬(1947),阐扬,notion,0,1,1,0,1,1,0.014222,4,0.275404,0.296091,0
阐杨(1947),阐杨,notion,0,1,1,0,1,1,0.014222,4,0.275404,0.296091,0
阔别(1947),阔别,notion,0,1,1,0,1,1,0.014732,4,0.276453,0.297813,0
阜阳(1947),阜阳,notion,0,1,1,0,1,1,0.014081,4,0.275493,0.296238,0
队伍(1947),队伍,notion,0,3,3,0,5,5,0.03475,4,0.309488,0.346199,5532.888574
防制(1947),防制,notion,0,1,1,0,1,1,0.009035,4,0.265075,0.278404,0
防务(1947),防务,notion,0,1,1,0,1,1,0.014732,4,0.276453,0.297813,0
防御(1947),防御,notion,0,1,1,0,2,2,0.00981,4,0.267191,0.28214,0
防止(1947),防止,notion,0,1,1,0,1,1,0.017323,4,0.281723,0.306272,0
阴影(1947),阴影,notion,0,1,1,0,1,1,0.014081,4,0.275493,0.296238,0
阴暗面(1947),阴暗面,notion,0,1,1,0,1,1,0.00981,4,0.267191,0.28214,0
阴谋活动(1947),阴谋活动,notion,0,1,1,0,1,1,0.00981,4,0.267191,0.28214,0
阴阳界(1947),阴阳界,notion,0,1,1,0,1,1,0.014081,4,0.275493,0.296238,0
阴魂(1947),阴魂,notion,0,1,1,0,1,1,0.009035,4,0.265075,0.278404,0
阵地(1947),阵地,notion,0,1,1,0,1,1,0.00981,4,0.267191,0.28214,0
阵线(1947),阵线,notion,0,4,4,0,5,5,0.05039,4,0.333692,0.375555,9500.567981
阶层(1947),阶层,notion,0,2,2,0,2,2,0.028954,4,0.300154,0.333577,2064.821066
阶级(1947),阶级,notion,0,3,3,0,5,5,0.037338,4,0.310954,0.348103,4493.316655
阻止(1947),阻止,notion,0,1,1,0,1,1,0.017323,4,0.281723,0.306272,0
阻止不了(1947),阻止不了,notion,0,1,1,0,1,1,0.011229,4,0.270366,0.287632,0
阻滞(1947),阻滞,notion,0,1,1,0,1,1,0.007422,4,0.26356,0.275695,0
阻疑(1947),阻疑,notion,0,1,1,0,1,1,0.014222,4,0.275404,0.296091,0
阻碍(1947),阻碍,notion,0,2,2,0,2,2,0.031545,4,0.305336,0.340645,2219.908318
阿Q(1947),阿Q,notion,0,2,2,0,2,2,0.027932,4,0.299811,0.333101,2443.455357
阿刺伯(1947),阿刺伯,notion,0,1,1,0,1,1,0.00981,4,0.267191,0.28214,0
阿剌伯(1947),阿剌伯,notion,0,1,1,0,1,1,0.00981,4,0.267191,0.28214,0
阿历克(1947),阿历克,notion,0,1,1,0,1,1,0.00981,4,0.267191,0.28214,0
阿尔巴尼亚(1947),阿尔巴尼亚,notion,0,1,1,0,1,1,0.00981,4,0.267191,0.28214,0
阿巴(1947),阿巴,notion,0,1,1,0,1,1,0.017323,4,0.281723,0.306272,0
附件(1947),附件,notion,0,1,1,0,1,1,0.002092,4,0.25318,0.25625,0
附註(1947),附註,notion,0,1,1,0,1,1,0.014081,4,0.275493,0.296238,0
陆机(1947),陆机,notion,0,1,1,0,1,1,0.014081,4,0.275493,0.296238,0
陆沉(1947),陆沉,notion,0,1,1,0,1,1,0.013711,4,0.275027,0.295469,0
陇海(1947),陇海,notion,0,2,2,0,2,2,0.031034,4,0.30613,0.341707,2639.595687
陇海线(1947),陇海线,notion,0,1,1,0,1,1,0.017323,4,0.281723,0.306272,0
陈嘉庚(1947),陈嘉庚,notion,0,1,1,0,1,1,0.017323,4,0.281723,0.306272,0
陈子松(1947),陈子松,notion,0,1,1,0,1,1,0.011229,4,0.270366,0.287632,0
陈家(1947),陈家,notion,0,1,1,0,1,1,0.011229,4,0.270366,0.287632,0
陈师道(1947),陈师道,notion,0,1,1,0,1,1,0.014222,4,0.275404,0.296091,0
陈文(1947),陈文,notion,0,1,1,0,1,1,0.011229,4,0.270366,0.287632,0
陈明仁(1947),陈明仁,notion,0,1,1,0,1,1,0.014081,4,0.275493,0.296238,0
陈毅(1947),陈毅,notion,0,1,1,0,1,1,0.011229,4,0.270366,0.287632,0
陈白尘(1947),陈白尘,notion,0,1,1,0,1,1,0.017323,4,0.281723,0.306272,0
陈立夫(1947),陈立夫,notion,0,1,1,0,1,1,0.014222,4,0.275404,0.296091,0
陈诚(1947),陈诚,notion,0,1,1,0,1,1,0.014732,4,0.276453,0.297813,0
陈述(1947),陈述,notion,0,1,1,0,1,1,0.014081,4,0.275493,0.296238,0
陈顾远(1947),陈顾远,notion,0,1,1,0,1,1,0.014222,4,0.275404,0.296091,0
陋习(1947),陋习,notion,0,1,1,0,1,1,0.004749,4,0.257108,0.263793,0
降低(1947),降低,notion,0,1,1,0,1,1,0.014732,4,0.276453,0.297813,0
限制(1947),限制,notion,0,1,1,0,2,2,0.014081,4,0.275493,0.296238,0
陕北(1947),陕北,notion,0,3,3,0,3,3,0.042263,4,0.32539,0.365937,6975.425387
陕豫(1947),陕豫,notion,0,1,1,0,1,1,0.014081,4,0.275493,0.296238,0
院长(1947),院长,notion,0,3,3,0,4,4,0.037848,4,0.312921,0.35063,4836.024023
除大害(1947),除大害,notion,0,1,1,0,1,1,0.011229,4,0.270366,0.287632,0
除暴(1947),除暴,notion,0,1,1,0,1,1,0.011229,4,0.270366,0.287632,0
除非(1947),除非,notion,0,1,1,0,1,1,0.014732,4,0.276453,0.297813,0
除非己莫为(1947),除非己莫为,notion,0,1,1,0,1,1,0.017323,4,0.281723,0.306272,0
陨星(1947),陨星,notion,0,1,1,0,1,1,0.014081,4,0.275493,0.296238,0
陶四(1947),陶四,notion,0,1,1,0,3,3,0.003588,4,0.255396,0.260534,0
陷落(1947),陷落,notion,0,1,1,0,1,1,0.00981,4,0.267191,0.28214,0
随处(1947),随处,notion,0,1,1,0,1,1,0.013711,4,0.275027,0.295469,0
随想(1947),随想,notion,0,1,1,0,1,1,0.009035,4,0.265075,0.278404,0
随意(1947),随意,notion,0,1,1,0,1,1,0.014081,4,0.275493,0.296238,0
随感(1947),随感,notion,0,1,1,0,3,3,0.007422,4,0.26356,0.275695,0
随铁大少(1947),随铁大少,notion,0,1,1,0,1,1,0.014081,4,0.275493,0.296238,0
隐忧(1947),隐忧,notion,0,1,1,0,1,1,0.014222,4,0.275404,0.296091,0
隔膜(1947),隔膜,notion,0,1,1,0,1,1,0.017323,4,0.281723,0.306272,0
难为(1947),难为,notion,0,1,1,0,1,1,0.014732,4,0.276453,0.297813,0
难产(1947),难产,notion,0,1,1,0,1,1,0.007422,4,0.26356,0.275695,0
难作(1947),难作,notion,0,1,1,0,1,1,0.004749,4,0.257108,0.263793,0
难兄难弟(1947),难兄难弟,notion,0,2,2,0,2,2,0.01948,4,0.281468,0.30593,668.20053
难忘(1947),难忘,notion,0,1,1,0,1,1,0.014081,4,0.275493,0.296238,0
难民(1947),难民,notion,0,2,2,0,3,3,0.032055,4,0.30624,0.341853,2215.722594
难者(1947),难者,notion,0,1,1,0,1,1,0.014081,4,0.275493,0.296238,0
难言之隐(1947),难言之隐,notion,0,1,1,0,1,1,0.013711,4,0.275027,0.295469,0
难题(1947),难题,notion,0,2,2,0,2,2,0.024032,4,0.290894,0.320321,1695.498775
雅俗(1947),雅俗,notion,0,1,1,0,1,1,0.014081,4,0.275493,0.296238,0
集体(1947),集体,notion,0,3,3,0,3,3,0.031454,4,0.30322,0.33785,5234.170784
集体创作(1947),集体创作,notion,0,1,1,0,1,1,0.017323,4,0.281723,0.306272,0
集合起来(1947),集合起来,notion,0,1,1,0,1,1,0.014081,4,0.275493,0.296238,0
集团(1947),集团,notion,0,2,2,0,2,2,0.026359,4,0.294788,0.325997,1561.492709
集权(1947),集权,notion,0,1,1,0,1,1,0.013711,4,0.275027,0.295469,0
集结(1947),集结,notion,0,1,1,0,1,1,0.002092,4,0.25318,0.25625,0
集训(1947),集训,notion,0,1,1,0,1,1,0.003699,4,0.256009,0.261706,0
集邮(1947),集邮,notion,0,1,1,0,1,1,0.014222,4,0.275404,0.296091,0
雕刻(1947),雕刻,notion,0,2,2,0,2,2,0.024542,4,0.292264,0.322335,1826.657886
雕刻家(1947),雕刻家,notion,0,1,1,0,1,1,0.00981,4,0.267191,0.28214,0
雨后春笋(1947),雨后春笋,notion,0,1,1,0,1,1,0.014081,4,0.275493,0.296238,0
雨点(1947),雨点,notion,0,1,1,0,1,1,0.014732,4,0.276453,0.297813,0
零简(1947),零简,notion,0,1,1,0,1,1,0.011229,4,0.270366,0.287632,0
雷先生(1947),雷先生,notion,0,2,2,0,2,2,0.024542,4,0.292264,0.322335,1826.657886
需要(1947),需要,notion,0,8,8,0,20,20,0.083655,4,0.395608,0.434427,39106.986893
震撼(1947),震撼,notion,0,1,1,0,1,1,0.011229,4,0.270366,0.287632,0
霉季(1947),霉季,notion,0,1,1,0,1,1,0.014732,4,0.276453,0.297813,0
露出(1947),露出,notion,0,1,1,0,1,1,0.014732,4,0.276453,0.297813,0
青年人(1947),青年人,notion,0,2,2,0,2,2,0.01897,4,0.280427,0.304282,657.210893
青年会(1947),青年会,notion,0,1,1,0,1,1,0.017323,4,0.281723,0.306272,0
青年修养(1947),青年修养,notion,0,1,1,0,1,1,0.014222,4,0.275404,0.296091,0
青年党(1947),青年党,notion,0,1,1,0,1,1,0.014732,4,0.276453,0.297813,0
青年团(1947),青年团,notion,0,1,1,0,1,1,0.009035,4,0.265075,0.278404,0
青沙(1947),青沙,notion,0,1,1,0,1,1,0.007422,4,0.26356,0.275695,0
青青(1947),青青,notion,0,1,1,0,1,1,0.014732,4,0.276453,0.297813,0
静静的(1947),静静的,notion,0,1,1,0,1,1,0.003699,4,0.256009,0.261706,0
非常(1947),非常,notion,0,1,1,0,1,1,0.004749,4,0.257108,0.263793,0
非改(1947),非改,notion,0,1,1,0,1,1,0.014081,4,0.275493,0.296238,0
非政治性(1947),非政治性,notion,0,1,1,0,1,1,0.017323,4,0.281723,0.306272,0
非敌(1947),非敌,notion,0,1,1,0,1,1,0.00981,4,0.267191,0.28214,0
非无(1947),非无,notion,0,1,1,0,1,1,0.014081,4,0.275493,0.296238,0
非有(1947),非有,notion,0,1,1,0,1,1,0.002092,4,0.25318,0.25625,0
非法(1947),非法,notion,0,2,2,0,2,2,0.012624,4,0.269533,0.286265,548.418626
非法组织(1947),非法组织,notion,0,1,1,0,1,1,0.017323,4,0.281723,0.306272,0
非美(1947),非美,notion,0,1,1,0,1,1,0.017323,4,0.281723,0.306272,0
面临(1947),面临,notion,0,1,1,0,1,1,0.014222,4,0.275404,0.296091,0
面前(1947),面前,notion,0,1,1,0,1,1,0.017323,4,0.281723,0.306272,0
面包(1947),面包,notion,0,1,1,0,1,1,0.011229,4,0.270366,0.287632,0
面孔(1947),面孔,notion,0,1,1,0,1,1,0.014081,4,0.275493,0.296238,0
面对(1947),面对,notion,0,1,1,0,1,1,0.009035,4,0.265075,0.278404,0
面目(1947),面目,notion,0,1,1,0,1,1,0.013711,4,0.275027,0.295469,0
面目一新(1947),面目一新,notion,0,1,1,0,2,2,0.00981,4,0.267191,0.28214,0
面貌(1947),面貌,notion,0,2,2,0,2,2,0.024032,4,0.290894,0.320321,1695.498775
面面观(1947),面面观,notion,0,2,2,0,3,3,0.031545,4,0.305336,0.340645,2219.908318
革命史(1947),革命史,notion,0,2,2,0,2,2,0.02531,4,0.2954,0.326876,2496.768821
革命战争(1947),革命战争,notion,0,1,1,0,1,1,0.013711,4,0.275027,0.295469,0
革命政权(1947),革命政权,notion,0,1,1,0,1,1,0.007422,4,0.26356,0.275695,0
革命者(1947),革命者,notion,0,2,2,0,3,3,0.019415,4,0.284233,0.310251,1126.485279
革新(1947),革新,notion,0,4,4,0,6,6,0.045411,4,0.326385,0.36717,10482.426242
革职(1947),革职,notion,0,1,1,0,1,1,0.017323,4,0.281723,0.306272,0
鞭策(1947),鞭策,notion,0,1,1,0,1,1,0.003588,4,0.255396,0.260534,0
韦镇福(1947),韦镇福,notion,0,1,1,0,1,1,0.011229,4,0.270366,0.287632,0
韩国(1947),韩国,notion,0,2,2,0,4,4,0.018845,4,0.280243,0.303989,1083.402703
韩江(1947),韩江,notion,0,1,1,0,2,2,0.011229,4,0.270366,0.287632,0
韬公(1947),韬公,notion,0,1,1,0,1,1,0.011229,4,0.270366,0.287632,0
韬奋(1947),韬奋,notion,0,6,6,0,7,7,0.060032,4,0.352434,0.395598,17965.481474
音乐(1947),音乐,notion,0,3,3,0,8,8,0.040041,4,0.320772,0.360407,6754.232663
音乐家(1947),音乐家,notion,0,1,1,0,1,1,0.013711,4,0.275027,0.295469,0
音乐界(1947),音乐界,notion,0,1,1,0,1,1,0.014732,4,0.276453,0.297813,0
项羽(1947),项羽,notion,0,1,1,0,1,1,0.017323,4,0.281723,0.306272,0
须待(1947),须待,notion,0,1,1,0,1,1,0.014222,4,0.275404,0.296091,0
须要(1947),须要,notion,0,1,1,0,1,1,0.014732,4,0.276453,0.297813,0
顽固(1947),顽固,notion,0,1,1,0,1,1,0.007422,4,0.26356,0.275695,0
顽固派(1947),顽固派,notion,0,1,1,0,1,1,0.014081,4,0.275493,0.296238,0
顽童(1947),顽童,notion,0,1,1,0,1,1,0.013711,4,0.275027,0.295469,0
顾临(1947),顾临,notion,0,1,1,0,1,1,0.014081,4,0.275493,0.296238,0
顾前不顾后(1947),顾前不顾后,notion,0,1,1,0,1,1,0.013711,4,0.275027,0.295469,0
顾家(1947),顾家,notion,0,1,1,0,1,1,0.007422,4,0.26356,0.275695,0
顾炎武(1947),顾炎武,notion,0,1,1,0,1,1,0.014222,4,0.275404,0.296091,0
顾远(1947),顾远,notion,0,1,1,0,2,2,0.014222,4,0.275404,0.296091,0
顾问(1947),顾问,notion,0,1,1,0,1,1,0.014081,4,0.275493,0.296238,0
颁布(1947),颁布,notion,0,1,1,0,1,1,0.009035,4,0.265075,0.278404,0
颂华(1947),颂华,notion,0,1,1,0,2,2,0.017323,4,0.281723,0.306272,0
预算(1947),预算,notion,0,3,3,0,4,4,0.027731,4,0.296324,0.328255,3957.34187
领土(1947),领土,notion,0,3,3,0,3,3,0.038622,4,0.31649,0.355134,5969.179521
领导(1947),领导,notion,0,4,4,0,6,6,0.040983,4,0.318468,0.357649,8987.588928
领悟(1947),领悟,notion,0,2,2,0,2,2,0.018651,4,0.283055,0.30842,2017.209887
领袖(1947),领袖,notion,0,4,4,0,6,6,0.047398,4,0.330621,0.372077,10490.555625
颓势(1947),颓势,notion,0,2,2,0,2,2,0.02494,4,0.292941,0.323324,1747.290038
颓坦(1947),颓坦,notion,0,1,1,0,1,1,0.009035,4,0.265075,0.278404,0
题为(1947),题为,notion,0,1,1,0,3,3,0.004749,4,0.257108,0.263793,0
题记(1947),题记,notion,0,1,1,0,1,1,0.004749,4,0.257108,0.263793,0
题词(1947),题词,notion,0,3,3,0,10,10,0.041355,4,0.320953,0.360627,5686.400693
风习(1947),风习,notion,0,1,1,0,1,1,0.014732,4,0.276453,0.297813,0
风云(1947),风云,notion,0,1,1,0,1,1,0.017323,4,0.281723,0.306272,0
风云人物(1947),风云人物,notion,0,1,1,0,1,1,0.014222,4,0.275404,0.296091,0
风光(1947),风光,notion,0,1,1,0,1,1,0.014732,4,0.276453,0.297813,0
风和水(1947),风和水,notion,0,1,1,0,1,1,0.007422,4,0.26356,0.275695,0
风土(1947),风土,notion,0,1,1,0,1,1,0.007422,4,0.26356,0.275695,0
风度(1947),风度,notion,0,2,2,0,3,3,0.017669,4,0.279944,0.303513,871.280033
风急(1947),风急,notion,0,1,1,0,1,1,0.009035,4,0.265075,0.278404,0
风景线(1947),风景线,notion,0,2,2,0,3,3,0.023767,4,0.289685,0.318527,1452.186204
风暴(1947),风暴,notion,0,3,3,0,5,5,0.028528,4,0.296787,0.328915,3134.739374
风波(1947),风波,notion,0,1,1,0,1,1,0.014732,4,0.276453,0.297813,0
风潮(1947),风潮,notion,0,3,3,0,3,3,0.042523,4,0.324801,0.365241,6618.635877
风起云涌(1947),风起云涌,notion,0,1,1,0,1,1,0.011229,4,0.270366,0.287632,0
风险(1947),风险,notion,0,1,1,0,1,1,0.014081,4,0.275493,0.296238,0
风雨(1947),风雨,notion,0,1,1,0,3,3,0.017323,4,0.281723,0.306272,0
风雨飘摇(1947),风雨飘摇,notion,0,1,1,0,1,1,0.00981,4,0.267191,0.28214,0
风风雨雨(1947),风风雨雨,notion,0,1,1,0,2,2,0.011229,4,0.270366,0.287632,0
飘扬(1947),飘扬,notion,0,2,2,0,3,3,0.018651,4,0.283055,0.30842,2017.209887
飘摇(1947),飘摇,notion,0,1,1,0,1,1,0.004749,4,0.257108,0.263793,0
飘流(1947),飘流,notion,0,1,1,0,1,1,0.014732,4,0.276453,0.297813,0
飘荡(1947),飘荡,notion,0,1,1,0,1,1,0.009035,4,0.265075,0.278404,0
飞机(1947),飞机,notion,0,1,1,0,1,1,0.017323,4,0.281723,0.306272,0
飞渡(1947),飞渡,notion,0,1,1,0,1,1,0.014081,4,0.275493,0.296238,0
飞盘(1947),飞盘,notion,0,2,2,0,2,2,0.028442,4,0.300022,0.333394,2187.730369
食盐(1947),食盐,notion,0,1,1,0,1,1,0.014081,4,0.275493,0.296238,0
饥民(1947),饥民,notion,0,1,1,0,1,1,0.014732,4,0.276453,0.297813,0
饥荒(1947),饥荒,notion,0,1,1,0,1,1,0.017323,4,0.281723,0.306272,0
饥遍(1947),饥遍,notion,0,1,1,0,1,1,0.009035,4,0.265075,0.278404,0
饥馑(1947),饥馑,notion,0,1,1,0,1,1,0.00981,4,0.267191,0.28214,0
饯别(1947),饯别,notion,0,1,1,0,1,1,0.014081,4,0.275493,0.296238,0
饶恕(1947),饶恕,notion,0,1,1,0,1,1,0.014732,4,0.276453,0.297813,0
饼干(1947),饼干,notion,0,1,1,0,1,1,0.011229,4,0.270366,0.287632,0
首次(1947),首次,notion,0,1,1,0,1,1,0.014222,4,0.275404,0.296091,0
首脑(1947),首脑,notion,0,1,1,0,1,1,0.017323,4,0.281723,0.306272,0
首都(1947),首都,notion,0,3,3,0,4,4,0.035244,4,0.310643,0.3477,4820.099079
首长(1947),首长,notion,0,1,1,0,1,1,0.017323,4,0.281723,0.306272,0
马克斯(1947),马克斯,notion,0,3,3,0,3,3,0.029883,4,0.302307,0.336605,4592.388471
马克西姆(1947),马克西姆,notion,0,1,1,0,1,1,0.00981,4,0.267191,0.28214,0
马凡(1947),马凡,notion,0,1,1,0,3,3,0.003699,4,0.256009,0.261706,0
马凡陀词(1947),马凡陀词,notion,0,1,1,0,1,1,0.014732,4,0.276453,0.297813,0
马占山(1947),马占山,notion,0,1,1,0,1,1,0.014732,4,0.276453,0.297813,0
马叙伦(1947),马叙伦,notion,0,3,3,0,3,3,0.035643,4,0.309994,0.346858,3809.101063
马头(1947),马头,notion,0,1,1,0,1,1,0.011229,4,0.270366,0.287632,0
马夷(1947),马夷,notion,0,1,1,0,1,1,0.017323,4,0.281723,0.306272,0
马戏团(1947),马戏团,notion,0,1,1,0,1,1,0.014732,4,0.276453,0.297813,0
马戏班(1947),马戏班,notion,0,1,1,0,1,1,0.014732,4,0.276453,0.297813,0
马虎(1947),马虎,notion,0,1,1,0,1,1,0.007422,4,0.26356,0.275695,0
马西(1947),马西,notion,0,1,1,0,1,1,0.017323,4,0.281723,0.306272,0
马赫(1947),马赫,notion,0,1,1,0,1,1,0.00981,4,0.267191,0.28214,0
马鞍(1947),马鞍,notion,0,2,2,0,2,2,0.02494,4,0.292941,0.323324,1747.290038
驯良(1947),驯良,notion,0,1,1,0,1,1,0.014081,4,0.275493,0.296238,0
驱使(1947),驱使,notion,0,1,1,0,1,1,0.017323,4,0.281723,0.306272,0
驱民(1947),驱民,notion,0,1,1,0,1,1,0.014222,4,0.275404,0.296091,0
驱爵(1947),驱爵,notion,0,1,1,0,1,1,0.017323,4,0.281723,0.306272,0
驱逐出境(1947),驱逐出境,notion,0,1,1,0,1,1,0.014081,4,0.275493,0.296238,0
驳斥(1947),驳斥,notion,0,3,3,0,3,3,0.043284,4,0.326791,0.367585,7036.110858
驻会(1947),驻会,notion,0,1,1,0,1,1,0.017323,4,0.281723,0.306272,0
驻委(1947),驻委,notion,0,1,1,0,1,1,0.017323,4,0.281723,0.306272,0
驼子(1947),驼子,notion,0,1,1,0,1,1,0.011229,4,0.270366,0.287632,0
骄子(1947),骄子,notion,0,1,1,0,1,1,0.009035,4,0.265075,0.278404,0
骆宾基(1947),骆宾基,notion,0,1,1,0,1,1,0.004749,4,0.257108,0.263793,0
骑师(1947),骑师,notion,0,1,1,0,1,1,0.014732,4,0.276453,0.297813,0
骗局(1947),骗局,notion,0,2,2,0,2,2,0.02494,4,0.292941,0.323324,1747.290038
骚动(1947),骚动,notion,0,2,2,0,2,2,0.025961,4,0.295759,0.327389,2231.848602
高中(1947),高中,notion,0,2,2,0,2,2,0.018431,4,0.28119,0.30549,1040.874592
高低(1947),高低,notion,0,1,1,0,1,1,0.011229,4,0.270366,0.287632,0
高利(1947),高利,notion,0,1,1,0,1,1,0.014222,4,0.275404,0.296091,0
高利贷(1947),高利贷,notion,0,1,1,0,1,1,0.013711,4,0.275027,0.295469,0
高官(1947),高官,notion,0,1,1,0,1,1,0.014222,4,0.275404,0.296091,0
高山仰止(1947),高山仰止,notion,0,1,1,0,1,1,0.014222,4,0.275404,0.296091,0
高涨(1947),高涨,notion,0,1,1,0,1,1,0.011229,4,0.270366,0.287632,0
高潮(1947),高潮,notion,0,2,2,0,2,2,0.017299,4,0.278915,0.301865,688.562525
高等教育(1947),高等教育,notion,0,3,3,0,3,3,0.036294,4,0.310219,0.347151,3739.543386
高雄(1947),高雄,notion,0,1,1,0,1,1,0.014222,4,0.275404,0.296091,0
鬍子(1947),鬍子,notion,0,2,2,0,2,2,0.027791,4,0.29968,0.332918,2405.290268
鬥志(1947),鬥志,notion,0,1,1,0,1,1,0.013711,4,0.275027,0.295469,0
鬼哭(1947),鬼哭,notion,0,2,2,0,2,2,0.01948,4,0.281468,0.30593,668.20053
魏使(1947),魏使,notion,0,1,1,0,1,1,0.017323,4,0.281723,0.306272,0
魏建功(1947),魏建功,notion,0,1,1,0,1,1,0.014732,4,0.276453,0.297813,0
魏特迈(1947),魏特迈,notion,0,1,1,0,1,1,0.003588,4,0.255396,0.260534,0
魏玛(1947),魏玛,notion,0,1,1,0,1,1,0.014081,4,0.275493,0.296238,0
魔术(1947),魔术,notion,0,2,2,0,3,3,0.02494,4,0.292941,0.323324,1747.290038
魔鬼(1947),魔鬼,notion,0,1,1,0,1,1,0.004749,4,0.257108,0.263793,0
鱼与熊掌(1947),鱼与熊掌,notion,0,1,1,0,1,1,0.014732,4,0.276453,0.297813,0
鲁东(1947),鲁东,notion,0,1,1,0,1,1,0.017323,4,0.281723,0.306272,0
鲁中(1947),鲁中,notion,0,1,1,0,1,1,0.013711,4,0.275027,0.295469,0
鲁南(1947),鲁南,notion,0,2,2,0,4,4,0.02494,4,0.292941,0.323324,1747.290038
鲁境(1947),鲁境,notion,0,1,1,0,1,1,0.017323,4,0.281723,0.306272,0
鲁尔(1947),鲁尔,notion,0,1,1,0,1,1,0.00981,4,0.267191,0.28214,0
鲁滨孙(1947),鲁滨孙,notion,0,1,1,0,1,1,0.014732,4,0.276453,0.297813,0
鲁苏(1947),鲁苏,notion,0,1,1,0,1,1,0.003588,4,0.255396,0.260534,0
鲁豫之战(1947),鲁豫之战,notion,0,1,1,0,1,1,0.013711,4,0.275027,0.295469,0
鲁迅(1947),鲁迅,notion,0,3,3,0,10,10,0.038252,4,0.315992,0.354511,5925.791163
鲍克(1947),鲍克,notion,0,1,1,0,1,1,0.017323,4,0.281723,0.306272,0
鳞爪(1947),鳞爪,notion,0,1,1,0,1,1,0.014081,4,0.275493,0.296238,0
鸟类(1947),鸟类,notion,0,1,1,0,1,1,0.014081,4,0.275493,0.296238,0
鸡娘(1947),鸡娘,notion,0,1,1,0,1,1,0.007422,4,0.26356,0.275695,0
鸡蛋(1947),鸡蛋,notion,0,1,1,0,1,1,0.014081,4,0.275493,0.296238,0
鸳鸯(1947),鸳鸯,notion,0,1,1,0,1,1,0.014222,4,0.275404,0.296091,0
鹏举(1947),鹏举,notion,0,1,1,0,2,2,0.011229,4,0.270366,0.287632,0
鹤山(1947),鹤山,notion,0,1,1,0,5,5,0.011229,4,0.270366,0.287632,0
鹦鹉(1947),鹦鹉,notion,0,1,1,0,1,1,0.013711,4,0.275027,0.295469,0
鹰爪(1947),鹰爪,notion,0,1,1,0,1,1,0.00981,4,0.267191,0.28214,0
麦克(1947),麦克,notion,0,1,1,0,1,1,0.017323,4,0.281723,0.306272,0
麦克阿瑟(1947),麦克阿瑟,notion,0,3,3,0,4,4,0.045256,4,0.33136,0.372858,7302.959362
麦帅(1947),麦帅,notion,0,1,1,0,1,1,0.009035,4,0.265075,0.278404,0
麦粉(1947),麦粉,notion,0,1,1,0,1,1,0.014081,4,0.275493,0.296238,0
麻木(1947),麻木,notion,0,1,1,0,1,1,0.014732,4,0.276453,0.297813,0
麻醉剂(1947),麻醉剂,notion,0,1,1,0,1,1,0.013711,4,0.275027,0.295469,0
黄伯轩(1947),黄伯轩,notion,0,1,1,0,1,1,0.011229,4,0.270366,0.287632,0
黄叶(1947),黄叶,notion,0,1,1,0,1,1,0.013711,4,0.275027,0.295469,0
黄山(1947),黄山,notion,0,1,1,0,1,1,0.014222,4,0.275404,0.296091,0
黄昏(1947),黄昏,notion,0,1,1,0,1,1,0.014081,4,0.275493,0.296238,0
黄梁梦(1947),黄梁梦,notion,0,1,1,0,1,1,0.014732,4,0.276453,0.297813,0
黄水(1947),黄水,notion,0,1,1,0,1,1,0.013711,4,0.275027,0.295469,0
黄汝成(1947),黄汝成,notion,0,1,1,0,1,1,0.014222,4,0.275404,0.296091,0
黄河(1947),黄河,notion,0,2,2,0,4,4,0.027932,4,0.299811,0.333101,2443.455357
黄泛区(1947),黄泛区,notion,0,1,1,0,1,1,0.014081,4,0.275493,0.296238,0
黄灾(1947),黄灾,notion,0,1,1,0,3,3,0.013711,4,0.275027,0.295469,0
黄着(1947),黄着,notion,0,1,1,0,1,1,0.017323,4,0.281723,0.306272,0
黄祸(1947),黄祸,notion,0,1,1,0,1,1,0.009035,4,0.265075,0.278404,0
黄者(1947),黄者,notion,0,1,1,0,1,1,0.017323,4,0.281723,0.306272,0
黄色(1947),黄色,notion,0,1,1,0,1,1,0.014732,4,0.276453,0.297813,0
黄花(1947),黄花,notion,0,1,1,0,1,1,0.017323,4,0.281723,0.306272,0
黄镇球(1947),黄镇球,notion,0,1,1,0,1,1,0.011229,4,0.270366,0.287632,0
黎明(1947),黎明,notion,0,2,2,0,2,2,0.031404,4,0.30602,0.34156,2430.025091
黑人(1947),黑人,notion,0,2,2,0,3,3,0.027133,4,0.29671,0.328744,1770.9936
黑夜(1947),黑夜,notion,0,1,1,0,1,1,0.014081,4,0.275493,0.296238,0
黑幕(1947),黑幕,notion,0,1,1,0,1,1,0.011229,4,0.270366,0.287632,0
黑智儿(1947),黑智儿,notion,0,1,1,0,1,1,0.009035,4,0.265075,0.278404,0
黑暗(1947),黑暗,notion,0,2,2,0,2,2,0.023521,4,0.291018,0.320504,1911.402908
黑暗面(1947),黑暗面,notion,0,1,1,0,1,1,0.014222,4,0.275404,0.296091,0
黑点(1947),黑点,notion,0,2,2,0,2,2,0.021132,4,0.288412,0.316623,2574.708611
黑白分明(1947),黑白分明,notion,0,1,1,0,1,1,0.014081,4,0.275493,0.296238,0
黑皮(1947),黑皮,notion,0,1,1,0,1,1,0.011229,4,0.270366,0.287632,0
黑色(1947),黑色,notion,0,1,1,0,1,1,0.003588,4,0.255396,0.260534,0
黩武(1947),黩武,notion,0,1,1,0,2,2,0.009035,4,0.265075,0.278404,0
鼓动(1947),鼓动,notion,0,1,1,0,1,1,0.009035,4,0.265075,0.278404,0
鼓励(1947),鼓励,notion,0,2,2,0,2,2,0.018651,4,0.283055,0.30842,2017.209887
鼓吹(1947),鼓吹,notion,0,1,1,0,1,1,0.009035,4,0.265075,0.278404,0
齐家(1947),齐家,notion,0,1,1,0,1,1,0.014222,4,0.275404,0.296091,0
齐鲁(1947),齐鲁,notion,0,1,1,0,1,1,0.014081,4,0.275493,0.296238,0
龙凤(1947),龙凤,notion,0,1,1,0,1,1,0.014732,4,0.276453,0.297813,0
龙门(1947),龙门,notion,0,1,1,0,1,1,0.011229,4,0.270366,0.287632,0
