Id,Label,type,indegree,outdegree,Degree,weighted indegree,weighted outdegree,Weighted Degree,eigencentrality,Eccentricity,closnesscentrality,harmonicclosnesscentrality,betweenesscentrality
《中央周刊》,《中央周刊》,journal,1384,0,1384,2484,0,2484,0.822262,3,0.38027,0.456453,6305198.656262
《时代杂志》,《时代杂志》,journal,929,0,929,1940,0,1940,0.56498,3,0.363526,0.416079,3711891.905199
《国讯》,《国讯》,journal,886,0,886,1452,0,1452,0.58149,3,0.36202,0.412263,3283467.871036
《再生》,《再生》,journal,724,0,724,1522,0,1522,0.427267,3,0.356455,0.397888,2942695.261488
《观察》,《观察》,journal,1057,0,1057,1636,0,1636,0.667651,3,0.368086,0.427437,4148836.177627
《正报》,《正报》,journal,959,0,959,1574,0,1574,0.551964,3,0.364585,0.418741,4092796.186273
《中建》,《中建》,journal,481,0,481,816,0,816,0.250765,3,0.348421,0.376325,2038475.712187
《光明报》,《光明报》,journal,430,0,430,591,0,591,0.301583,3,0.346781,0.3718,1265458.519764
《群众》,《群众》,journal,1541,0,1541,2879,0,2879,0.984868,3,0.386412,0.470385,6659218.021519
《时与文》,《时与文》,journal,962,0,962,1496,0,1496,0.597633,3,0.364691,0.419007,3825422.878936
《主流》,《主流》,journal,194,0,194,296,0,296,0.133381,3,0.339387,0.350859,566287.364969
《展望》,《展望》,journal,1561,0,1561,2695,0,2695,1,3,0.387208,0.472159,6793259.170314
杂话(1948),杂话,notion,0,2,2,0,72,72,0.026272,4,0.29319,0.323683,1793.896368
茶亭(1948),茶亭,notion,0,1,1,0,70,70,0.016518,4,0.278724,0.3015,0
中国(1948),中国,notion,0,15,15,0,287,287,0.134826,2,0.5005,0.500998,148023.942963
使命(1948),使命,notion,0,2,2,0,34,34,0.009848,4,0.265524,0.27926,689.820462
对外贸易(1948),对外贸易,notion,0,1,1,0,33,33,0.007515,4,0.262793,0.274313,0
应有(1948),应有,notion,0,6,6,0,41,41,0.055844,4,0.34071,0.383369,21449.665436
我国(1948),我国,notion,0,6,6,0,45,45,0.058827,4,0.346173,0.389159,23144.145684
措施(1948),措施,notion,0,6,6,0,41,41,0.061512,4,0.349816,0.392919,23616.177358
政府(1948),政府,notion,0,10,10,0,72,72,0.108857,4,0.444846,0.469475,78759.354022
重大(1948),重大,notion,0,3,3,0,35,35,0.033077,4,0.30475,0.339911,5680.358983
战局(1948),战局,notion,0,9,9,0,69,69,0.103687,4,0.433401,0.461999,65117.807189
展望(1948),展望,notion,0,9,9,0,131,131,0.090116,4,0.402432,0.439804,54230.704764
制度(1948),制度,notion,0,10,10,0,89,89,0.094853,4,0.421392,0.453836,81484.990021
文官(1948),文官,notion,0,1,1,0,25,25,0.007515,4,0.262793,0.274313,0
历史(1948),历史,notion,0,11,11,0,65,65,0.113163,4,0.452672,0.474389,88113.819417
史谈(1948),史谈,notion,0,1,1,0,20,20,0.007515,4,0.262793,0.274313,0
国际(1948),国际,notion,0,14,14,0,71,71,0.130108,4,0.484428,0.492657,122451.814544
官僚政治(1948),官僚政治,notion,0,2,2,0,21,21,0.026972,4,0.293947,0.324781,1749.441854
政治(1948),政治,notion,0,13,13,0,117,117,0.125091,4,0.475898,0.487976,111855.53628
经济(1948),经济,notion,0,15,15,0,141,141,0.134826,2,0.5005,0.500998,148023.942963
上海(1948),上海,notion,0,13,13,0,98,98,0.127776,4,0.480217,0.490339,112340.033327
学生(1948),学生,notion,0,13,13,0,99,99,0.127776,4,0.480217,0.490339,112340.033327
亚洲(1948),亚洲,notion,0,5,5,0,25,25,0.067004,4,0.361706,0.40461,20499.304796
批评(1948),批评,notion,0,8,8,0,143,143,0.083489,4,0.391078,0.430731,47429.054112
美国(1948),美国,notion,0,13,13,0,281,281,0.121765,4,0.471123,0.485314,116778.745118
各国(1948),各国,notion,0,3,3,0,23,23,0.02701,4,0.291982,0.321975,4209.231546
政局(1948),政局,notion,0,6,6,0,40,40,0.065371,4,0.354671,0.39781,23585.421486
时事(1948),时事,notion,0,3,3,0,25,25,0.037828,4,0.311575,0.348895,5613.568801
随感(1948),随感,notion,0,2,2,0,24,24,0.026507,4,0.294224,0.325181,2012.895914
联大(1948),联大,notion,0,1,1,0,13,13,0.009755,4,0.266617,0.281135,0
华莱士(1948),华莱士,notion,0,8,8,0,31,31,0.084865,4,0.386531,0.426971,42034.841156
反对(1948),反对,notion,0,11,11,0,51,51,0.119078,4,0.468596,0.483773,95639.289365
日内瓦(1948),日内瓦,notion,0,2,2,0,13,13,0.013265,4,0.270534,0.287979,961.111373
《新路周刊》,《新路周刊》,journal,778,0,778,1258,0,1258,0.477642,3,0.358291,0.40268,3076641.985262
瑞士(1948),瑞士,notion,0,3,3,0,13,13,0.024586,4,0.286876,0.314355,3031.227895
三年(1948),三年,notion,0,6,6,0,16,16,0.045676,4,0.321577,0.36154,19264.271797
今日(1948),今日,notion,0,10,10,0,39,39,0.101285,4,0.420167,0.45297,62340.463254
多幅(1948),多幅,notion,0,2,2,0,21,21,0.030758,4,0.303347,0.337959,2812.221703
思想(1948),思想,notion,0,11,11,0,42,42,0.107836,4,0.437591,0.464872,79407.198571
梁漱溟(1948),梁漱溟,notion,0,2,2,0,11,11,0.012553,4,0.269796,0.286714,703.533419
游击战争(1948),游击战争,notion,0,2,2,0,12,12,0.026269,4,0.293695,0.324415,1931.353166
苏联(1948),苏联,notion,0,10,10,0,89,89,0.11406,4,0.46044,0.478992,86278.879638
前身(1948),前身,notion,0,1,1,0,9,9,0.009751,4,0.267186,0.282133,0
奋斗史(1948),奋斗史,notion,0,1,1,0,9,9,0.009751,4,0.267186,0.282133,0
新四军(1948),新四军,notion,0,1,1,0,9,9,0.009751,4,0.267186,0.282133,0
民主(1948),民主,notion,0,14,14,0,110,110,0.131517,3,0.500433,0.50091,142167.109417
风光(1948),风光,notion,0,1,1,0,9,9,0.008247,4,0.26379,0.27611,0
北美(1948),北美,notion,0,2,2,0,9,9,0.021542,4,0.284314,0.310373,1410.419447
古录(1948),古录,notion,0,1,1,0,8,8,0.007515,4,0.262793,0.274313,0
委员会(1948),委员会,notion,0,7,7,0,20,20,0.070819,4,0.35956,0.402658,28963.980128
对华政策(1948),对华政策,notion,0,8,8,0,19,19,0.090858,4,0.403686,0.440714,47316.608517
成立(1948),成立,notion,0,6,6,0,15,15,0.060828,4,0.351091,0.394217,25502.018728
援华(1948),援华,notion,0,6,6,0,24,24,0.069789,4,0.364868,0.40766,27116.53532
琐记(1948),琐记,notion,0,1,1,0,8,8,0.004718,4,0.258401,0.266227,0
运粮(1948),运粮,notion,0,1,1,0,8,8,0.004718,4,0.258401,0.266227,0
重游(1948),重游,notion,0,1,1,0,9,9,0.01022,4,0.267243,0.282233,0
南京(1948),南京,notion,0,12,12,0,55,55,0.106113,4,0.421298,0.45388,78404.377054
大学生(1948),大学生,notion,0,6,6,0,16,16,0.067663,4,0.35901,0.40207,23899.532079
天下(1948),天下,notion,0,5,5,0,12,12,0.046511,4,0.315898,0.354497,8745.443343
天风(1948),天风,notion,0,1,1,0,7,7,0.01424,4,0.275514,0.296275,0
工人(1948),工人,notion,0,7,7,0,30,30,0.07548,4,0.376158,0.417998,40125.215041
攻势(1948),攻势,notion,0,6,6,0,13,13,0.061939,4,0.346014,0.388992,19465.002812
文化(1948),文化,notion,0,13,13,0,53,53,0.113591,4,0.444477,0.469409,99595.27413
海涛(1948),海涛,notion,0,1,1,0,7,7,0.01424,4,0.275514,0.296275,0
演辞(1948),演辞,notion,0,2,2,0,9,9,0.026507,4,0.294224,0.325181,2012.895914
炉边(1948),炉边,notion,0,1,1,0,7,7,0.011322,4,0.269061,0.285394,0
独树港(1948),独树港,notion,0,1,1,0,7,7,0.004718,4,0.258401,0.266227,0
研究(1948),研究,notion,0,9,9,0,27,27,0.087771,4,0.397534,0.435978,59538.263334
社会主义(1948),社会主义,notion,0,8,8,0,61,61,0.064387,4,0.346333,0.389436,29683.347299
第一(1948),第一,notion,0,5,5,0,14,14,0.055653,4,0.344396,0.38724,19487.215145
街头(1948),街头,notion,0,2,2,0,8,8,0.014772,4,0.272635,0.291539,771.57337
要求(1948),要求,notion,0,2,2,0,10,10,0.026491,4,0.291937,0.321853,1403.825067
论衡(1948),论衡,notion,0,1,1,0,7,7,0.01424,4,0.275514,0.296275,0
选粹(1948),选粹,notion,0,1,1,0,7,7,0.01424,4,0.275514,0.296275,0
两周(1948),两周,notion,0,2,2,0,8,8,0.026507,4,0.294224,0.325181,2012.895914
中部(1948),中部,notion,0,1,1,0,6,6,0.016752,4,0.279138,0.302165,0
作者(1948),作者,notion,0,6,6,0,12,12,0.050426,4,0.329937,0.37139,20641.371989
先生(1948),先生,notion,0,14,14,0,142,142,0.130108,4,0.484428,0.492657,122451.814544
剪影(1948),剪影,notion,0,1,1,0,7,7,0.004718,4,0.258401,0.266227,0
土地(1948),土地,notion,0,7,7,0,43,43,0.079306,4,0.385896,0.426383,41347.040292
地方(1948),地方,notion,0,8,8,0,26,26,0.089532,4,0.409138,0.44484,57560.325354
大别山(1948),大别山,notion,0,3,3,0,9,9,0.04751,4,0.331714,0.373253,8022.59349
局势(1948),局势,notion,0,10,10,0,26,26,0.105797,4,0.437234,0.464584,79445.786929
广播(1948),广播,notion,0,1,1,0,7,7,0.016752,4,0.279138,0.302165,0
日本(1948),日本,notion,0,13,13,0,85,85,0.127776,4,0.480217,0.490339,112340.033327
游记(1948),游记,notion,0,1,1,0,6,6,0.016752,4,0.279138,0.302165,0
续完(1948),续完,notion,0,8,8,0,27,27,0.090559,4,0.409183,0.444873,56613.715202
自治(1948),自治,notion,0,7,7,0,15,15,0.086307,4,0.397745,0.436033,40222.388866
裁军(1948),裁军,notion,0,1,1,0,6,6,0.009755,4,0.266617,0.281135,0
解放(1948),解放,notion,0,6,6,0,22,22,0.062336,4,0.353337,0.396479,25433.435319
远东(1948),远东,notion,0,8,8,0,25,25,0.085293,4,0.390144,0.429966,44140.896344
问题(1948),问题,notion,0,15,15,0,192,192,0.134826,2,0.5005,0.500998,148023.942963
香港(1948),香港,notion,0,9,9,0,48,48,0.084944,4,0.381506,0.422767,42920.569663
世界(1948),世界,notion,0,14,14,0,55,55,0.130108,4,0.484428,0.492657,122451.814544
事件(1948),事件,notion,0,8,8,0,27,27,0.092056,4,0.404294,0.44118,45897.30445
周末(1948),周末,notion,0,1,1,0,5,5,0.016752,4,0.279138,0.302165,0
外二题(1948),外二题,notion,0,1,1,0,6,6,0.009755,4,0.266617,0.281135,0
外交政策(1948),外交政策,notion,0,2,2,0,10,10,0.021756,4,0.286964,0.314433,2044.761444
工作(1948),工作,notion,0,12,12,0,89,89,0.113236,4,0.444793,0.469553,98151.104805
抗议(1948),抗议,notion,0,5,5,0,17,17,0.040207,4,0.304626,0.339855,6891.852051
梧州(1948),梧州,notion,0,1,1,0,5,5,0.016518,4,0.278724,0.3015,0
民盟(1948),民盟,notion,0,5,5,0,11,11,0.058247,4,0.33954,0.382049,13654.591532
英国(1948),英国,notion,0,9,9,0,27,27,0.097543,4,0.422958,0.454878,67350.531473
解释(1948),解释,notion,0,1,1,0,5,5,0.01022,4,0.267243,0.282233,0
评介(1948),评介,notion,0,5,5,0,10,10,0.053994,4,0.340093,0.382648,20160.911768
诗人(1948),诗人,notion,0,3,3,0,9,9,0.034022,4,0.306041,0.341641,5811.628066
进入(1948),进入,notion,0,2,2,0,7,7,0.030758,4,0.303347,0.337959,2812.221703
青年(1948),青年,notion,0,9,9,0,39,39,0.093701,4,0.40785,0.443931,54730.647442
一代(1948),一代,notion,0,1,1,0,5,5,0.005389,4,0.25849,0.266394,0
《中建:北平版》,《中建:北平版》,journal,486,0,486,689,0,689,0.314711,3,0.348583,0.376769,1391307.263684
上演(1948),上演,notion,0,1,1,0,8,8,0.009755,4,0.266617,0.281135,0
专访(1948),专访,notion,0,2,2,0,11,11,0.016573,4,0.278249,0.30079,1169.878765
义大利(1948),义大利,notion,0,4,4,0,12,12,0.046467,4,0.32235,0.362361,9577.417647
之间(1948),之间,notion,0,11,11,0,23,23,0.110221,4,0.447336,0.471095,91182.247223
儒家思想(1948),儒家思想,notion,0,1,1,0,5,5,0.007515,4,0.262793,0.274313,0
共产党(1948),共产党,notion,0,6,6,0,36,36,0.074519,4,0.376346,0.418109,30240.69003
军事(1948),军事,notion,0,6,6,0,20,20,0.078807,4,0.384946,0.425529,31324.768066
北平(1948),北平,notion,0,9,9,0,65,65,0.086514,4,0.38027,0.421702,39529.162341
华盛顿(1948),华盛顿,notion,0,7,7,0,11,11,0.070321,4,0.358736,0.401859,29239.735958
南昌(1948),南昌,notion,0,2,2,0,8,8,0.027839,4,0.295962,0.327676,1920.33989
原因(1948),原因,notion,0,5,5,0,8,8,0.044287,4,0.314602,0.352866,9832.072042
呼吁(1948),呼吁,notion,0,2,2,0,9,9,0.026491,4,0.291937,0.321853,1403.825067
和平(1948),和平,notion,0,14,14,0,68,68,0.125074,4,0.471182,0.485403,122088.196443
善后(1948),善后,notion,0,1,1,0,9,9,0.008247,4,0.26379,0.27611,0
四首(1948),四首,notion,0,2,2,0,5,5,0.017999,4,0.280116,0.303785,1897.286008
大选(1948),大选,notion,0,10,10,0,29,29,0.104676,4,0.439742,0.466214,82939.178117
实现(1948),实现,notion,0,5,5,0,14,14,0.060547,4,0.350567,0.393629,19615.426209
币制(1948),币制,notion,0,10,10,0,55,55,0.103252,4,0.423673,0.455433,64218.721708
幕剧(1948),幕剧,notion,0,1,1,0,4,4,0.004718,4,0.258401,0.266227,0
影剧(1948),影剧,notion,0,1,1,0,5,5,0.009739,4,0.265806,0.279704,0
徐州(1948),徐州,notion,0,3,3,0,6,6,0.04349,4,0.321192,0.360908,6041.296212
成都(1948),成都,notion,0,9,9,0,30,30,0.089012,4,0.389295,0.429323,45470.171105
我写(1948),我写,notion,0,1,1,0,4,4,0.016752,4,0.279138,0.302165,0
报导(1948),报导,notion,0,4,4,0,27,27,0.041207,4,0.318577,0.357769,12825.248662
捷克(1948),捷克,notion,0,3,3,0,10,10,0.036012,4,0.306365,0.342074,4567.575323
政策(1948),政策,notion,0,13,13,0,74,74,0.129185,4,0.49594,0.498591,131282.568278
方法(1948),方法,notion,0,6,6,0,14,14,0.066727,4,0.367043,0.40969,32091.708298
旧录(1948),旧录,notion,0,1,1,0,4,4,0.016752,4,0.279138,0.302165,0
杂记(1948),杂记,notion,0,6,6,0,13,13,0.076833,4,0.381274,0.422401,30991.420401
正视(1948),正视,notion,0,3,3,0,8,8,0.040732,4,0.317178,0.355983,6314.893682
破产(1948),破产,notion,0,5,5,0,9,9,0.051786,4,0.335267,0.377357,19104.650998
秋灯(1948),秋灯,notion,0,1,1,0,4,4,0.016752,4,0.279138,0.302165,0
经过(1948),经过,notion,0,4,4,0,9,9,0.045809,4,0.322876,0.362993,10303.975646
综合(1948),综合,notion,0,5,5,0,16,16,0.057959,4,0.347486,0.390468,22069.16044
航空(1948),航空,notion,0,2,2,0,5,5,0.021542,4,0.284314,0.310373,1410.419447
西安(1948),西安,notion,0,5,5,0,8,8,0.046727,4,0.320397,0.360054,11247.835093
解放军(1948),解放军,notion,0,2,2,0,19,19,0.026269,4,0.293695,0.324415,1931.353166
解放区(1948),解放区,notion,0,6,6,0,41,41,0.062102,4,0.346461,0.389458,21523.509976
计划(1948),计划,notion,0,10,10,0,36,36,0.096823,4,0.419603,0.452571,78627.377361
豫西(1948),豫西,notion,0,1,1,0,5,5,0.016752,4,0.279138,0.302165,0
赤色(1948),赤色,notion,0,2,2,0,5,5,0.024461,4,0.291756,0.321587,2304.72473
运动(1948),运动,notion,0,15,15,0,69,69,0.134826,2,0.5005,0.500998,148023.942963
青岛(1948),青岛,notion,0,6,6,0,13,13,0.056732,4,0.330896,0.372488,14505.752642
鲁迅(1948),鲁迅,notion,0,5,5,0,19,19,0.058165,4,0.345282,0.388172,17452.375568
黑白(1948),黑白,notion,0,1,1,0,4,4,0.004718,4,0.258401,0.266227,0
七五(1948),七五,notion,0,6,6,0,10,10,0.061536,4,0.343012,0.385831,17188.821622
三剑客(1948),三剑客,notion,0,1,1,0,4,4,0.009755,4,0.266617,0.281135,0
三十一日(1948),三十一日,notion,0,2,2,0,4,4,0.030758,4,0.303347,0.337959,2812.221703
东北(1948),东北,notion,0,11,11,0,40,40,0.113004,4,0.448511,0.471827,84090.771144
东南亚(1948),东南亚,notion,0,3,3,0,8,8,0.036243,4,0.308707,0.345168,5722.670135
东江(1948),东江,notion,0,2,2,0,8,8,0.026269,4,0.293695,0.324415,1931.353166
中枢(1948),中枢,notion,0,1,1,0,3,3,0.007515,4,0.262793,0.274313,0
之四(1948),之四,notion,0,5,5,0,7,7,0.050061,4,0.33239,0.374129,19389.298115
之新(1948),之新,notion,0,1,1,0,3,3,0.01424,4,0.275514,0.296275,0
书评(1948),书评,notion,0,5,5,0,28,28,0.042507,4,0.312508,0.350204,10242.977179
人民(1948),人民,notion,0,12,12,0,114,114,0.124467,4,0.480156,0.49025,107219.577807
人类(1948),人类,notion,0,6,6,0,9,9,0.068679,4,0.367079,0.409723,27172.837903
传奇(1948),传奇,notion,0,1,1,0,4,4,0.016752,4,0.279138,0.302165,0
伦敦(1948),伦敦,notion,0,7,7,0,16,16,0.076343,4,0.376007,0.417865,35553.795613
作家(1948),作家,notion,0,4,4,0,11,11,0.044493,4,0.319797,0.359266,9605.56456
八月八(1948),八月八,notion,0,1,1,0,3,3,0.01424,4,0.275514,0.296275,0
共匪(1948),共匪,notion,0,2,2,0,11,11,0.02398,4,0.290133,0.319191,1998.682918
内幕(1948),内幕,notion,0,8,8,0,13,13,0.089288,4,0.403903,0.44088,50609.258253
内阁(1948),内阁,notion,0,7,7,0,17,17,0.082553,4,0.384002,0.424786,35294.707959
军区(1948),军区,notion,0,1,1,0,3,3,0.007515,4,0.262793,0.274313,0
军火(1948),军火,notion,0,1,1,0,3,3,0.009739,4,0.265806,0.279704,0
军队(1948),军队,notion,0,2,2,0,6,6,0.026269,4,0.293695,0.324415,1931.353166
农村(1948),农村,notion,0,9,9,0,35,35,0.080598,4,0.383375,0.424364,57088.155552
农民(1948),农民,notion,0,9,9,0,28,28,0.099941,4,0.432353,0.4613,73958.467998
列车(1948),列车,notion,0,1,1,0,3,3,0.004718,4,0.258401,0.266227,0
势力(1948),势力,notion,0,6,6,0,10,10,0.063039,4,0.35274,0.39588,23771.915426
十月十日(1948),十月十日,notion,0,2,2,0,4,4,0.021756,4,0.286964,0.314433,2044.761444
华侨(1948),华侨,notion,0,7,7,0,19,19,0.086307,4,0.397745,0.436033,40222.388866
华北(1948),华北,notion,0,8,8,0,29,29,0.089198,4,0.397198,0.435656,41984.561942
华尔街(1948),华尔街,notion,0,1,1,0,9,9,0.009755,4,0.266617,0.281135,0
印度(1948),印度,notion,0,7,7,0,17,17,0.086573,4,0.396946,0.435401,39855.224976
友声(1948),友声,notion,0,2,2,0,120,120,0.030758,4,0.303347,0.337959,2812.221703
反帝(1948),反帝,notion,0,1,1,0,6,6,0.016518,4,0.278724,0.3015,0
发展(1948),发展,notion,0,10,10,0,30,30,0.09701,4,0.417691,0.451207,67270.96834
取得胜利(1948),取得胜利,notion,0,1,1,0,3,3,0.016518,4,0.278724,0.3015,0
同济(1948),同济,notion,0,4,4,0,10,10,0.041495,4,0.312638,0.350315,7139.881149
哲学(1948),哲学,notion,0,5,5,0,11,11,0.04272,4,0.313237,0.351136,10643.552045
《中建:华北航空版》,《中建:华北航空版》,journal,278,0,278,334,0,334,0.194796,3,0.341982,0.358312,371737.025481
唐诗(1948),唐诗,notion,0,1,1,0,3,3,0.01424,4,0.275514,0.296275,0
四川(1948),四川,notion,0,8,8,0,20,20,0.078267,4,0.365649,0.408503,29222.989927
国会(1948),国会,notion,0,4,4,0,7,7,0.048262,4,0.332154,0.373808,13262.507292
复兴(1948),复兴,notion,0,7,7,0,15,15,0.075194,4,0.375894,0.417765,36206.05759
多瑙河(1948),多瑙河,notion,0,2,2,0,4,4,0.026507,4,0.294224,0.325181,2012.895914
大会(1948),大会,notion,0,8,8,0,24,24,0.082535,4,0.379234,0.420748,37056.926052
大战(1948),大战,notion,0,6,6,0,13,13,0.070574,4,0.366006,0.408725,27256.7567
奇谭(1948),奇谭,notion,0,1,1,0,4,4,0.016752,4,0.279138,0.302165,0
学联(1948),学联,notion,0,4,4,0,7,7,0.048026,4,0.323348,0.363559,7832.168746
官僚资本主义(1948),官僚资本主义,notion,0,1,1,0,3,3,0.016518,4,0.278724,0.3015,0
宣布(1948),宣布,notion,0,1,1,0,3,3,0.009739,4,0.265806,0.279704,0
宪政(1948),宪政,notion,0,3,3,0,9,9,0.033809,4,0.305096,0.340377,5463.518126
对华(1948),对华,notion,0,4,4,0,8,8,0.036994,4,0.309546,0.346322,9081.203743
小结(1948),小结,notion,0,1,1,0,3,3,0.004718,4,0.258401,0.266227,0
尝试(1948),尝试,notion,0,2,2,0,5,5,0.012965,4,0.271708,0.289975,1825.821004
巡礼(1948),巡礼,notion,0,1,1,0,3,3,0.016752,4,0.279138,0.302165,0
布拉格(1948),布拉格,notion,0,2,2,0,4,4,0.026257,4,0.292073,0.322053,1522.40889
希望(1948),希望,notion,0,9,9,0,67,67,0.093623,4,0.412734,0.447558,63360.230651
希腊(1948),希腊,notion,0,3,3,0,22,22,0.036246,4,0.306866,0.342739,4667.991046
干涉(1948),干涉,notion,0,4,4,0,10,10,0.046232,4,0.322682,0.36276,9721.428336
平津(1948),平津,notion,0,6,6,0,12,12,0.066494,4,0.354136,0.397278,21606.778089
广东(1948),广东,notion,0,7,7,0,23,23,0.073261,4,0.364691,0.407549,28115.653142
广州(1948),广州,notion,0,7,7,0,21,21,0.08255,4,0.386014,0.426483,37622.165553
应负(1948),应负,notion,0,1,1,0,6,6,0.008247,4,0.26379,0.27611,0
座谈(1948),座谈,notion,0,5,5,0,15,15,0.05438,4,0.343451,0.386242,19493.320738
建设(1948),建设,notion,0,11,11,0,25,25,0.090874,4,0.393784,0.433094,66106.000894
总统(1948),总统,notion,0,11,11,0,32,32,0.119078,4,0.468596,0.483773,95639.289365
戊戌变法(1948),戊戌变法,notion,0,3,3,0,5,5,0.016214,4,0.270592,0.288134,1477.557689
战况(1948),战况,notion,0,1,1,0,3,3,0.009751,4,0.267186,0.282133,0
战区(1948),战区,notion,0,2,2,0,6,6,0.030992,4,0.303936,0.338757,2912.385696
改革(1948),改革,notion,0,13,13,0,61,61,0.122739,4,0.470887,0.485181,115935.967663
政治史(1948),政治史,notion,0,1,1,0,3,3,0.007515,4,0.262793,0.274313,0
新中国(1948),新中国,notion,0,4,4,0,9,9,0.049595,4,0.333659,0.375505,12971.949281
新作(1948),新作,notion,0,1,1,0,3,3,0.009755,4,0.266617,0.281135,0
新华社(1948),新华社,notion,0,1,1,0,7,7,0.016518,4,0.278724,0.3015,0
新德里(1948),新德里,notion,0,3,3,0,5,5,0.037579,4,0.309393,0.346067,4779.319455
新话(1948),新话,notion,0,1,1,0,4,4,0.009739,4,0.265806,0.279704,0
旧诗(1948),旧诗,notion,0,1,1,0,4,4,0.009739,4,0.265806,0.279704,0
时代(1948),时代,notion,0,12,12,0,26,26,0.12111,4,0.479604,0.489951,118140.526897
晚会(1948),晚会,notion,0,4,4,0,6,6,0.043376,4,0.321549,0.361396,10942.78226
棉田(1948),棉田,notion,0,1,1,0,3,3,0.004718,4,0.258401,0.266227,0
欧洲(1948),欧洲,notion,0,5,5,0,14,14,0.054849,4,0.337012,0.379287,16545.47837
欧美(1948),欧美,notion,0,1,1,0,3,3,0.007515,4,0.262793,0.274313,0
民主主义(1948),民主主义,notion,0,4,4,0,6,6,0.028267,4,0.287425,0.315242,3567.203068
民国(1948),民国,notion,0,3,3,0,15,15,0.041213,4,0.319634,0.359011,6966.552281
汉口(1948),汉口,notion,0,5,5,0,15,15,0.063119,4,0.356523,0.399585,19068.097275
江南(1948),江南,notion,0,6,6,0,17,17,0.075729,4,0.383179,0.424032,33722.297132
游戏(1948),游戏,notion,0,1,1,0,3,3,0.009751,4,0.267186,0.282133,0
湖南(1948),湖南,notion,0,6,6,0,12,12,0.074069,4,0.37302,0.415147,26427.049155
演词(1948),演词,notion,0,2,2,0,7,7,0.01727,4,0.278352,0.300956,1619.09855
琼崖(1948),琼崖,notion,0,2,2,0,6,6,0.014769,4,0.273708,0.293336,1042.722106
电教(1948),电教,notion,0,1,1,0,5,5,0.004718,4,0.258401,0.266227,0
知识(1948),知识,notion,0,5,5,0,9,9,0.038978,4,0.309444,0.346244,12720.455986
知识份子(1948),知识份子,notion,0,9,9,0,27,27,0.083233,4,0.38857,0.428724,51987.896435
短讯(1948),短讯,notion,0,1,1,0,3,3,0.009739,4,0.265806,0.279704,0
石头城(1948),石头城,notion,0,2,2,0,4,4,0.021535,4,0.28397,0.309841,889.229879
社论(1948),社论,notion,0,3,3,0,11,11,0.036024,4,0.308631,0.345069,5629.029515
粤桂(1948),粤桂,notion,0,1,1,0,3,3,0.016518,4,0.278724,0.3015,0
纪念(1948),纪念,notion,0,11,11,0,65,65,0.099416,4,0.41201,0.447136,73571.432256
纲领(1948),纲领,notion,0,4,4,0,11,11,0.042608,4,0.316857,0.355639,8902.988374
维辛斯基(1948),维辛斯基,notion,0,1,1,0,3,3,0.009755,4,0.266617,0.281135,0
罢课(1948),罢课,notion,0,5,5,0,8,8,0.052817,4,0.329821,0.371201,12684.107444
美援(1948),美援,notion,0,9,9,0,30,30,0.101811,4,0.424391,0.455876,59468.092517
美苏(1948),美苏,notion,0,11,11,0,36,36,0.11945,4,0.471715,0.485536,97274.577453
联盟(1948),联盟,notion,0,4,4,0,6,6,0.052764,4,0.333274,0.375072,10282.282394
联邦(1948),联邦,notion,0,2,2,0,4,4,0.01727,4,0.278352,0.300956,1619.09855
自由(1948),自由,notion,0,15,15,0,37,37,0.134826,2,0.5005,0.500998,148023.942963
苏北(1948),苏北,notion,0,6,6,0,17,17,0.078791,4,0.382049,0.423067,29000.417271
苦诉(1948),苦诉,notion,0,1,1,0,4,4,0.016752,4,0.279138,0.302165,0
英美(1948),英美,notion,0,6,6,0,13,13,0.070901,4,0.371031,0.41335,28193.705026
草案(1948),草案,notion,0,4,4,0,6,6,0.035257,4,0.304651,0.339833,8565.420516
衣食住行(1948),衣食住行,notion,0,1,1,0,3,3,0.005017,4,0.257497,0.26453,0
言官(1948),言官,notion,0,1,1,0,3,3,0.007515,4,0.262793,0.274313,0
认识(1948),认识,notion,0,8,8,0,16,16,0.075807,4,0.376082,0.417987,40061.530728
评传(1948),评传,notion,0,1,1,0,4,4,0.007515,4,0.262793,0.274313,0
贝奈斯(1948),贝奈斯,notion,0,4,4,0,6,6,0.046755,4,0.329157,0.37038,12517.610147
责任(1948),责任,notion,0,4,4,0,13,13,0.043836,4,0.31977,0.359233,9983.778727
费边(1948),费边,notion,0,1,1,0,3,3,0.002332,4,0.253398,0.256677,0
费边社(1948),费边社,notion,0,1,1,0,3,3,0.002332,4,0.253398,0.256677,0
起源(1948),起源,notion,0,1,1,0,3,3,0.007515,4,0.262793,0.274313,0
转捩(1948),转捩,notion,0,1,1,0,3,3,0.01424,4,0.275514,0.296275,0
遗着(1948),遗着,notion,0,1,1,0,3,3,0.007515,4,0.262793,0.274313,0
那裏(1948),那裏,notion,0,2,2,0,4,4,0.030758,4,0.303347,0.337959,2812.221703
长沙(1948),长沙,notion,0,5,5,0,9,9,0.051923,4,0.331422,0.373031,13053.938191
集体(1948),集体,notion,0,9,9,0,21,21,0.093216,4,0.412689,0.447524,67705.014707
Stilwell(1948),Stilwell,notion,0,1,1,0,2,2,0.005389,4,0.25849,0.266394,0
by(1948),by,notion,0,2,2,0,4,4,0.008698,4,0.258507,0.266483,0.569098
of(1948),of,notion,0,2,2,0,4,4,0.008698,4,0.258507,0.266483,0.569098
一九三三年(1948),一九三三年,notion,0,1,1,0,2,2,0.016518,4,0.278724,0.3015,0
一关(1948),一关,notion,0,1,1,0,2,2,0.009755,4,0.266617,0.281135,0
一天(1948),一天,notion,0,4,4,0,5,5,0.048207,4,0.330053,0.371412,13260.294943
一根(1948),一根,notion,0,1,1,0,2,2,0.004718,4,0.258401,0.266227,0
一步(1948),一步,notion,0,2,2,0,3,3,0.026503,4,0.295799,0.327444,2668.961321
一点(1948),一点,notion,0,5,5,0,8,8,0.064563,4,0.356658,0.399718,20322.621831
一种(1948),一种,notion,0,7,7,0,10,10,0.073314,4,0.370628,0.41304,33922.081341
一谈(1948),一谈,notion,0,1,1,0,2,2,0.009739,4,0.265806,0.279704,0
一边(1948),一边,notion,0,1,1,0,2,2,0.016518,4,0.278724,0.3015,0
三优(1948),三优,notion,0,1,1,0,2,2,0.002332,4,0.253398,0.256677,0
三周年(1948),三周年,notion,0,4,4,0,7,7,0.03567,4,0.300893,0.334709,4674.496605
三报(1948),三报,notion,0,1,1,0,2,2,0.007515,4,0.262793,0.274313,0
上之馆(1948),上之馆,notion,0,1,1,0,2,2,0.007515,4,0.262793,0.274313,0
下乡(1948),下乡,notion,0,2,2,0,5,5,0.014469,4,0.27493,0.295366,1965.542095
不同(1948),不同,notion,0,5,5,0,8,8,0.052893,4,0.336529,0.378755,16084.912752
专门知识(1948),专门知识,notion,0,1,1,0,2,2,0.016752,4,0.279138,0.302165,0
丛书(1948),丛书,notion,0,2,2,0,3,3,0.028074,4,0.296149,0.327943,1864.79583
东京(1948),东京,notion,0,5,5,0,9,9,0.052585,4,0.330082,0.371501,12972.423083
东南欧(1948),东南欧,notion,0,2,2,0,3,3,0.014772,4,0.272635,0.291539,771.57337
两个(1948),两个,notion,0,12,12,0,26,26,0.116731,4,0.45481,0.475742,98567.195199
两党(1948),两党,notion,0,4,4,0,5,5,0.046755,4,0.329157,0.37038,12517.610147
两大(1948),两大,notion,0,3,3,0,4,4,0.040732,4,0.317178,0.355983,6314.893682
两种(1948),两种,notion,0,7,7,0,11,11,0.071435,4,0.360457,0.403523,26306.589104
两难(1948),两难,notion,0,2,2,0,3,3,0.027839,4,0.295962,0.327676,1920.33989
中共中央(1948),中共中央,notion,0,2,2,0,8,8,0.026269,4,0.293695,0.324415,1931.353166
中国式(1948),中国式,notion,0,2,2,0,5,5,0.021542,4,0.284314,0.310373,1410.419447
中国通史(1948),中国通史,notion,0,1,1,0,2,2,0.01424,4,0.275514,0.296275,0
中大(1948),中大,notion,0,3,3,0,6,6,0.037813,4,0.309012,0.345568,4605.191573
中央(1948),中央,notion,0,4,4,0,5,5,0.048728,4,0.332243,0.373907,12822.507001
中央委员会(1948),中央委员会,notion,0,2,2,0,5,5,0.026272,4,0.29319,0.323683,1793.896368
中日(1948),中日,notion,0,1,1,0,2,2,0.01424,4,0.275514,0.296275,0
中演(1948),中演,notion,0,1,1,0,2,2,0.009755,4,0.266617,0.281135,0
中间(1948),中间,notion,0,1,1,0,6,6,0.008247,4,0.26379,0.27611,0
主潮(1948),主潮,notion,0,1,1,0,2,2,0.002332,4,0.253398,0.256677,0
之五(1948),之五,notion,0,2,2,0,3,3,0.024267,4,0.290987,0.320456,2179.633602
之六(1948),之六,notion,0,1,1,0,2,2,0.007515,4,0.262793,0.274313,0
之后(1948),之后,notion,0,6,6,0,9,9,0.057925,4,0.342856,0.385665,22995.589441
之君(1948),之君,notion,0,1,1,0,2,2,0.007515,4,0.262793,0.274313,0
之学官(1948),之学官,notion,0,1,1,0,2,2,0.007515,4,0.262793,0.274313,0
之封(1948),之封,notion,0,1,1,0,2,2,0.007515,4,0.262793,0.274313,0
之幕职(1948),之幕职,notion,0,1,1,0,2,2,0.007515,4,0.262793,0.274313,0
之战(1948),之战,notion,0,5,5,0,8,8,0.058262,4,0.341982,0.384678,15200.898698
之行(1948),之行,notion,0,3,3,0,5,5,0.024286,4,0.288839,0.317317,5141.270303
九月底(1948),九月底,notion,0,1,1,0,7,7,0.009755,4,0.266617,0.281135,0
九龙(1948),九龙,notion,0,5,5,0,12,12,0.053037,4,0.335597,0.377723,17006.45327
乡建(1948),乡建,notion,0,1,1,0,2,2,0.007515,4,0.262793,0.274313,0
乡村(1948),乡村,notion,0,10,10,0,17,17,0.084848,4,0.381274,0.422623,52590.998633
争取(1948),争取,notion,0,5,5,0,8,8,0.050232,4,0.331597,0.373231,17696.721803
事实(1948),事实,notion,0,6,6,0,8,8,0.070762,4,0.365685,0.408425,27368.365217
二三(1948),二三,notion,0,8,8,0,13,13,0.087788,4,0.402561,0.439849,52822.334612
二十一(1948),二十一,notion,0,2,2,0,3,3,0.022488,4,0.288152,0.31623,2102.825587
二十一条(1948),二十一条,notion,0,1,1,0,2,2,0.016518,4,0.278724,0.3015,0
五四(1948),五四,notion,0,6,6,0,17,17,0.062161,4,0.346717,0.389724,19024.359288
交通(1948),交通,notion,0,5,5,0,7,7,0.048747,4,0.330547,0.372033,20020.883256
京沪(1948),京沪,notion,0,4,4,0,6,6,0.05773,4,0.348389,0.391344,14070.628341
人民解放军(1948),人民解放军,notion,0,1,1,0,6,6,0.016518,4,0.278724,0.3015,0
人物(1948),人物,notion,0,6,6,0,10,10,0.075732,4,0.381235,0.422368,31625.549729
今后(1948),今后,notion,0,6,6,0,12,12,0.066011,4,0.362404,0.405331,30119.94347
介绍(1948),介绍,notion,0,6,6,0,9,9,0.05708,4,0.341609,0.384334,24958.363815
代表(1948),代表,notion,0,8,8,0,16,16,0.083858,4,0.391282,0.430898,47817.841686
份子(1948),份子,notion,0,4,4,0,5,5,0.036007,4,0.30644,0.342229,9217.177126
会战(1948),会战,notion,0,2,2,0,3,3,0.022141,4,0.285959,0.312902,1122.074528
会演(1948),会演,notion,0,1,1,0,2,2,0.009755,4,0.266617,0.281135,0
会议(1948),会议,notion,0,8,8,0,25,25,0.092518,4,0.414602,0.448866,56243.934767
会谈(1948),会谈,notion,0,3,3,0,4,4,0.042314,4,0.321357,0.361107,6944.653827
伟大(1948),伟大,notion,0,5,5,0,11,11,0.060004,4,0.350273,0.393329,20525.43449
传统(1948),传统,notion,0,4,4,0,5,5,0.045809,4,0.322876,0.362993,10303.975646
低头(1948),低头,notion,0,1,1,0,2,2,0.002332,4,0.253398,0.256677,0
何处(1948),何处,notion,0,6,6,0,8,8,0.06503,4,0.363456,0.406329,33701.967264
何香凝(1948),何香凝,notion,0,1,1,0,2,2,0.009739,4,0.265806,0.279704,0
作品(1948),作品,notion,0,2,2,0,3,3,0.026503,4,0.295799,0.327444,2668.961321
侵略(1948),侵略,notion,0,5,5,0,11,11,0.055282,4,0.341174,0.383813,18196.685288
侵略者(1948),侵略者,notion,0,1,1,0,2,2,0.01424,4,0.275514,0.296275,0
保卫(1948),保卫,notion,0,8,8,0,13,13,0.077574,4,0.377784,0.419484,41755.316044
保卫和平(1948),保卫和平,notion,0,1,1,0,4,4,0.009755,4,0.266617,0.281135,0
保护(1948),保护,notion,0,6,6,0,10,10,0.073837,4,0.370738,0.413084,27536.291112
修正(1948),修正,notion,0,5,5,0,6,6,0.05972,4,0.343577,0.386375,14526.390885
假面具(1948),假面具,notion,0,1,1,0,3,3,0.009755,4,0.266617,0.281135,0
元代(1948),元代,notion,0,1,1,0,3,3,0.007515,4,0.262793,0.274313,0
免於(1948),免於,notion,0,1,1,0,2,2,0.01424,4,0.275514,0.296275,0
党部(1948),党部,notion,0,1,1,0,2,2,0.007515,4,0.262793,0.274313,0
全体(1948),全体,notion,0,1,1,0,2,2,0.009755,4,0.266617,0.281135,0
全国(1948),全国,notion,0,4,4,0,12,12,0.054331,4,0.336107,0.378233,10345.926443
全局(1948),全局,notion,0,2,2,0,4,4,0.026269,4,0.293695,0.324415,1931.353166
全文(1948),全文,notion,0,1,1,0,3,3,0.009755,4,0.266617,0.281135,0
八闽(1948),八闽,notion,0,1,1,0,2,2,0.016752,4,0.279138,0.302165,0
公平(1948),公平,notion,0,2,2,0,3,3,0.019569,4,0.280598,0.30455,1193.220239
公开信(1948),公开信,notion,0,3,3,0,7,7,0.037828,4,0.311575,0.348895,5613.568801
公敌(1948),公敌,notion,0,1,1,0,4,4,0.016518,4,0.278724,0.3015,0
公断(1948),公断,notion,0,2,2,0,3,3,0.026972,4,0.293947,0.324781,1749.441854
公民(1948),公民,notion,0,2,2,0,3,3,0.019494,4,0.280535,0.30445,1251.270065
公约(1948),公约,notion,0,4,4,0,5,5,0.0267,4,0.28681,0.314311,4543.221812
六个月(1948),六个月,notion,0,1,1,0,2,2,0.016518,4,0.278724,0.3015,0
共和国(1948),共和国,notion,0,2,2,0,4,4,0.019494,4,0.280535,0.30445,1251.270065
关於(1948),关於,notion,0,1,1,0,3,3,0.011322,4,0.269061,0.285394,0
内战(1948),内战,notion,0,7,7,0,11,11,0.077722,4,0.373874,0.415968,31542.726866
内蒙(1948),内蒙,notion,0,1,1,0,2,2,0.016518,4,0.278724,0.3015,0
军人(1948),军人,notion,0,2,2,0,3,3,0.017736,4,0.278993,0.301988,1631.559673
军备(1948),军备,notion,0,4,4,0,5,5,0.042846,4,0.317071,0.355905,8325.495825
军警(1948),军警,notion,0,1,1,0,3,3,0.01022,4,0.267243,0.282233,0
农事(1948),农事,notion,0,1,1,0,4,4,0.004718,4,0.258401,0.266227,0
农场(1948),农场,notion,0,2,2,0,15,15,0.014472,4,0.274708,0.295,2180.550764
减低(1948),减低,notion,0,1,1,0,3,3,0.016752,4,0.279138,0.302165,0
几个(1948),几个,notion,0,7,7,0,14,14,0.088558,4,0.406482,0.442788,45482.524068
几位(1948),几位,notion,0,3,3,0,5,5,0.038508,4,0.316031,0.354552,7136.780743
刑庭(1948),刑庭,notion,0,2,2,0,3,3,0.026972,4,0.293947,0.324781,1749.441854
列宁(1948),列宁,notion,0,2,2,0,7,7,0.026272,4,0.29319,0.323683,1793.896368
初期(1948),初期,notion,0,1,1,0,2,2,0.007515,4,0.262793,0.274313,0
到处(1948),到处,notion,0,4,4,0,5,5,0.057264,4,0.347744,0.390678,14323.117856
前后(1948),前后,notion,0,9,9,0,12,12,0.075476,4,0.365614,0.408525,41844.874842
办法(1948),办法,notion,0,8,8,0,17,17,0.079231,4,0.379771,0.421214,40945.004931
功臣(1948),功臣,notion,0,1,1,0,2,2,0.007515,4,0.262793,0.274313,0
加轮(1948),加轮,notion,0,1,1,0,2,2,0.009739,4,0.265806,0.279704,0
动态(1948),动态,notion,0,1,1,0,2,2,0.008247,4,0.26379,0.27611,0
劳资(1948),劳资,notion,0,1,1,0,2,2,0.009739,4,0.265806,0.279704,0
十月革命(1948),十月革命,notion,0,3,3,0,8,8,0.036024,4,0.308631,0.345069,5629.029515
华丽(1948),华丽,notion,0,2,2,0,3,3,0.021061,4,0.283157,0.308576,1336.570675
华北大学(1948),华北大学,notion,0,1,1,0,2,2,0.016518,4,0.278724,0.3015,0
华南(1948),华南,notion,0,5,5,0,19,19,0.05936,4,0.345695,0.388604,16798.188986
单位(1948),单位,notion,0,1,1,0,3,3,0.004718,4,0.258401,0.266227,0
南朝鲜(1948),南朝鲜,notion,0,1,1,0,4,4,0.009755,4,0.266617,0.281135,0
南洋(1948),南洋,notion,0,5,5,0,7,7,0.04272,4,0.313237,0.351136,10643.552045
南美(1948),南美,notion,0,2,2,0,3,3,0.024267,4,0.290987,0.320456,2179.633602
南阳(1948),南阳,notion,0,1,1,0,3,3,0.016752,4,0.279138,0.302165,0
印尼(1948),印尼,notion,0,4,4,0,10,10,0.048413,4,0.32795,0.368983,9722.580782
危乎(1948),危乎,notion,0,1,1,0,2,2,0.009739,4,0.265806,0.279704,0
危局(1948),危局,notion,0,2,2,0,4,4,0.030992,4,0.303936,0.338757,2912.385696
危机(1948),危机,notion,0,11,11,0,22,22,0.108129,4,0.440878,0.467002,87896.246479
历代(1948),历代,notion,0,2,2,0,4,4,0.024033,4,0.291281,0.320888,2559.028705
原则性(1948),原则性,notion,0,2,2,0,4,4,0.026269,4,0.293695,0.324415,1931.353166
原子弹(1948),原子弹,notion,0,3,3,0,4,4,0.029012,4,0.297603,0.330061,4655.276517
原子武器(1948),原子武器,notion,0,1,1,0,2,2,0.009755,4,0.266617,0.281135,0
双十节(1948),双十节,notion,0,2,2,0,7,7,0.033269,4,0.305692,0.34112,2297.98609
反封建(1948),反封建,notion,0,1,1,0,3,3,0.016518,4,0.278724,0.3015,0
反抗(1948),反抗,notion,0,6,6,0,8,8,0.068002,4,0.355712,0.398842,21338.938082
发动(1948),发动,notion,0,3,3,0,4,4,0.030813,4,0.299741,0.333056,5228.901472
发生(1948),发生,notion,0,5,5,0,6,6,0.055504,4,0.33905,0.381516,15953.054997
发行(1948),发行,notion,0,7,7,0,13,13,0.071276,4,0.356929,0.400095,24100.396204
发表(1948),发表,notion,0,5,5,0,13,13,0.051707,4,0.325675,0.366376,10034.069613
变化(1948),变化,notion,0,6,6,0,12,12,0.078791,4,0.382049,0.423067,29000.417271
只有(1948),只有,notion,0,3,3,0,5,5,0.037813,4,0.309012,0.345568,4605.191573
台山(1948),台山,notion,0,1,1,0,3,3,0.009751,4,0.267186,0.282133,0
台湾(1948),台湾,notion,0,12,12,0,27,27,0.112987,4,0.44432,0.469253,93055.654027
史大林(1948),史大林,notion,0,1,1,0,5,5,0.009755,4,0.266617,0.281135,0
各地(1948),各地,notion,0,2,2,0,3,3,0.030992,4,0.303936,0.338757,2912.385696
各部(1948),各部,notion,0,1,1,0,2,2,0.007515,4,0.262793,0.274313,0
合作(1948),合作,notion,0,6,6,0,18,18,0.063217,4,0.356861,0.399973,30457.506062
吉田(1948),吉田,notion,0,2,2,0,5,5,0.033269,4,0.305692,0.34112,2297.98609
同学(1948),同学,notion,0,6,6,0,11,11,0.072859,4,0.371141,0.41345,26203.313171
同盟(1948),同盟,notion,0,4,4,0,6,6,0.046232,4,0.322682,0.36276,9721.428336
君位(1948),君位,notion,0,1,1,0,2,2,0.007515,4,0.262793,0.274313,0
周恩来(1948),周恩来,notion,0,1,1,0,2,2,0.016518,4,0.278724,0.3015,0
周鲠生(1948),周鲠生,notion,0,2,2,0,13,13,0.030758,4,0.303347,0.337959,2812.221703
响应(1948),响应,notion,0,6,6,0,9,9,0.049658,4,0.328437,0.369659,21000.005914
哭诉(1948),哭诉,notion,0,1,1,0,4,4,0.011322,4,0.269061,0.285394,0
哲学史(1948),哲学史,notion,0,1,1,0,4,4,0.009755,4,0.266617,0.281135,0
商人(1948),商人,notion,0,5,5,0,6,6,0.060043,4,0.350927,0.393995,19085.023635
啓事(1948),啓事,notion,0,1,1,0,2,2,0.011322,4,0.269061,0.285394,0
四育(1948),四育,notion,0,1,1,0,2,2,0.002332,4,0.253398,0.256677,0
困难(1948),困难,notion,0,3,3,0,5,5,0.040744,4,0.321908,0.361773,8749.552586
国大(1948),国大,notion,0,6,6,0,8,8,0.069569,4,0.357745,0.400839,21063.613657
圆明园(1948),圆明园,notion,0,1,1,0,2,2,0.007515,4,0.262793,0.274313,0
土地改革(1948),土地改革,notion,0,9,9,0,27,27,0.087474,4,0.401486,0.439072,64598.22974
在场(1948),在场,notion,0,4,4,0,6,6,0.03024,4,0.291213,0.320899,3918.810743
均势(1948),均势,notion,0,1,1,0,2,2,0.007515,4,0.262793,0.274313,0
坎拿大(1948),坎拿大,notion,0,1,1,0,2,2,0.01424,4,0.275514,0.296275,0
坚守(1948),坚守,notion,0,1,1,0,2,2,0.016518,4,0.278724,0.3015,0
垂簾(1948),垂簾,notion,0,1,1,0,2,2,0.007515,4,0.262793,0.274313,0
城市(1948),城市,notion,0,5,5,0,18,18,0.058259,4,0.34364,0.386441,16653.867721
基础(1948),基础,notion,0,7,7,0,9,9,0.065126,4,0.359456,0.402558,36060.186106
堡垒(1948),堡垒,notion,0,2,2,0,3,3,0.023992,4,0.29271,0.322985,3168.205568
增税(1948),增税,notion,0,1,1,0,2,2,0.01022,4,0.267243,0.282233,0
声援(1948),声援,notion,0,1,1,0,2,2,0.009739,4,0.265806,0.279704,0
处处(1948),处处,notion,0,1,1,0,4,4,0.016752,4,0.279138,0.302165,0
外戚(1948),外戚,notion,0,1,1,0,2,2,0.007515,4,0.262793,0.274313,0
外货(1948),外货,notion,0,1,1,0,3,3,0.016752,4,0.279138,0.302165,0
大公报(1948),大公报,notion,0,6,6,0,10,10,0.077221,4,0.38236,0.423333,31962.231844
大学(1948),大学,notion,0,9,9,0,22,22,0.093177,4,0.411829,0.446892,61322.304545
大捷(1948),大捷,notion,0,2,2,0,4,4,0.026269,4,0.293695,0.324415,1931.353166
大木(1948),大木,notion,0,1,1,0,2,2,0.01424,4,0.275514,0.296275,0
大韩民国(1948),大韩民国,notion,0,1,1,0,2,2,0.007515,4,0.262793,0.274313,0
天津(1948),天津,notion,0,5,5,0,8,8,0.044785,4,0.315129,0.353532,9467.033952
太原(1948),太原,notion,0,5,5,0,7,7,0.057552,4,0.342981,0.385742,16513.403326
太平洋(1948),太平洋,notion,0,1,1,0,2,2,0.009739,4,0.265806,0.279704,0
奥斯特(1948),奥斯特,notion,0,1,1,0,3,3,0.009755,4,0.266617,0.281135,0
奴才(1948),奴才,notion,0,2,2,0,4,4,0.026272,4,0.29319,0.323683,1793.896368
奸细(1948),奸细,notion,0,1,1,0,2,2,0.009755,4,0.266617,0.281135,0
妇女(1948),妇女,notion,0,8,8,0,15,15,0.088775,4,0.400544,0.438285,53313.795339
孔子(1948),孔子,notion,0,2,2,0,4,4,0.008698,4,0.258507,0.266483,0.569098
孙中山(1948),孙中山,notion,0,3,3,0,4,4,0.04349,4,0.321192,0.360908,6041.296212
学习(1948),学习,notion,0,6,6,0,37,37,0.067698,4,0.361602,0.404565,29684.012402
学术(1948),学术,notion,0,5,5,0,7,7,0.049429,4,0.329012,0.370269,13524.754622
学说(1948),学说,notion,0,2,2,0,4,4,0.030758,4,0.303347,0.337959,2812.221703
学运(1948),学运,notion,0,6,6,0,13,13,0.067668,4,0.36409,0.406928,26076.41711
它的(1948),它的,notion,0,1,1,0,2,2,0.01424,4,0.275514,0.296275,0
它的眞相(1948),它的眞相,notion,0,1,1,0,2,2,0.01424,4,0.275514,0.296275,0
定户(1948),定户,notion,0,1,1,0,2,2,0.011322,4,0.269061,0.285394,0
宪法(1948),宪法,notion,0,6,6,0,13,13,0.060819,4,0.34855,0.391621,25106.68806
对外(1948),对外,notion,0,4,4,0,7,7,0.039758,4,0.315765,0.354275,11265.559677
小说(1948),小说,notion,0,2,2,0,3,3,0.015144,4,0.274508,0.294667,1190.768282
尔斯(1948),尔斯,notion,0,1,1,0,2,2,0.009755,4,0.266617,0.281135,0
局面(1948),局面,notion,0,4,4,0,8,8,0.040609,4,0.313604,0.351546,8125.725709
山西(1948),山西,notion,0,4,4,0,5,5,0.058831,4,0.350012,0.393008,13975.20151
崩溃(1948),崩溃,notion,0,7,7,0,14,14,0.058456,4,0.335477,0.377701,21310.909198
崭露头角(1948),崭露头角,notion,0,1,1,0,2,2,0.007515,4,0.262793,0.274313,0
工业化(1948),工业化,notion,0,2,2,0,4,4,0.019569,4,0.280598,0.30455,1193.220239
工商(1948),工商,notion,0,3,3,0,5,5,0.036712,4,0.306816,0.342673,4458.540834
工商界(1948),工商界,notion,0,4,4,0,10,10,0.041729,4,0.3123,0.349882,6951.098406
布尔(1948),布尔,notion,0,1,1,0,2,2,0.009755,4,0.266617,0.281135,0
席上(1948),席上,notion,0,2,2,0,9,9,0.01727,4,0.278352,0.300956,1619.09855
干部(1948),干部,notion,0,2,2,0,3,3,0.017267,4,0.279595,0.302953,2297.821122
座谈会(1948),座谈会,notion,0,4,4,0,13,13,0.045449,4,0.326269,0.367019,13689.43535
建立(1948),建立,notion,0,4,4,0,9,9,0.050252,4,0.332743,0.374473,11872.212029
建议(1948),建议,notion,0,6,6,0,12,12,0.049279,4,0.326695,0.367629,22201.666279
开封(1948),开封,notion,0,7,7,0,16,16,0.058361,4,0.336017,0.3783,21174.770528
张君劢(1948),张君劢,notion,0,3,3,0,6,6,0.029285,4,0.296874,0.32903,4179.439055
张季鸾(1948),张季鸾,notion,0,1,1,0,2,2,0.007515,4,0.262793,0.274313,0
当前(1948),当前,notion,0,10,10,0,26,26,0.104973,4,0.437438,0.464717,75468.301269
形势(1948),形势,notion,0,7,7,0,22,22,0.082254,4,0.391853,0.431308,40071.965032
徐蚌(1948),徐蚌,notion,0,1,1,0,2,2,0.005389,4,0.25849,0.266394,0
忠告(1948),忠告,notion,0,4,4,0,5,5,0.050561,4,0.333778,0.375638,12170.393834
总结(1948),总结,notion,0,6,6,0,9,9,0.053294,4,0.337739,0.380141,25299.12156
恋爱(1948),恋爱,notion,0,3,3,0,5,5,0.037813,4,0.309012,0.345568,4605.191573
恩泽(1948),恩泽,notion,0,1,1,0,2,2,0.007515,4,0.262793,0.274313,0
悼词(1948),悼词,notion,0,1,1,0,2,2,0.009755,4,0.266617,0.281135,0
惨案(1948),惨案,notion,0,8,8,0,14,14,0.07446,4,0.36115,0.404244,30723.741272
意大利(1948),意大利,notion,0,2,2,0,4,4,0.015763,4,0.275232,0.295865,1348.309636
意见(1948),意见,notion,0,11,11,0,29,29,0.114041,4,0.459595,0.478548,99261.776044
感言(1948),感言,notion,0,6,6,0,11,11,0.055161,4,0.331978,0.373719,17016.255097
战事(1948),战事,notion,0,2,2,0,3,3,0.028074,4,0.296149,0.327943,1864.79583
战士(1948),战士,notion,0,4,4,0,16,16,0.050264,4,0.335687,0.377767,14103.188871
战役(1948),战役,notion,0,2,2,0,3,3,0.019084,4,0.281903,0.306613,1181.807466
战火(1948),战火,notion,0,3,3,0,4,4,0.034739,4,0.304503,0.339578,4684.566207
战略(1948),战略,notion,0,5,5,0,8,8,0.068571,4,0.364231,0.407006,20236.68906
战贩们(1948),战贩们,notion,0,1,1,0,2,2,0.009755,4,0.266617,0.281135,0
所见(1948),所见,notion,0,6,6,0,7,7,0.062573,4,0.3506,0.393718,25151.475544
手迹(1948),手迹,notion,0,2,2,0,3,3,0.008698,4,0.258507,0.266483,0.569098
托尔斯泰(1948),托尔斯泰,notion,0,1,1,0,2,2,0.004718,4,0.258401,0.266227,0
扶植(1948),扶植,notion,0,5,5,0,9,9,0.055985,4,0.341826,0.384511,17326.731667
承德(1948),承德,notion,0,1,1,0,2,2,0.008247,4,0.26379,0.27611,0
投降(1948),投降,notion,0,5,5,0,7,7,0.045422,4,0.318766,0.358057,11359.54938
抗战(1948),抗战,notion,0,5,5,0,6,6,0.055516,4,0.344333,0.387173,19427.684475
抢救(1948),抢救,notion,0,3,3,0,4,4,0.03571,4,0.312586,0.350193,8553.467019
护乡团(1948),护乡团,notion,0,1,1,0,2,2,0.009751,4,0.267186,0.282133,0
报告(1948),报告,notion,0,9,9,0,34,34,0.091805,4,0.412825,0.447624,70046.290113
报载(1948),报载,notion,0,1,1,0,2,2,0.016752,4,0.279138,0.302165,0
抨击(1948),抨击,notion,0,1,1,0,2,2,0.009739,4,0.265806,0.279704,0
拥护(1948),拥护,notion,0,2,2,0,3,3,0.01996,4,0.281333,0.305715,1305.273912
指示(1948),指示,notion,0,2,2,0,4,4,0.026269,4,0.293695,0.324415,1931.353166
揭开(1948),揭开,notion,0,3,3,0,8,8,0.035775,4,0.308859,0.345368,5091.422643
搜查(1948),搜查,notion,0,4,4,0,6,6,0.03024,4,0.291213,0.320899,3918.810743
撕破(1948),撕破,notion,0,2,2,0,3,3,0.026272,4,0.29319,0.323683,1793.896368
支援(1948),支援,notion,0,3,3,0,4,4,0.035775,4,0.308859,0.345368,5091.422643
改造(1948),改造,notion,0,8,8,0,19,19,0.072924,4,0.376233,0.41812,48287.052903
政区(1948),政区,notion,0,1,1,0,2,2,0.007515,4,0.262793,0.274313,0
政友(1948),政友,notion,0,1,1,0,2,2,0.016752,4,0.279138,0.302165,0
政委(1948),政委,notion,0,1,1,0,2,2,0.009755,4,0.266617,0.281135,0
政权(1948),政权,notion,0,6,6,0,13,13,0.069007,4,0.365045,0.407826,28337.290095
政治责任(1948),政治责任,notion,0,1,1,0,2,2,0.008247,4,0.26379,0.27611,0
故事(1948),故事,notion,0,6,6,0,23,23,0.06061,4,0.345378,0.388327,22913.810231
故都(1948),故都,notion,0,4,4,0,6,6,0.052227,4,0.341174,0.383757,16187.627914
故里(1948),故里,notion,0,1,1,0,2,2,0.016752,4,0.279138,0.302165,0
敌人(1948),敌人,notion,0,3,3,0,7,7,0.036258,4,0.311059,0.34823,6585.637217
敎育(1948),敎育,notion,0,4,4,0,11,11,0.050327,4,0.333629,0.375471,12293.324806
救兵(1948),救兵,notion,0,1,1,0,2,2,0.016518,4,0.278724,0.3015,0
救命(1948),救命,notion,0,1,1,0,2,2,0.016518,4,0.278724,0.3015,0
救济(1948),救济,notion,0,4,4,0,12,12,0.050718,4,0.333689,0.375538,11937.18042
教职员(1948),教职员,notion,0,4,4,0,6,6,0.03024,4,0.291213,0.320899,3918.810743
教育(1948),教育,notion,0,12,12,0,38,38,0.124167,4,0.487193,0.49401,120279.594281
散记(1948),散记,notion,0,2,2,0,4,4,0.026269,4,0.293695,0.324415,1931.353166
文件(1948),文件,notion,0,3,3,0,7,7,0.028601,4,0.296546,0.328564,4239.722529
文化界(1948),文化界,notion,0,2,2,0,4,4,0.026507,4,0.294224,0.325181,2012.895914
文学(1948),文学,notion,0,6,6,0,11,11,0.048625,4,0.320835,0.360642,13598.944359
文艺(1948),文艺,notion,0,5,5,0,19,19,0.054245,4,0.3378,0.380152,17725.475617
斗争(1948),斗争,notion,0,6,6,0,41,41,0.061235,4,0.346141,0.389126,22349.904659
斯拉夫(1948),斯拉夫,notion,0,1,1,0,2,2,0.009755,4,0.266617,0.281135,0
新书(1948),新书,notion,0,1,1,0,3,3,0.009755,4,0.266617,0.281135,0
新内阁(1948),新内阁,notion,0,3,3,0,5,5,0.041213,4,0.319634,0.359011,6966.552281
新宪(1948),新宪,notion,0,1,1,0,3,3,0.007515,4,0.262793,0.274313,0
新政(1948),新政,notion,0,2,2,0,4,4,0.021756,4,0.286964,0.314433,2044.761444
新政协(1948),新政协,notion,0,4,4,0,16,16,0.041507,4,0.315182,0.353543,8874.021084
新民主主义(1948),新民主主义,notion,0,2,2,0,5,5,0.026269,4,0.293695,0.324415,1931.353166
新闻事业(1948),新闻事业,notion,0,1,1,0,4,4,0.007515,4,0.262793,0.274313,0
方言(1948),方言,notion,0,3,3,0,10,10,0.037591,4,0.311575,0.348895,6094.140105
日子(1948),日子,notion,0,5,5,0,6,6,0.057778,4,0.340155,0.382714,15125.089086
时局(1948),时局,notion,0,7,7,0,13,13,0.08334,4,0.390347,0.430077,37815.078062
明十三陵(1948),明十三陵,notion,0,1,1,0,2,2,0.01424,4,0.275514,0.296275,0
是非(1948),是非,notion,0,3,3,0,6,6,0.038508,4,0.316031,0.354552,7136.780743
显露(1948),显露,notion,0,1,1,0,2,2,0.01424,4,0.275514,0.296275,0
晋绥(1948),晋绥,notion,0,1,1,0,2,2,0.016518,4,0.278724,0.3015,0
普希金(1948),普希金,notion,0,1,1,0,6,6,0.009755,4,0.266617,0.281135,0
景泰(1948),景泰,notion,0,1,1,0,2,2,0.01424,4,0.275514,0.296275,0
暑工(1948),暑工,notion,0,1,1,0,7,7,0.004718,4,0.258401,0.266227,0
暴力(1948),暴力,notion,0,1,1,0,2,2,0.002332,4,0.253398,0.256677,0
曼谷(1948),曼谷,notion,0,2,2,0,7,7,0.024765,4,0.291552,0.321288,2097.245087
最后(1948),最后,notion,0,4,4,0,9,9,0.052838,4,0.335597,0.377668,11303.281317
月刊(1948),月刊,notion,0,1,1,0,2,2,0.005389,4,0.25849,0.266394,0
有效(1948),有效,notion,0,3,3,0,5,5,0.030003,4,0.299549,0.33279,5495.896668
本社(1948),本社,notion,0,2,2,0,3,3,0.021076,4,0.284616,0.310839,1735.877057
朱总司令(1948),朱总司令,notion,0,1,1,0,3,3,0.016518,4,0.278724,0.3015,0
杂感(1948),杂感,notion,0,2,2,0,3,3,0.017736,4,0.278993,0.301988,1631.559673
杂文(1948),杂文,notion,0,2,2,0,5,5,0.019972,4,0.283949,0.309807,2243.008915
杜鲁门(1948),杜鲁门,notion,0,6,6,0,12,12,0.060595,4,0.343766,0.38663,21567.022799
条款(1948),条款,notion,0,3,3,0,5,5,0.016214,4,0.270592,0.288134,1477.557689
梁启超(1948),梁启超,notion,0,1,1,0,2,2,0.007515,4,0.262793,0.274313,0
梅园新村(1948),梅园新村,notion,0,1,1,0,2,2,0.005017,4,0.257497,0.26453,0
梅隐(1948),梅隐,notion,0,1,1,0,2,2,0.01424,4,0.275514,0.296275,0
森园(1948),森园,notion,0,1,1,0,2,2,0.01424,4,0.275514,0.296275,0
楹联(1948),楹联,notion,0,1,1,0,2,2,0.01424,4,0.275514,0.296275,0
横切面(1948),横切面,notion,0,1,1,0,2,2,0.008247,4,0.26379,0.27611,0
正当(1948),正当,notion,0,2,2,0,3,3,0.009735,4,0.265411,0.279061,1057.973644
正文(1948),正文,notion,0,1,1,0,2,2,0.008247,4,0.26379,0.27611,0
正确(1948),正确,notion,0,2,2,0,3,3,0.030758,4,0.303347,0.337959,2812.221703
武汉(1948),武汉,notion,0,6,6,0,10,10,0.066428,4,0.356556,0.399674,21283.405225
每周(1948),每周,notion,0,1,1,0,2,2,0.009739,4,0.265806,0.279704,0
毛主席(1948),毛主席,notion,0,2,2,0,5,5,0.026269,4,0.293695,0.324415,1931.353166
毛泽东(1948),毛泽东,notion,0,2,2,0,11,11,0.026269,4,0.293695,0.324415,1931.353166
民主派(1948),民主派,notion,0,2,2,0,3,3,0.026491,4,0.291937,0.321853,1403.825067
民主自由(1948),民主自由,notion,0,1,1,0,10,10,0.002332,4,0.253398,0.256677,0
民众(1948),民众,notion,0,1,1,0,3,3,0.009739,4,0.265806,0.279704,0
民族化(1948),民族化,notion,0,1,1,0,2,2,0.016518,4,0.278724,0.3015,0
水利(1948),水利,notion,0,1,1,0,4,4,0.004718,4,0.258401,0.266227,0
水灾(1948),水灾,notion,0,3,3,0,6,6,0.03649,4,0.310032,0.346899,6168.230347
江苏(1948),江苏,notion,0,2,2,0,3,3,0.018958,4,0.283863,0.309674,3113.558811
河西(1948),河西,notion,0,1,1,0,2,2,0.008247,4,0.26379,0.27611,0
沿线(1948),沿线,notion,0,1,1,0,2,2,0.01022,4,0.267243,0.282233,0
法国(1948),法国,notion,0,6,6,0,16,16,0.068002,4,0.355712,0.398842,21338.938082
法案(1948),法案,notion,0,5,5,0,9,9,0.052009,4,0.332154,0.373863,16091.46928
波兰(1948),波兰,notion,0,3,3,0,6,6,0.026094,4,0.290335,0.319546,3384.346711
济南(1948),济南,notion,0,5,5,0,11,11,0.06259,4,0.35337,0.396457,20043.328861
浙东(1948),浙东,notion,0,2,2,0,3,3,0.01996,4,0.281333,0.305715,1305.273912
浙西(1948),浙西,notion,0,1,1,0,4,4,0.016752,4,0.279138,0.302165,0
浦东(1948),浦东,notion,0,1,1,0,12,12,0.004718,4,0.258401,0.266227,0
浪漫(1948),浪漫,notion,0,1,1,0,2,2,0.007515,4,0.262793,0.274313,0
涨风(1948),涨风,notion,0,6,6,0,11,11,0.076818,4,0.378699,0.420172,28910.721112
淮海(1948),淮海,notion,0,2,2,0,3,3,0.021907,4,0.286133,0.313168,1304.9596
混合(1948),混合,notion,0,1,1,0,6,6,0.008247,4,0.26379,0.27611,0
清轩(1948),清轩,notion,0,1,1,0,2,2,0.008247,4,0.26379,0.27611,0
游行(1948),游行,notion,0,3,3,0,4,4,0.036712,4,0.306816,0.342673,4458.540834
準备(1948),準备,notion,0,3,3,0,6,6,0.036086,4,0.307922,0.344137,5210.805215
演说(1948),演说,notion,0,1,1,0,2,2,0.009739,4,0.265806,0.279704,0
潜力(1948),潜力,notion,0,1,1,0,2,2,0.01424,4,0.275514,0.296275,0
澄清(1948),澄清,notion,0,2,2,0,3,3,0.01727,4,0.278352,0.300956,1619.09855
澈底(1948),澈底,notion,0,2,2,0,6,6,0.026269,4,0.293695,0.324415,1931.353166
澳门(1948),澳门,notion,0,1,1,0,2,2,0.009751,4,0.267186,0.282133,0
灯笼(1948),灯笼,notion,0,1,1,0,2,2,0.009751,4,0.267186,0.282133,0
烽火(1948),烽火,notion,0,5,5,0,7,7,0.053289,4,0.330314,0.371767,10807.896499
爱国(1948),爱国,notion,0,2,2,0,3,3,0.021907,4,0.286133,0.313168,1304.9596
爱情(1948),爱情,notion,0,2,2,0,3,3,0.026491,4,0.291937,0.321853,1403.825067
父母(1948),父母,notion,0,1,1,0,4,4,0.011322,4,0.269061,0.285394,0
物价(1948),物价,notion,0,8,8,0,29,29,0.092428,4,0.406702,0.44301,46842.026985
特约(1948),特约,notion,0,3,3,0,12,12,0.036712,4,0.306816,0.342673,4458.540834
狂涨(1948),狂涨,notion,0,2,2,0,3,3,0.021542,4,0.284314,0.310373,1410.419447
现代化(1948),现代化,notion,0,1,1,0,2,2,0.016518,4,0.278724,0.3015,0
现实(1948),现实,notion,0,4,4,0,5,5,0.045502,4,0.327207,0.368117,13766.693597
班子(1948),班子,notion,0,1,1,0,2,2,0.016518,4,0.278724,0.3015,0
瓦尔德(1948),瓦尔德,notion,0,1,1,0,2,2,0.016518,4,0.278724,0.3015,0
甘地(1948),甘地,notion,0,4,4,0,12,12,0.033629,4,0.302346,0.336705,7204.515175
甚么(1948),甚么,notion,0,1,1,0,3,3,0.016752,4,0.279138,0.302165,0
生产(1948),生产,notion,0,8,8,0,15,15,0.065849,4,0.358941,0.402114,43598.869914
生存(1948),生存,notion,0,2,2,0,3,3,0.021469,4,0.287095,0.314632,2527.522512
生活(1948),生活,notion,0,13,13,0,42,42,0.127476,4,0.487256,0.494099,125675.151873
用人(1948),用人,notion,0,2,2,0,5,5,0.018837,4,0.280346,0.304151,1468.125238
白毛女(1948),白毛女,notion,0,2,2,0,6,6,0.026269,4,0.293695,0.324415,1931.353166
的关(1948),的关,notion,0,1,1,0,2,2,0.016518,4,0.278724,0.3015,0
皇帝(1948),皇帝,notion,0,1,1,0,2,2,0.008247,4,0.26379,0.27611,0
目前(1948),目前,notion,0,8,8,0,16,16,0.069514,4,0.360042,0.403179,36932.774596
知人(1948),知人,notion,0,1,1,0,4,4,0.007515,4,0.262793,0.274313,0
社会(1948),社会,notion,0,10,10,0,34,34,0.106641,4,0.438357,0.465316,74170.47472
神祕(1948),神祕,notion,0,2,2,0,3,3,0.025562,4,0.293259,0.323783,2167.4723
禁止(1948),禁止,notion,0,1,1,0,2,2,0.009755,4,0.266617,0.281135,0
福建(1948),福建,notion,0,3,3,0,7,7,0.04349,4,0.321192,0.360908,6041.296212
科学(1948),科学,notion,0,6,6,0,9,9,0.053297,4,0.333748,0.375715,18834.678105
科学家(1948),科学家,notion,0,2,2,0,3,3,0.033269,4,0.305692,0.34112,2297.98609
移送(1948),移送,notion,0,1,1,0,2,2,0.016752,4,0.279138,0.302165,0
立委(1948),立委,notion,0,5,5,0,6,6,0.066347,4,0.36409,0.406873,22226.750501
立法(1948),立法,notion,0,4,4,0,6,6,0.043836,4,0.31977,0.359233,9983.778727
第三(1948),第三,notion,0,2,2,0,4,4,0.021469,4,0.287095,0.314632,2527.522512
第五期(1948),第五期,notion,0,1,1,0,2,2,0.005389,4,0.25849,0.266394,0
简编(1948),简编,notion,0,1,1,0,2,2,0.01424,4,0.275514,0.296275,0
粗暴(1948),粗暴,notion,0,1,1,0,2,2,0.009751,4,0.267186,0.282133,0
粤局(1948),粤局,notion,0,1,1,0,2,2,0.009751,4,0.267186,0.282133,0
纪录(1948),纪录,notion,0,5,5,0,8,8,0.052421,4,0.3378,0.380152,19507.328446
纪念大会(1948),纪念大会,notion,0,1,1,0,2,2,0.009755,4,0.266617,0.281135,0
纪详(1948),纪详,notion,0,3,3,0,6,6,0.043009,4,0.318172,0.357214,5224.220047
纵横(1948),纵横,notion,0,2,2,0,13,13,0.014457,4,0.273688,0.293303,1733.460346
纽约(1948),纽约,notion,0,4,4,0,6,6,0.042596,4,0.314365,0.352511,7200.707066
绅士(1948),绅士,notion,0,2,2,0,3,3,0.017999,4,0.280116,0.303785,1897.286008
绅权(1948),绅权,notion,0,2,2,0,3,3,0.021542,4,0.284314,0.310373,1410.419447
经验(1948),经验,notion,0,7,7,0,22,22,0.066191,4,0.355073,0.398265,30515.207528
结婚(1948),结婚,notion,0,4,4,0,6,6,0.047568,4,0.324522,0.364956,9605.234609
统一(1948),统一,notion,0,6,6,0,11,11,0.070762,4,0.365685,0.408425,27368.365217
统治(1948),统治,notion,0,4,4,0,9,9,0.045094,4,0.32188,0.361795,10145.33633
继承(1948),继承,notion,0,1,1,0,2,2,0.007515,4,0.262793,0.274313,0
维克(1948),维克,notion,0,1,1,0,2,2,0.009755,4,0.266617,0.281135,0
编者(1948),编者,notion,0,4,4,0,39,39,0.054346,4,0.33853,0.380895,11625.791149
罗夫斯基(1948),罗夫斯基,notion,0,1,1,0,3,3,0.009755,4,0.266617,0.281135,0
罗曼罗兰(1948),罗曼罗兰,notion,0,1,1,0,2,2,0.011322,4,0.269061,0.285394,0
美女(1948),美女,notion,0,1,1,0,2,2,0.009739,4,0.265806,0.279704,0
美帝(1948),美帝,notion,0,4,4,0,19,19,0.041041,4,0.313708,0.351679,8332.554869
美术(1948),美术,notion,0,1,1,0,2,2,0.016752,4,0.279138,0.302165,0
群像(1948),群像,notion,0,2,2,0,3,3,0.019491,4,0.281819,0.30648,1649.883746
老区(1948),老区,notion,0,1,1,0,2,2,0.016518,4,0.278724,0.3015,0
考验(1948),考验,notion,0,6,6,0,10,10,0.071243,4,0.369935,0.412352,29644.049319
联合(1948),联合,notion,0,1,1,0,2,2,0.007515,4,0.262793,0.274313,0
联合国(1948),联合国,notion,0,5,5,0,9,9,0.067079,4,0.363738,0.40654,21298.186603
肃顺(1948),肃顺,notion,0,1,1,0,2,2,0.007515,4,0.262793,0.274313,0
胜利(1948),胜利,notion,0,9,9,0,41,41,0.10061,4,0.426802,0.45754,64221.782579
胡适(1948),胡适,notion,0,8,8,0,27,27,0.089213,4,0.400202,0.438019,44710.96783
能否(1948),能否,notion,0,2,2,0,7,7,0.019569,4,0.280598,0.30455,1193.220239
自传(1948),自传,notion,0,2,2,0,3,3,0.019569,4,0.280598,0.30455,1193.220239
自己(1948),自己,notion,0,8,8,0,18,18,0.090186,4,0.411153,0.446337,58810.799612
自由主义(1948),自由主义,notion,0,14,14,0,44,44,0.130108,4,0.484428,0.492657,122451.814544
自行(1948),自行,notion,0,2,2,0,3,3,0.033269,4,0.305692,0.34112,2297.98609
致敬(1948),致敬,notion,0,2,2,0,3,3,0.026257,4,0.292073,0.322053,1522.40889
艺术(1948),艺术,notion,0,7,7,0,17,17,0.088077,4,0.402648,0.43986,43088.991383
艺术剧院(1948),艺术剧院,notion,0,1,1,0,4,4,0.009755,4,0.266617,0.281135,0
苏俄(1948),苏俄,notion,0,2,2,0,3,3,0.021756,4,0.286964,0.314433,2044.761444
苏皖(1948),苏皖,notion,0,1,1,0,2,2,0.01022,4,0.267243,0.282233,0
范文澜(1948),范文澜,notion,0,1,1,0,2,2,0.01424,4,0.275514,0.296275,0
范登堡(1948),范登堡,notion,0,1,1,0,2,2,0.009755,4,0.266617,0.281135,0
荷泽(1948),荷泽,notion,0,1,1,0,2,2,0.011322,4,0.269061,0.285394,0
莫斯科(1948),莫斯科,notion,0,5,5,0,12,12,0.067485,4,0.365436,0.408137,22225.863541
莫洛托夫(1948),莫洛托夫,notion,0,1,1,0,2,2,0.009755,4,0.266617,0.281135,0
落水(1948),落水,notion,0,1,1,0,2,2,0.016752,4,0.279138,0.302165,0
蒋主席(1948),蒋主席,notion,0,1,1,0,5,5,0.01424,4,0.275514,0.296275,0
蒋区(1948),蒋区,notion,0,1,1,0,3,3,0.016518,4,0.278724,0.3015,0
蒙古(1948),蒙古,notion,0,3,3,0,4,4,0.033731,4,0.307318,0.343338,6816.772232
蒙特(1948),蒙特,notion,0,2,2,0,4,4,0.026507,4,0.294224,0.325181,2012.895914
蚌埠(1948),蚌埠,notion,0,1,1,0,2,2,0.016752,4,0.279138,0.302165,0
行动(1948),行动,notion,0,7,7,0,12,12,0.074835,4,0.37302,0.415203,35206.401938
衡阳(1948),衡阳,notion,0,3,3,0,5,5,0.035775,4,0.308859,0.345368,5091.422643
补充(1948),补充,notion,0,1,1,0,2,2,0.008247,4,0.26379,0.27611,0
被困(1948),被困,notion,0,1,1,0,2,2,0.005017,4,0.257497,0.26453,0
裁减(1948),裁减,notion,0,1,1,0,2,2,0.009755,4,0.266617,0.281135,0
西班牙(1948),西班牙,notion,0,2,2,0,8,8,0.026507,4,0.294224,0.325181,2012.895914
要义(1948),要义,notion,0,1,1,0,2,2,0.007515,4,0.262793,0.274313,0
见闻(1948),见闻,notion,0,3,3,0,7,7,0.039005,4,0.316377,0.354985,7012.292377
观后(1948),观后,notion,0,1,1,0,5,5,0.009751,4,0.267186,0.282133,0
观察(1948),观察,notion,0,3,3,0,24,24,0.042314,4,0.321357,0.361107,6944.653827
观感(1948),观感,notion,0,4,4,0,6,6,0.042846,4,0.317071,0.355905,8325.495825
规则(1948),规则,notion,0,1,1,0,3,3,0.009739,4,0.265806,0.279704,0
视察(1948),视察,notion,0,3,3,0,4,4,0.037813,4,0.309012,0.345568,4605.191573
解放运动(1948),解放运动,notion,0,4,4,0,5,5,0.046232,4,0.322682,0.36276,9721.428336
警宪(1948),警宪,notion,0,4,4,0,9,9,0.03024,4,0.291213,0.320899,3918.810743
警政(1948),警政,notion,0,1,1,0,2,2,0.007515,4,0.262793,0.274313,0
记录(1948),记录,notion,0,2,2,0,4,4,0.021469,4,0.287095,0.314632,2527.522512
讲话(1948),讲话,notion,0,3,3,0,6,6,0.043021,4,0.321604,0.361407,6898.300577
许昌(1948),许昌,notion,0,1,1,0,2,2,0.009739,4,0.265806,0.279704,0
许曼(1948),许曼,notion,0,1,1,0,2,2,0.009755,4,0.266617,0.281135,0
论争(1948),论争,notion,0,3,3,0,4,4,0.033785,4,0.306666,0.342473,6788.202993
评价(1948),评价,notion,0,1,1,0,2,2,0.01424,4,0.275514,0.296275,0
试炼(1948),试炼,notion,0,1,1,0,2,2,0.016752,4,0.279138,0.302165,0
诗二首(1948),诗二首,notion,0,1,1,0,2,2,0.016752,4,0.279138,0.302165,0
诗话(1948),诗话,notion,0,1,1,0,2,2,0.01424,4,0.275514,0.296275,0
诛戮(1948),诛戮,notion,0,1,1,0,2,2,0.007515,4,0.262793,0.274313,0
话旧(1948),话旧,notion,0,1,1,0,2,2,0.01424,4,0.275514,0.296275,0
详记(1948),详记,notion,0,2,2,0,8,8,0.028074,4,0.296149,0.327943,1864.79583
说话(1948),说话,notion,0,6,6,0,8,8,0.048242,4,0.318983,0.358379,14858.360546
请愿(1948),请愿,notion,0,5,5,0,7,7,0.064551,4,0.35221,0.395293,16804.929923
读者(1948),读者,notion,0,8,8,0,52,52,0.078519,4,0.373949,0.41609,37118.124871
调配(1948),调配,notion,0,1,1,0,2,2,0.004718,4,0.258401,0.266227,0
财阀(1948),财阀,notion,0,3,3,0,4,4,0.040747,4,0.319852,0.359277,7419.013695
贫穷(1948),贫穷,notion,0,3,3,0,4,4,0.021901,4,0.2832,0.308698,2756.052926
资产阶级(1948),资产阶级,notion,0,3,3,0,5,5,0.036012,4,0.306365,0.342074,4567.575323
资料(1948),资料,notion,0,2,2,0,4,4,0.018958,4,0.283863,0.309674,3113.558811
资本主义(1948),资本主义,notion,0,5,5,0,12,12,0.05935,4,0.349881,0.39293,20614.553342
赞扬(1948),赞扬,notion,0,2,2,0,3,3,0.019491,4,0.281819,0.30648,1649.883746
赫坦(1948),赫坦,notion,0,1,1,0,2,2,0.009755,4,0.266617,0.281135,0
走向(1948),走向,notion,0,5,5,0,12,12,0.061023,4,0.351387,0.394461,20189.93049
起义(1948),起义,notion,0,2,2,0,4,4,0.026269,4,0.293695,0.324415,1931.353166
越南(1948),越南,notion,0,6,6,0,13,13,0.065021,4,0.355948,0.399075,25274.192356
路线(1948),路线,notion,0,6,6,0,8,8,0.069817,4,0.368483,0.411021,27189.909824
车辆(1948),车辆,notion,0,1,1,0,2,2,0.004718,4,0.258401,0.266227,0
辅导(1948),辅导,notion,0,1,1,0,2,2,0.004718,4,0.258401,0.266227,0
辩论(1948),辩论,notion,0,3,3,0,21,21,0.033809,4,0.305096,0.340377,5463.518126
边疆(1948),边疆,notion,0,2,2,0,3,3,0.025562,4,0.293259,0.323783,2167.4723
迈进(1948),迈进,notion,0,4,4,0,5,5,0.036079,4,0.311471,0.348818,10639.359473
这样(1948),这样,notion,0,4,4,0,8,8,0.043524,4,0.320425,0.360032,11299.35856
进口税(1948),进口税,notion,0,1,1,0,3,3,0.016752,4,0.279138,0.302165,0
进步(1948),进步,notion,0,10,10,0,17,17,0.096345,4,0.421581,0.453969,79798.415783
迫害(1948),迫害,notion,0,7,7,0,15,15,0.077828,4,0.376913,0.418663,34660.412067
选举(1948),选举,notion,0,6,6,0,12,12,0.069323,4,0.364974,0.40776,27827.989375
选择(1948),选择,notion,0,2,2,0,9,9,0.018002,4,0.27945,0.30272,1656.832374
途径(1948),途径,notion,0,4,4,0,6,6,0.050561,4,0.333778,0.375638,12170.393834
逸事(1948),逸事,notion,0,1,1,0,2,2,0.016752,4,0.279138,0.302165,0
道德(1948),道德,notion,0,5,5,0,8,8,0.036407,4,0.303838,0.338791,9632.569635
道路(1948),道路,notion,0,9,9,0,23,23,0.089442,4,0.399947,0.437874,57937.41576
那些(1948),那些,notion,0,1,1,0,2,2,0.016518,4,0.278724,0.3015,0
部署(1948),部署,notion,0,4,4,0,5,5,0.054812,4,0.338622,0.380995,11236.851379
重庆(1948),重庆,notion,0,7,7,0,19,19,0.080314,4,0.380964,0.42219,35514.745134
金圆券(1948),金圆券,notion,0,5,5,0,16,16,0.063059,4,0.351946,0.395026,18070.099844
铁民纯青(1948),铁民纯青,notion,0,1,1,0,2,2,0.016752,4,0.279138,0.302165,0
镇定(1948),镇定,notion,0,1,1,0,2,2,0.016752,4,0.279138,0.302165,0
闺怨(1948),闺怨,notion,0,2,2,0,3,3,0.026972,4,0.293947,0.324781,1749.441854
防共(1948),防共,notion,0,1,1,0,2,2,0.01424,4,0.275514,0.296275,0
阳春(1948),阳春,notion,0,2,2,0,3,3,0.021073,4,0.285785,0.312636,2242.44705
阵营(1948),阵营,notion,0,1,1,0,2,2,0.009755,4,0.266617,0.281135,0
陶行知(1948),陶行知,notion,0,2,2,0,3,3,0.021535,4,0.28397,0.309841,889.229879
随想录(1948),随想录,notion,0,1,1,0,2,2,0.009739,4,0.265806,0.279704,0
雕像(1948),雕像,notion,0,1,1,0,3,3,0.009755,4,0.266617,0.281135,0
面临(1948),面临,notion,0,7,7,0,13,13,0.075538,4,0.371544,0.413872,32364.004645
革命(1948),革命,notion,0,11,11,0,21,21,0.109328,4,0.437285,0.464672,77384.552873
革新(1948),革新,notion,0,4,4,0,7,7,0.05773,4,0.348389,0.391344,14070.628341
音乐(1948),音乐,notion,0,3,3,0,6,6,0.036493,4,0.309342,0.346,5642.475469
预约(1948),预约,notion,0,1,1,0,2,2,0.011322,4,0.269061,0.285394,0
领袖(1948),领袖,notion,0,5,5,0,11,11,0.053748,4,0.335597,0.377723,16869.978196
风潮(1948),风潮,notion,0,4,4,0,5,5,0.053229,4,0.334223,0.376137,10272.804081
饥饿(1948),饥饿,notion,0,7,7,0,12,12,0.071883,4,0.361915,0.40492,27234.854141
马来亚(1948),马来亚,notion,0,5,5,0,7,7,0.044944,4,0.314181,0.352334,9320.649425
马歇尔(1948),马歇尔,notion,0,5,5,0,16,16,0.05935,4,0.349881,0.39293,20614.553342
高夫(1948),高夫,notion,0,1,1,0,2,2,0.009755,4,0.266617,0.281135,0
高特(1948),高特,notion,0,1,1,0,2,2,0.016518,4,0.278724,0.3015,0
魂灵(1948),魂灵,notion,0,1,1,0,2,2,0.009751,4,0.267186,0.282133,0
鸦片战争(1948),鸦片战争,notion,0,1,1,0,3,3,0.007515,4,0.262793,0.274313,0
黄远(1948),黄远,notion,0,1,1,0,2,2,0.007515,4,0.262793,0.274313,0
齐之以(1948),齐之以,notion,0,1,1,0,2,2,0.01022,4,0.267243,0.282233,0
11(1948),11,notion,0,1,1,0,1,1,0.009751,4,0.267186,0.282133,0
14(1948),14,notion,0,1,1,0,1,1,0.009751,4,0.267186,0.282133,0
15(1948),15,notion,0,1,1,0,1,1,0.009751,4,0.267186,0.282133,0
1792-1822(1948),1792-1822,notion,0,1,1,0,1,1,0.007515,4,0.262793,0.274313,0
1945(1948),1945,notion,0,2,2,0,2,2,0.008698,4,0.258507,0.266483,0.569098
1948.(1948),1948.,notion,0,1,1,0,1,1,0.005389,4,0.25849,0.266394,0
230(1948),230,notion,0,2,2,0,2,2,0.008698,4,0.258507,0.266483,0.569098
357(1948),357,notion,0,1,1,0,1,1,0.005389,4,0.25849,0.266394,0
Aifred(1948),Aifred,notion,0,1,1,0,1,1,0.008247,4,0.26379,0.27611,0
An(1948),An,notion,0,2,2,0,2,2,0.008698,4,0.258507,0.266483,0.569098
Association(1948),Association,notion,0,1,1,0,1,1,0.005389,4,0.25849,0.266394,0
Barker(1948),Barker,notion,0,1,1,0,1,1,0.011322,4,0.269061,0.285394,0
BeatriceWebb(1948),BeatriceWebb,notion,0,1,1,0,1,1,0.011322,4,0.269061,0.285394,0
Bentham(1948),Bentham,notion,0,1,1,0,1,1,0.008247,4,0.26379,0.27611,0
Berdyaev(1948),Berdyaev,notion,0,1,1,0,1,1,0.011322,4,0.269061,0.285394,0
Bill(1948),Bill,notion,0,2,2,0,2,2,0.008698,4,0.258507,0.266483,0.569098
CC(1948),CC,notion,0,1,1,0,1,1,0.016518,4,0.278724,0.3015,0
Carlo(1948),Carlo,notion,0,1,1,0,1,1,0.011322,4,0.269061,0.285394,0
Columbia(1948),Columbia,notion,0,2,2,0,2,2,0.008698,4,0.258507,0.266483,0.569098
Corwin(1948),Corwin,notion,0,1,1,0,1,1,0.008247,4,0.26379,0.27611,0
Count(1948),Count,notion,0,1,1,0,1,1,0.011322,4,0.269061,0.285394,0
Dorothy(1948),Dorothy,notion,0,1,1,0,1,1,0.011322,4,0.269061,0.285394,0
Edited(1948),Edited,notion,0,1,1,0,1,1,0.005389,4,0.25849,0.266394,0
Edward(1948),Edward,notion,0,1,1,0,1,1,0.008247,4,0.26379,0.27611,0
Ernest(1948),Ernest,notion,0,1,1,0,1,1,0.011322,4,0.269061,0.285394,0
Fellow(1948),Fellow,notion,0,1,1,0,1,1,0.011322,4,0.269061,0.285394,0
Freternity(1948),Freternity,notion,0,1,1,0,1,1,0.01424,4,0.275514,0.296275,0
General(1948),General,notion,0,1,1,0,1,1,0.005389,4,0.25849,0.266394,0
Harrod(1948),Harrod,notion,0,1,1,0,1,1,0.008247,4,0.26379,0.27611,0
Ine(1948),Ine,notion,0,1,1,0,1,1,0.005389,4,0.25849,0.266394,0
International(1948),International,notion,0,2,2,0,2,2,0.008698,4,0.258507,0.266483,0.569098
Jeremy(1948),Jeremy,notion,0,1,1,0,1,1,0.008247,4,0.26379,0.27611,0
Jones(1948),Jones,notion,0,1,1,0,1,1,0.011322,4,0.269061,0.285394,0
Joseph(1948),Joseph,notion,0,1,1,0,1,1,0.005389,4,0.25849,0.266394,0
Knopf(1948),Knopf,notion,0,1,1,0,1,1,0.008247,4,0.26379,0.27611,0
Lauterpacht(1948),Lauterpacht,notion,0,2,2,0,2,2,0.008698,4,0.258507,0.266483,0.569098
Liberal(1948),Liberal,notion,0,1,1,0,1,1,0.011322,4,0.269061,0.285394,0
Liberhsm(1948),Liberhsm,notion,0,1,1,0,1,1,0.011322,4,0.269061,0.285394,0
Man(1948),Man,notion,0,2,2,0,2,2,0.008698,4,0.258507,0.266483,0.569098
New(1948),New,notion,0,2,2,0,2,2,0.008698,4,0.258507,0.266483,0.569098
Nlcolai(1948),Nlcolai,notion,0,1,1,0,1,1,0.011322,4,0.269061,0.285394,0
Pandora(1948),Pandora,notion,0,1,1,0,1,1,0.008247,4,0.26379,0.27611,0
Papers(1948),Papers,notion,0,1,1,0,1,1,0.005389,4,0.25849,0.266394,0
Pickles(1948),Pickles,notion,0,1,1,0,1,1,0.011322,4,0.269061,0.285394,0
Pigou(1948),Pigou,notion,0,1,1,0,1,1,0.011322,4,0.269061,0.285394,0
Press(1948),Press,notion,0,2,2,0,2,2,0.008698,4,0.258507,0.266483,0.569098
Rights(1948),Rights,notion,0,2,2,0,2,2,0.008698,4,0.258507,0.266483,0.569098
Roper(1948),Roper,notion,0,1,1,0,1,1,0.011322,4,0.269061,0.285394,0
Sforza(1948),Sforza,notion,0,1,1,0,1,1,0.011322,4,0.269061,0.285394,0
Sir(1948),Sir,notion,0,1,1,0,1,1,0.011322,4,0.269061,0.285394,0
Sloane(1948),Sloane,notion,0,1,1,0,1,1,0.005389,4,0.25849,0.266394,0
T.V.宋(1948),T.V.宋,notion,0,3,3,0,3,3,0.018438,4,0.273429,0.292926,1298.292089
TV(1948),TV,notion,0,2,2,0,2,2,0.021073,4,0.285785,0.312636,2242.44705
The(1948),The,notion,0,2,2,0,3,3,0.008698,4,0.258507,0.266483,0.569098
Theodore(1948),Theodore,notion,0,1,1,0,1,1,0.005389,4,0.25849,0.266394,0
Tom(1948),Tom,notion,0,1,1,0,1,1,0.011322,4,0.269061,0.285394,0
Traveller(1948),Traveller,notion,0,1,1,0,1,1,0.011322,4,0.269061,0.285394,0
Trover(1948),Trover,notion,0,1,1,0,1,1,0.011322,4,0.269061,0.285394,0
University(1948),University,notion,0,2,2,0,2,2,0.008698,4,0.258507,0.266483,0.569098
Visolang(1948),Visolang,notion,0,1,1,0,1,1,0.007515,4,0.262793,0.274313,0
White(1948),White,notion,0,1,1,0,1,1,0.005389,4,0.25849,0.266394,0
Willisam(1948),Willisam,notion,0,1,1,0,1,1,0.005389,4,0.25849,0.266394,0
Wishful(1948),Wishful,notion,0,1,1,0,1,1,0.016752,4,0.279138,0.302165,0
York(1948),York,notion,0,2,2,0,2,2,0.008698,4,0.258507,0.266483,0.569098
and(1948),and,notion,0,1,1,0,1,1,0.005389,4,0.25849,0.266394,0
aranged(1948),aranged,notion,0,1,1,0,1,1,0.005389,4,0.25849,0.266394,0
pp(1948),pp,notion,0,2,2,0,2,2,0.008698,4,0.258507,0.266483,0.569098
thinking(1948),thinking,notion,0,1,1,0,1,1,0.016752,4,0.279138,0.302165,0
xvi(1948),xvi,notion,0,1,1,0,1,1,0.005389,4,0.25849,0.266394,0
一一(1948),一一,notion,0,3,3,0,3,3,0.034022,4,0.306041,0.341641,5811.628066
一七(1948),一七,notion,0,1,1,0,1,1,0.007515,4,0.262793,0.274313,0
一三(1948),一三,notion,0,1,1,0,1,1,0.007515,4,0.262793,0.274313,0
一丘之貉(1948),一丘之貉,notion,0,2,2,0,2,2,0.027839,4,0.295962,0.327676,1920.33989
一个月(1948),一个月,notion,0,1,1,0,1,1,0.009751,4,0.267186,0.282133,0
一串(1948),一串,notion,0,1,1,0,1,1,0.01022,4,0.267243,0.282233,0
一九(1948),一九,notion,0,1,1,0,1,1,0.007515,4,0.262793,0.274313,0
一九三七年(1948),一九三七年,notion,0,1,1,0,1,1,0.007515,4,0.262793,0.274313,0
一九四八(1948),一九四八,notion,0,2,2,0,2,2,0.018837,4,0.280346,0.304151,1468.125238
一二(1948),一二,notion,0,3,3,0,3,3,0.040785,4,0.318577,0.357713,7036.648398
一二一(1948),一二一,notion,0,1,1,0,2,2,0.005389,4,0.25849,0.266394,0
一二九(1948),一二九,notion,0,1,1,0,1,1,0.009739,4,0.265806,0.279704,0
一五(1948),一五,notion,0,1,1,0,1,1,0.007515,4,0.262793,0.274313,0
一些(1948),一些,notion,0,3,3,0,5,5,0.024224,4,0.290785,0.320212,6049.872842
一仍旧贯(1948),一仍旧贯,notion,0,1,1,0,1,1,0.016752,4,0.279138,0.302165,0
一令(1948),一令,notion,0,1,1,0,1,1,0.009739,4,0.265806,0.279704,0
一件(1948),一件,notion,0,1,1,0,1,1,0.008247,4,0.26379,0.27611,0
一位(1948),一位,notion,0,2,2,0,4,4,0.025562,4,0.293259,0.323783,2167.4723
一例(1948),一例,notion,0,2,2,0,3,3,0.016039,4,0.2771,0.298926,2122.22906
一元化(1948),一元化,notion,0,1,1,0,1,1,0.008247,4,0.26379,0.27611,0
一八(1948),一八,notion,0,4,4,0,5,5,0.030924,4,0.298194,0.330949,7012.895726
一六(1948),一六,notion,0,1,1,0,1,1,0.007515,4,0.262793,0.274313,0
一册(1948),一册,notion,0,1,1,0,1,1,0.01424,4,0.275514,0.296275,0
一切(1948),一切,notion,0,2,2,0,2,2,0.027839,4,0.295962,0.327676,1920.33989
一副(1948),一副,notion,0,1,1,0,1,1,0.008247,4,0.26379,0.27611,0
一卷(1948),一卷,notion,0,1,1,0,1,1,0.008247,4,0.26379,0.27611,0
一只(1948),一只,notion,0,1,1,0,1,1,0.009751,4,0.267186,0.282133,0
一叶知秋(1948),一叶知秋,notion,0,1,1,0,1,1,0.016752,4,0.279138,0.302165,0
一周年(1948),一周年,notion,0,4,4,0,4,4,0.041275,4,0.316483,0.355173,9463.390064
一四(1948),一四,notion,0,1,1,0,1,1,0.007515,4,0.262793,0.274313,0
一场(1948),一场,notion,0,2,2,0,2,2,0.021542,4,0.284314,0.310373,1410.419447
一堆(1948),一堆,notion,0,1,1,0,1,1,0.016518,4,0.278724,0.3015,0
一声(1948),一声,notion,0,1,1,0,1,1,0.009739,4,0.265806,0.279704,0
一夕(1948),一夕,notion,0,1,1,0,1,1,0.016518,4,0.278724,0.3015,0
一多兄(1948),一多兄,notion,0,2,2,0,2,2,0.008698,4,0.258507,0.266483,0.569098
一夫一妻制(1948),一夫一妻制,notion,0,1,1,0,1,1,0.008247,4,0.26379,0.27611,0
一定(1948),一定,notion,0,2,2,0,4,4,0.026269,4,0.293695,0.324415,1931.353166
一家(1948),一家,notion,0,2,2,0,2,2,0.026269,4,0.293695,0.324415,1931.353166
一封(1948),一封,notion,0,2,2,0,2,2,0.028074,4,0.296149,0.327943,1864.79583
一封信(1948),一封信,notion,0,6,6,0,6,6,0.074997,4,0.382283,0.423266,34794.961859
一带(1948),一带,notion,0,2,2,0,2,2,0.01996,4,0.281333,0.305715,1305.273912
一席谈(1948),一席谈,notion,0,3,3,0,3,3,0.036321,4,0.307771,0.343937,4987.71025
一幅(1948),一幅,notion,0,2,2,0,2,2,0.024999,4,0.291484,0.321188,1929.694181
一幕(1948),一幕,notion,0,4,4,0,8,8,0.048046,4,0.328926,0.370114,12179.074418
一年(1948),一年,notion,0,10,10,0,24,24,0.09227,4,0.396569,0.435268,59007.504918
一年一度(1948),一年一度,notion,0,1,1,0,1,1,0.004718,4,0.258401,0.266227,0
一座(1948),一座,notion,0,1,1,0,1,1,0.016752,4,0.279138,0.302165,0
一张(1948),一张,notion,0,3,3,0,4,4,0.04349,4,0.321192,0.360908,6041.296212
一役(1948),一役,notion,0,1,1,0,1,1,0.01022,4,0.267243,0.282233,0
一律(1948),一律,notion,0,2,2,0,2,2,0.026491,4,0.291937,0.321853,1403.825067
一战(1948),一战,notion,0,1,1,0,1,1,0.01424,4,0.275514,0.296275,0
一所(1948),一所,notion,0,1,1,0,1,1,0.004718,4,0.258401,0.266227,0
一批(1948),一批,notion,0,2,2,0,2,2,0.019569,4,0.280598,0.30455,1193.220239
一按(1948),一按,notion,0,1,1,0,1,1,0.016518,4,0.278724,0.3015,0
一支(1948),一支,notion,0,1,1,0,1,1,0.009751,4,0.267186,0.282133,0
一文(1948),一文,notion,0,4,4,0,5,5,0.052838,4,0.335597,0.377668,11303.281317
一新(1948),一新,notion,0,2,2,0,2,2,0.030992,4,0.303936,0.338757,2912.385696
一朝天子一朝臣(1948),一朝天子一朝臣,notion,0,1,1,0,1,1,0.005017,4,0.257497,0.26453,0
一本(1948),一本,notion,0,1,1,0,1,1,0.009751,4,0.267186,0.282133,0
一束(1948),一束,notion,0,2,2,0,2,2,0.026507,4,0.294224,0.325181,2012.895914
一条(1948),一条,notion,0,5,5,0,6,6,0.064082,4,0.353836,0.396923,18838.571726
一来(1948),一来,notion,0,1,1,0,1,1,0.016518,4,0.278724,0.3015,0
一案(1948),一案,notion,0,1,1,0,1,1,0.01022,4,0.267243,0.282233,0
一棵(1948),一棵,notion,0,1,1,0,1,1,0.007515,4,0.262793,0.274313,0
一次(1948),一次,notion,0,4,4,0,5,5,0.031724,4,0.301788,0.33594,10664.139827
一死(1948),一死,notion,0,1,1,0,1,1,0.009751,4,0.267186,0.282133,0
一段(1948),一段,notion,0,2,2,0,2,2,0.024999,4,0.291484,0.321188,1929.694181
一江春水向东流(1948),一江春水向东流,notion,0,1,1,0,2,2,0.009751,4,0.267186,0.282133,0
一波(1948),一波,notion,0,1,1,0,1,1,0.01424,4,0.275514,0.296275,0
一片(1948),一片,notion,0,4,4,0,4,4,0.039756,4,0.310185,0.347154,7364.3964
一玩(1948),一玩,notion,0,1,1,0,1,1,0.004718,4,0.258401,0.266227,0
一生(1948),一生,notion,0,1,1,0,1,1,0.009739,4,0.265806,0.279704,0
一百二十五(1948),一百二十五,notion,0,1,1,0,1,1,0.009755,4,0.266617,0.281135,0
一百名(1948),一百名,notion,0,1,1,0,1,1,0.01022,4,0.267243,0.282233,0
一百年(1948),一百年,notion,0,2,2,0,2,2,0.027839,4,0.295962,0.327676,1920.33989
一百週年(1948),一百週年,notion,0,1,1,0,1,1,0.016518,4,0.278724,0.3015,0
一直(1948),一直,notion,0,1,1,0,1,1,0.016518,4,0.278724,0.3015,0
一瞥(1948),一瞥,notion,0,3,3,0,4,4,0.036246,4,0.306866,0.342739,4667.991046
一票(1948),一票,notion,0,1,1,0,1,1,0.01424,4,0.275514,0.296275,0
一章(1948),一章,notion,0,2,2,0,2,2,0.026272,4,0.29319,0.323683,1793.896368
一笔(1948),一笔,notion,0,2,2,0,3,3,0.027839,4,0.295962,0.327676,1920.33989
一篇(1948),一篇,notion,0,3,3,0,3,3,0.024958,4,0.287403,0.315154,2845.214899
一统(1948),一统,notion,0,1,1,0,1,1,0.009755,4,0.266617,0.281135,0
一羣(1948),一羣,notion,0,1,1,0,1,1,0.01424,4,0.275514,0.296275,0
一群(1948),一群,notion,0,3,3,0,4,4,0.036724,4,0.31142,0.348696,6661.412091
一致(1948),一致,notion,0,4,4,0,5,5,0.040964,4,0.315341,0.353742,11109.524669
一般(1948),一般,notion,0,1,1,0,1,1,0.016752,4,0.279138,0.302165,0
一艘(1948),一艘,notion,0,1,1,0,1,1,0.005389,4,0.25849,0.266394,0
一行(1948),一行,notion,0,2,2,0,2,2,0.030992,4,0.303936,0.338757,2912.385696
一袋(1948),一袋,notion,0,1,1,0,1,1,0.009751,4,0.267186,0.282133,0
一览(1948),一览,notion,0,1,1,0,1,1,0.009755,4,0.266617,0.281135,0
一角(1948),一角,notion,0,2,2,0,4,4,0.028074,4,0.296149,0.327943,1864.79583
一解(1948),一解,notion,0,1,1,0,1,1,0.009739,4,0.265806,0.279704,0
一语(1948),一语,notion,0,1,1,0,1,1,0.016752,4,0.279138,0.302165,0
一贯(1948),一贯,notion,0,1,1,0,1,1,0.01424,4,0.275514,0.296275,0
一起(1948),一起,notion,0,2,2,0,2,2,0.026491,4,0.291937,0.321853,1403.825067
一路(1948),一路,notion,0,1,1,0,1,1,0.016518,4,0.278724,0.3015,0
一连(1948),一连,notion,0,2,2,0,2,2,0.027839,4,0.295962,0.327676,1920.33989
一连串(1948),一连串,notion,0,1,1,0,1,1,0.011322,4,0.269061,0.285394,0
一週年(1948),一週年,notion,0,1,1,0,2,2,0.016518,4,0.278724,0.3015,0
一部(1948),一部,notion,0,1,1,0,1,1,0.009739,4,0.265806,0.279704,0
一阵(1948),一阵,notion,0,1,1,0,1,1,0.016752,4,0.279138,0.302165,0
一面(1948),一面,notion,0,1,1,0,1,1,0.016752,4,0.279138,0.302165,0
一页(1948),一页,notion,0,2,2,0,2,2,0.019084,4,0.281903,0.306613,1181.807466
一顶(1948),一顶,notion,0,1,1,0,1,1,0.016518,4,0.278724,0.3015,0
一颗(1948),一颗,notion,0,3,3,0,4,4,0.035313,4,0.311059,0.34823,7578.124919
一首(1948),一首,notion,0,2,2,0,2,2,0.027839,4,0.295962,0.327676,1920.33989
丁文渊(1948),丁文渊,notion,0,1,1,0,1,1,0.009739,4,0.265806,0.279704,0
七一(1948),七一,notion,0,1,1,0,1,1,0.016518,4,0.278724,0.3015,0
七一五(1948),七一五,notion,0,1,1,0,1,1,0.01022,4,0.267243,0.282233,0
七七(1948),七七,notion,0,2,2,0,3,3,0.026972,4,0.293947,0.324781,1749.441854
七七事变(1948),七七事变,notion,0,1,1,0,1,1,0.01022,4,0.267243,0.282233,0
七个(1948),七个,notion,0,1,1,0,1,1,0.011322,4,0.269061,0.285394,0
七分(1948),七分,notion,0,2,2,0,2,2,0.021542,4,0.284314,0.310373,1410.419447
七十(1948),七十,notion,0,2,2,0,2,2,0.026272,4,0.29319,0.323683,1793.896368
七十五万(1948),七十五万,notion,0,1,1,0,1,1,0.016518,4,0.278724,0.3015,0
七号(1948),七号,notion,0,2,2,0,2,2,0.021073,4,0.285785,0.312636,2242.44705
七年(1948),七年,notion,0,1,1,0,1,1,0.009739,4,0.265806,0.279704,0
七角(1948),七角,notion,0,2,2,0,2,2,0.008698,4,0.258507,0.266483,0.569098
万万(1948),万万,notion,0,1,1,0,1,1,0.011322,4,0.269061,0.285394,0
万世开(1948),万世开,notion,0,1,1,0,1,1,0.009739,4,0.265806,0.279704,0
万千(1948),万千,notion,0,1,1,0,1,1,0.009751,4,0.267186,0.282133,0
万县(1948),万县,notion,0,1,1,0,1,1,0.016518,4,0.278724,0.3015,0
万家灯火(1948),万家灯火,notion,0,2,2,0,2,2,0.026503,4,0.295799,0.327444,2668.961321
万方(1948),万方,notion,0,2,2,0,3,3,0.01058,4,0.266674,0.28129,814.96844
万生(1948),万生,notion,0,1,1,0,1,1,0.009751,4,0.267186,0.282133,0
万里(1948),万里,notion,0,2,2,0,2,2,0.030992,4,0.303936,0.338757,2912.385696
丈夫(1948),丈夫,notion,0,1,1,0,1,1,0.008247,4,0.26379,0.27611,0
三一(1948),三一,notion,0,2,2,0,2,2,0.012233,4,0.270573,0.288045,1678.569586
三三(1948),三三,notion,0,1,1,0,1,1,0.007515,4,0.262793,0.274313,0
三个(1948),三个,notion,0,5,5,0,5,5,0.04123,4,0.316377,0.355096,15947.450273
三中全会(1948),三中全会,notion,0,4,4,0,4,4,0.041495,4,0.312638,0.350315,7139.881149
三二(1948),三二,notion,0,1,1,0,1,1,0.007515,4,0.262793,0.274313,0
三位一体(1948),三位一体,notion,0,1,1,0,1,1,0.009755,4,0.266617,0.281135,0
三元(1948),三元,notion,0,2,2,0,2,2,0.008698,4,0.258507,0.266483,0.569098
三光政策(1948),三光政策,notion,0,1,1,0,1,1,0.009751,4,0.267186,0.282133,0
三八(1948),三八,notion,0,2,2,0,3,3,0.019494,4,0.280535,0.30445,1251.270065
三八妇女节(1948),三八妇女节,notion,0,2,2,0,2,2,0.026257,4,0.292073,0.322053,1522.40889
三八节(1948),三八节,notion,0,2,2,0,4,4,0.019491,4,0.281819,0.30648,1649.883746
三分(1948),三分,notion,0,1,1,0,1,1,0.01022,4,0.267243,0.282233,0
三区(1948),三区,notion,0,1,1,0,1,1,0.004718,4,0.258401,0.266227,0
三十(1948),三十,notion,0,3,3,0,4,4,0.036024,4,0.308631,0.345069,5629.029515
三十二条(1948),三十二条,notion,0,1,1,0,1,1,0.01022,4,0.267243,0.282233,0
三十年(1948),三十年,notion,0,3,3,0,3,3,0.024226,4,0.287425,0.315187,3341.270955
三咏(1948),三咏,notion,0,1,1,0,1,1,0.011322,4,0.269061,0.285394,0
三型(1948),三型,notion,0,1,1,0,1,1,0.004718,4,0.258401,0.266227,0
三大(1948),三大,notion,0,4,4,0,5,5,0.048507,4,0.326411,0.367186,8767.822213
三天(1948),三天,notion,0,1,1,0,1,1,0.016518,4,0.278724,0.3015,0
三届(1948),三届,notion,0,1,1,0,1,1,0.016518,4,0.278724,0.3015,0
三幅(1948),三幅,notion,0,1,1,0,1,1,0.016518,4,0.278724,0.3015,0
三打(1948),三打,notion,0,1,1,0,1,1,0.009751,4,0.267186,0.282133,0
三整(1948),三整,notion,0,1,1,0,1,1,0.016518,4,0.278724,0.3015,0
三条(1948),三条,notion,0,1,1,0,1,1,0.009751,4,0.267186,0.282133,0
三查(1948),三查,notion,0,1,1,0,1,1,0.016518,4,0.278724,0.3015,0
三校(1948),三校,notion,0,1,1,0,1,1,0.011322,4,0.269061,0.285394,0
三次(1948),三次,notion,0,1,1,0,2,2,0.016518,4,0.278724,0.3015,0
三点(1948),三点,notion,0,1,1,0,1,1,0.009739,4,0.265806,0.279704,0
三百万(1948),三百万,notion,0,1,1,0,1,1,0.009755,4,0.266617,0.281135,0
三百五十万(1948),三百五十万,notion,0,1,1,0,1,1,0.009739,4,0.265806,0.279704,0
三章(1948),三章,notion,0,1,1,0,1,1,0.016752,4,0.279138,0.302165,0
三管齐下(1948),三管齐下,notion,0,1,1,0,1,1,0.016518,4,0.278724,0.3015,0
三篇(1948),三篇,notion,0,2,2,0,2,2,0.008698,4,0.258507,0.266483,0.569098
三续(1948),三续,notion,0,1,1,0,1,1,0.004718,4,0.258401,0.266227,0
三行(1948),三行,notion,0,1,1,0,1,1,0.008247,4,0.26379,0.27611,0
三裂(1948),三裂,notion,0,1,1,0,1,1,0.011322,4,0.269061,0.285394,0
三角(1948),三角,notion,0,1,1,0,1,1,0.01022,4,0.267243,0.282233,0
三角洲(1948),三角洲,notion,0,1,1,0,1,1,0.009751,4,0.267186,0.282133,0
三言两语(1948),三言两语,notion,0,1,1,0,1,1,0.009739,4,0.265806,0.279704,0
三部(1948),三部,notion,0,1,1,0,1,1,0.009755,4,0.266617,0.281135,0
三部曲(1948),三部曲,notion,0,1,1,0,1,1,0.01424,4,0.275514,0.296275,0
三题(1948),三题,notion,0,2,2,0,2,2,0.026272,4,0.29319,0.323683,1793.896368
三首(1948),三首,notion,0,1,1,0,1,1,0.009739,4,0.265806,0.279704,0
上之环(1948),上之环,notion,0,1,1,0,1,1,0.01424,4,0.275514,0.296275,0
上了(1948),上了,notion,0,1,1,0,1,1,0.016518,4,0.278724,0.3015,0
上任(1948),上任,notion,0,1,1,0,1,1,0.016752,4,0.279138,0.302165,0
上午(1948),上午,notion,0,1,1,0,1,1,0.011322,4,0.269061,0.285394,0
上台(1948),上台,notion,0,1,1,0,1,1,0.016752,4,0.279138,0.302165,0
上士(1948),上士,notion,0,1,1,0,1,1,0.01424,4,0.275514,0.296275,0
上当(1948),上当,notion,0,2,2,0,2,2,0.026257,4,0.292073,0.322053,1522.40889
上有(1948),上有,notion,0,1,1,0,1,1,0.009751,4,0.267186,0.282133,0
上海大众(1948),上海大众,notion,0,1,1,0,1,1,0.016752,4,0.279138,0.302165,0
上海市(1948),上海市,notion,0,3,3,0,3,3,0.044591,4,0.323126,0.363237,6083.12181
上海银行(1948),上海银行,notion,0,1,1,0,1,1,0.007515,4,0.262793,0.274313,0
上游(1948),上游,notion,0,1,1,0,1,1,0.009751,4,0.267186,0.282133,0
上的(1948),上的,notion,0,2,2,0,2,2,0.030758,4,0.303347,0.337959,2812.221703
上看(1948),上看,notion,0,1,1,0,1,1,0.004718,4,0.258401,0.266227,0
上策(1948),上策,notion,0,1,1,0,1,1,0.01424,4,0.275514,0.296275,0
上篇(1948),上篇,notion,0,2,2,0,2,2,0.017255,4,0.277263,0.299193,1338.862931
上腾(1948),上腾,notion,0,1,1,0,1,1,0.009739,4,0.265806,0.279704,0
上谈(1948),上谈,notion,0,1,1,0,1,1,0.01424,4,0.275514,0.296275,0
下一代(1948),下一代,notion,0,1,1,0,1,1,0.01022,4,0.267243,0.282233,0
下关(1948),下关,notion,0,1,1,0,1,1,0.002332,4,0.253398,0.256677,0
下决心(1948),下决心,notion,0,1,1,0,1,1,0.011322,4,0.269061,0.285394,0
下午(1948),下午,notion,0,4,4,0,4,4,0.03024,4,0.291213,0.320899,3918.810743
下半年(1948),下半年,notion,0,2,2,0,2,2,0.026738,4,0.294408,0.325447,1993.868267
下去(1948),下去,notion,0,2,2,0,2,2,0.030758,4,0.303347,0.337959,2812.221703
下台(1948),下台,notion,0,2,2,0,2,2,0.026738,4,0.294408,0.325447,1993.868267
下文(1948),下文,notion,0,1,1,0,1,1,0.008247,4,0.26379,0.27611,0
下期(1948),下期,notion,0,3,3,0,5,5,0.037813,4,0.309012,0.345568,4605.191573
下的(1948),下的,notion,0,1,1,0,1,1,0.01022,4,0.267243,0.282233,0
下篇(1948),下篇,notion,0,1,1,0,1,1,0.007515,4,0.262793,0.274313,0
下面(1948),下面,notion,0,2,2,0,2,2,0.030758,4,0.303347,0.337959,2812.221703
不为(1948),不为,notion,0,1,1,0,1,1,0.009739,4,0.265806,0.279704,0
不了(1948),不了,notion,0,3,3,0,3,3,0.038287,4,0.310827,0.34793,4250.67334
不争气(1948),不争气,notion,0,1,1,0,1,1,0.011322,4,0.269061,0.285394,0
不会(1948),不会,notion,0,4,4,0,5,5,0.028426,4,0.292779,0.323195,5278.48516
不住(1948),不住,notion,0,2,2,0,2,2,0.017987,4,0.278331,0.300923,1351.046959
不公(1948),不公,notion,0,1,1,0,1,1,0.008247,4,0.26379,0.27611,0
不准(1948),不准,notion,0,1,1,0,1,1,0.01424,4,0.275514,0.296275,0
不出(1948),不出,notion,0,1,1,0,1,1,0.009739,4,0.265806,0.279704,0
不劳而获(1948),不劳而获,notion,0,1,1,0,1,1,0.016752,4,0.279138,0.302165,0
不及(1948),不及,notion,0,1,1,0,1,1,0.005017,4,0.257497,0.26453,0
不可(1948),不可,notion,0,4,4,0,4,4,0.039136,4,0.317098,0.355939,11644.784309
不合理(1948),不合理,notion,0,1,1,0,2,2,0.01424,4,0.275514,0.296275,0
不合算(1948),不合算,notion,0,1,1,0,1,1,0.011322,4,0.269061,0.285394,0
不售(1948),不售,notion,0,1,1,0,1,1,0.01424,4,0.275514,0.296275,0
不在(1948),不在,notion,0,2,2,0,2,2,0.024999,4,0.291484,0.321188,1929.694181
不均(1948),不均,notion,0,2,2,0,2,2,0.024267,4,0.290987,0.320456,2179.633602
不堪(1948),不堪,notion,0,2,2,0,2,2,0.02398,4,0.290133,0.319191,1998.682918
不堪回首(1948),不堪回首,notion,0,1,1,0,1,1,0.007515,4,0.262793,0.274313,0
不够(1948),不够,notion,0,1,1,0,1,1,0.01424,4,0.275514,0.296275,0
不安(1948),不安,notion,0,2,2,0,3,3,0.024267,4,0.290987,0.320456,2179.633602
不容(1948),不容,notion,0,4,4,0,6,6,0.036533,4,0.308479,0.344924,8159.736273
不容忽视(1948),不容忽视,notion,0,1,1,0,2,2,0.01424,4,0.275514,0.296275,0
不屈(1948),不屈,notion,0,1,1,0,1,1,0.016752,4,0.279138,0.302165,0
不已(1948),不已,notion,0,1,1,0,1,1,0.016752,4,0.279138,0.302165,0
不平(1948),不平,notion,0,2,2,0,2,2,0.026491,4,0.291937,0.321853,1403.825067
不幸(1948),不幸,notion,0,2,2,0,2,2,0.021061,4,0.283157,0.308576,1336.570675
不应(1948),不应,notion,0,4,4,0,4,4,0.030454,4,0.29494,0.326323,5927.795358
不得(1948),不得,notion,0,3,3,0,4,4,0.02002,4,0.276102,0.297351,1213.217211
不得了(1948),不得了,notion,0,1,1,0,2,2,0.01424,4,0.275514,0.296275,0
不必(1948),不必,notion,0,2,2,0,4,4,0.018958,4,0.283863,0.309674,3113.558811
不忍(1948),不忍,notion,0,1,1,0,2,2,0.016752,4,0.279138,0.302165,0
不怕(1948),不怕,notion,0,1,1,0,1,1,0.01022,4,0.267243,0.282233,0
不患(1948),不患,notion,0,1,1,0,1,1,0.016752,4,0.279138,0.302165,0
不愿(1948),不愿,notion,0,2,2,0,2,2,0.026272,4,0.29319,0.323683,1793.896368
不成(1948),不成,notion,0,1,1,0,1,1,0.005389,4,0.25849,0.266394,0
不戴(1948),不戴,notion,0,1,1,0,1,1,0.01022,4,0.267243,0.282233,0
不易(1948),不易,notion,0,2,2,0,2,2,0.012905,4,0.270573,0.288045,1024.740512
不是(1948),不是,notion,0,9,9,0,16,16,0.089024,4,0.39486,0.433848,50968.419801
不暇(1948),不暇,notion,0,1,1,0,1,1,0.01424,4,0.275514,0.296275,0
不来(1948),不来,notion,0,2,2,0,2,2,0.033269,4,0.305692,0.34112,2297.98609
不止(1948),不止,notion,0,1,1,0,1,1,0.016518,4,0.278724,0.3015,0
不正(1948),不正,notion,0,1,1,0,1,1,0.01424,4,0.275514,0.296275,0
不法(1948),不法,notion,0,1,1,0,1,1,0.01424,4,0.275514,0.296275,0
不洁(1948),不洁,notion,0,1,1,0,1,1,0.01424,4,0.275514,0.296275,0
不知(1948),不知,notion,0,2,2,0,2,2,0.018958,4,0.283863,0.309674,3113.558811
不离(1948),不离,notion,0,1,1,0,1,1,0.016518,4,0.278724,0.3015,0
不能(1948),不能,notion,0,9,9,0,12,12,0.098373,4,0.425931,0.456941,65309.920067
不自(1948),不自,notion,0,1,1,0,1,1,0.007515,4,0.262793,0.274313,0
不要(1948),不要,notion,0,8,8,0,16,16,0.091959,4,0.409093,0.444807,50341.210262
不要紧(1948),不要紧,notion,0,1,1,0,1,1,0.016518,4,0.278724,0.3015,0
不见得(1948),不见得,notion,0,2,2,0,2,2,0.028074,4,0.296149,0.327943,1864.79583
不让(1948),不让,notion,0,1,1,0,1,1,0.009739,4,0.265806,0.279704,0
不设防(1948),不设防,notion,0,1,1,0,1,1,0.016752,4,0.279138,0.302165,0
不诚(1948),不诚,notion,0,1,1,0,1,1,0.008247,4,0.26379,0.27611,0
不诚实(1948),不诚实,notion,0,1,1,0,1,1,0.008247,4,0.26379,0.27611,0
不该(1948),不该,notion,0,2,2,0,2,2,0.024461,4,0.291756,0.321587,2304.72473
不过(1948),不过,notion,0,1,1,0,1,1,0.016518,4,0.278724,0.3015,0
不通(1948),不通,notion,0,1,1,0,1,1,0.004718,4,0.258401,0.266227,0
不靖(1948),不靖,notion,0,1,1,0,2,2,0.011322,4,0.269061,0.285394,0
与其(1948),与其,notion,0,2,2,0,2,2,0.023992,4,0.29271,0.322985,3168.205568
与币信(1948),与币信,notion,0,1,1,0,1,1,0.008247,4,0.26379,0.27611,0
与虎谋皮(1948),与虎谋皮,notion,0,1,1,0,1,1,0.01424,4,0.275514,0.296275,0
丑剧(1948),丑剧,notion,0,1,1,0,1,1,0.016752,4,0.279138,0.302165,0
丑闻(1948),丑闻,notion,0,2,2,0,2,2,0.019491,4,0.281819,0.30648,1649.883746
专刊(1948),专刊,notion,0,2,2,0,2,2,0.008698,4,0.258507,0.266483,0.569098
专号(1948),专号,notion,0,2,2,0,2,2,0.026269,4,0.293695,0.324415,1931.353166
专员(1948),专员,notion,0,1,1,0,1,1,0.01424,4,0.275514,0.296275,0
专家(1948),专家,notion,0,1,1,0,1,1,0.016752,4,0.279138,0.302165,0
专用(1948),专用,notion,0,1,1,0,1,1,0.007515,4,0.262793,0.274313,0
专科(1948),专科,notion,0,1,1,0,1,1,0.009739,4,0.265806,0.279704,0
专科学校(1948),专科学校,notion,0,1,1,0,1,1,0.009739,4,0.265806,0.279704,0
世乱(1948),世乱,notion,0,1,1,0,1,1,0.016752,4,0.279138,0.302165,0
世外桃源(1948),世外桃源,notion,0,1,1,0,1,1,0.01424,4,0.275514,0.296275,0
世家(1948),世家,notion,0,1,1,0,1,1,0.016752,4,0.279138,0.302165,0
世局(1948),世局,notion,0,1,1,0,1,1,0.01424,4,0.275514,0.296275,0
世界史(1948),世界史,notion,0,1,1,0,1,1,0.009739,4,0.265806,0.279704,0
世界大战(1948),世界大战,notion,0,3,3,0,4,4,0.033077,4,0.30475,0.339911,5680.358983
世界纪录(1948),世界纪录,notion,0,1,1,0,1,1,0.009755,4,0.266617,0.281135,0
世纪(1948),世纪,notion,0,2,2,0,2,2,0.012905,4,0.270573,0.288045,1024.740512
世运(1948),世运,notion,0,1,1,0,1,1,0.011322,4,0.269061,0.285394,0
世青(1948),世青,notion,0,1,1,0,1,1,0.009739,4,0.265806,0.279704,0
丘八(1948),丘八,notion,0,1,1,0,1,1,0.016752,4,0.279138,0.302165,0
丘陵(1948),丘陵,notion,0,1,1,0,2,2,0.009751,4,0.267186,0.282133,0
业余(1948),业余,notion,0,1,1,0,1,1,0.004718,4,0.258401,0.266227,0
业务(1948),业务,notion,0,2,2,0,2,2,0.016039,4,0.2771,0.298926,2122.22906
东亚(1948),东亚,notion,0,1,1,0,1,1,0.009755,4,0.266617,0.281135,0
东南(1948),东南,notion,0,3,3,0,3,3,0.021972,4,0.285177,0.31176,4750.892863
东山再起(1948),东山再起,notion,0,1,1,0,1,1,0.016752,4,0.279138,0.302165,0
东德(1948),东德,notion,0,1,1,0,1,1,0.009755,4,0.266617,0.281135,0
东拼西凑(1948),东拼西凑,notion,0,1,1,0,1,1,0.016518,4,0.278724,0.3015,0
东方(1948),东方,notion,0,4,4,0,4,4,0.053245,4,0.33677,0.378965,11702.799327
东来(1948),东来,notion,0,1,1,0,1,1,0.009739,4,0.265806,0.279704,0
东林(1948),东林,notion,0,1,1,0,1,1,0.007515,4,0.262793,0.274313,0
东欧(1948),东欧,notion,0,1,1,0,1,1,0.011322,4,0.269061,0.285394,0
东海(1948),东海,notion,0,1,1,0,1,1,0.016752,4,0.279138,0.302165,0
东西(1948),东西,notion,0,2,2,0,2,2,0.015763,4,0.275232,0.295865,1348.309636
东西南北(1948),东西南北,notion,0,1,1,0,1,1,0.009739,4,0.265806,0.279704,0
东路(1948),东路,notion,0,1,1,0,1,1,0.01022,4,0.267243,0.282233,0
东顾(1948),东顾,notion,0,1,1,0,1,1,0.011322,4,0.269061,0.285394,0
丢丑(1948),丢丑,notion,0,1,1,0,1,1,0.005017,4,0.257497,0.26453,0
两事工(1948),两事工,notion,0,1,1,0,1,1,0.01424,4,0.275514,0.296275,0
两件(1948),两件,notion,0,2,2,0,2,2,0.018468,4,0.27997,0.303552,1613.088959
两位(1948),两位,notion,0,1,1,0,1,1,0.016752,4,0.279138,0.302165,0
两函(1948),两函,notion,0,1,1,0,1,1,0.01424,4,0.275514,0.296275,0
两分(1948),两分,notion,0,1,1,0,1,1,0.011322,4,0.269061,0.285394,0
两国(1948),两国,notion,0,2,2,0,3,3,0.021076,4,0.284616,0.310839,1735.877057
两处(1948),两处,notion,0,1,1,0,1,1,0.01022,4,0.267243,0.282233,0
两家(1948),两家,notion,0,1,1,0,1,1,0.01022,4,0.267243,0.282233,0
两封(1948),两封,notion,0,1,1,0,1,1,0.011322,4,0.269061,0.285394,0
两封信(1948),两封信,notion,0,1,1,0,2,2,0.004718,4,0.258401,0.266227,0
两局(1948),两局,notion,0,1,1,0,1,1,0.016518,4,0.278724,0.3015,0
两年(1948),两年,notion,0,1,1,0,1,1,0.009755,4,0.266617,0.281135,0
两广(1948),两广,notion,0,3,3,0,4,4,0.037825,4,0.313551,0.351424,6776.204202
两条(1948),两条,notion,0,3,3,0,3,3,0.024512,4,0.28609,0.313157,2678.104884
两条路(1948),两条路,notion,0,1,1,0,1,1,0.011322,4,0.269061,0.285394,0
两条路线(1948),两条路线,notion,0,3,3,0,3,3,0.036012,4,0.306365,0.342074,4567.575323
两条道路(1948),两条道路,notion,0,1,1,0,1,1,0.005017,4,0.257497,0.26453,0
两极(1948),两极,notion,0,1,1,0,1,1,0.009739,4,0.265806,0.279704,0
两极化(1948),两极化,notion,0,1,1,0,1,1,0.011322,4,0.269061,0.285394,0
两次(1948),两次,notion,0,1,1,0,2,2,0.011322,4,0.269061,0.285394,0
两点(1948),两点,notion,0,1,1,0,1,1,0.009739,4,0.265806,0.279704,0
两讲(1948),两讲,notion,0,1,1,0,1,1,0.007515,4,0.262793,0.274313,0
两起(1948),两起,notion,0,1,1,0,1,1,0.016752,4,0.279138,0.302165,0
两路(1948),两路,notion,0,1,1,0,1,1,0.01424,4,0.275514,0.296275,0
两过间(1948),两过间,notion,0,1,1,0,1,1,0.016518,4,0.278724,0.3015,0
两重(1948),两重,notion,0,1,1,0,1,1,0.007515,4,0.262793,0.274313,0
严冬(1948),严冬,notion,0,1,1,0,1,1,0.016752,4,0.279138,0.302165,0
严弛(1948),严弛,notion,0,1,1,0,1,1,0.008247,4,0.26379,0.27611,0
严惩(1948),严惩,notion,0,1,1,0,1,1,0.007515,4,0.262793,0.274313,0
严法(1948),严法,notion,0,1,1,0,1,1,0.01424,4,0.275514,0.296275,0
严肃性(1948),严肃性,notion,0,2,2,0,2,2,0.026269,4,0.293695,0.324415,1931.353166
严重(1948),严重,notion,0,3,3,0,5,5,0.038508,4,0.316031,0.354552,7136.780743
丧钟(1948),丧钟,notion,0,1,1,0,1,1,0.009755,4,0.266617,0.281135,0
个人(1948),个人,notion,0,4,4,0,4,4,0.048991,4,0.335357,0.377401,14679.358362
个人主义(1948),个人主义,notion,0,1,1,0,2,2,0.009751,4,0.267186,0.282133,0
个人经历(1948),个人经历,notion,0,1,1,0,1,1,0.01022,4,0.267243,0.282233,0
个性(1948),个性,notion,0,1,1,0,1,1,0.01424,4,0.275514,0.296275,0
中东(1948),中东,notion,0,2,2,0,2,2,0.030992,4,0.303936,0.338757,2912.385696
中之至性(1948),中之至性,notion,0,1,1,0,1,1,0.01424,4,0.275514,0.296275,0
中人(1948),中人,notion,0,1,1,0,1,1,0.01424,4,0.275514,0.296275,0
中共(1948),中共,notion,0,3,3,0,8,8,0.04208,4,0.32089,0.360542,6900.033893
中兴(1948),中兴,notion,0,2,2,0,2,2,0.026738,4,0.294408,0.325447,1993.868267
中区(1948),中区,notion,0,1,1,0,1,1,0.016518,4,0.278724,0.3015,0
中医(1948),中医,notion,0,1,1,0,1,1,0.007515,4,0.262793,0.274313,0
中华(1948),中华,notion,0,1,1,0,2,2,0.016752,4,0.279138,0.302165,0
中华全国(1948),中华全国,notion,0,2,2,0,2,2,0.026491,4,0.291937,0.321853,1403.825067
中华工商(1948),中华工商,notion,0,1,1,0,1,1,0.009739,4,0.265806,0.279704,0
中华民国(1948),中华民国,notion,0,1,1,0,1,1,0.007515,4,0.262793,0.274313,0
中原(1948),中原,notion,0,4,4,0,5,5,0.052838,4,0.335597,0.377668,11303.281317
中去(1948),中去,notion,0,1,1,0,1,1,0.016752,4,0.279138,0.302165,0
中古时代(1948),中古时代,notion,0,1,1,0,1,1,0.007515,4,0.262793,0.274313,0
中国人(1948),中国人,notion,0,4,4,0,6,6,0.053245,4,0.33677,0.378965,11702.799327
中国人民解放军(1948),中国人民解放军,notion,0,1,1,0,1,1,0.016518,4,0.278724,0.3015,0
中国人民银行(1948),中国人民银行,notion,0,1,1,0,1,1,0.016518,4,0.278724,0.3015,0
中国共产党(1948),中国共产党,notion,0,1,1,0,1,1,0.007515,4,0.262793,0.274313,0
中国共产党中央委员会(1948),中国共产党中央委员会,notion,0,1,1,0,1,1,0.016518,4,0.278724,0.3015,0
中国史纲(1948),中国史纲,notion,0,1,1,0,1,1,0.01424,4,0.275514,0.296275,0
中国国民党革命委员会(1948),中国国民党革命委员会,notion,0,1,1,0,1,1,0.016518,4,0.278724,0.3015,0
中国政府(1948),中国政府,notion,0,1,1,0,1,1,0.01022,4,0.267243,0.282233,0
中士(1948),中士,notion,0,1,1,0,1,1,0.011322,4,0.269061,0.285394,0
中外(1948),中外,notion,0,2,2,0,2,2,0.030758,4,0.303347,0.337959,2812.221703
中大的(1948),中大的,notion,0,1,1,0,1,1,0.005017,4,0.257497,0.26453,0
中央大学(1948),中央大学,notion,0,3,3,0,3,3,0.023875,4,0.286657,0.314022,2861.817113
中央局(1948),中央局,notion,0,1,1,0,2,2,0.016518,4,0.278724,0.3015,0
中央日报(1948),中央日报,notion,0,1,1,0,1,1,0.011322,4,0.269061,0.285394,0
中央研究院(1948),中央研究院,notion,0,3,3,0,3,3,0.033463,4,0.302687,0.337116,3835.275563
中央社(1948),中央社,notion,0,1,1,0,1,1,0.016518,4,0.278724,0.3015,0
中央银行(1948),中央银行,notion,0,1,1,0,1,1,0.01424,4,0.275514,0.296275,0
中学(1948),中学,notion,0,4,4,0,4,4,0.043298,4,0.321055,0.360797,11027.062833
中学生(1948),中学生,notion,0,2,2,0,3,3,0.025562,4,0.293259,0.323783,2167.4723
中小(1948),中小,notion,0,1,1,0,2,2,0.016518,4,0.278724,0.3015,0
中年人(1948),中年人,notion,0,2,2,0,2,2,0.008698,4,0.258507,0.266483,0.569098
中年妇女(1948),中年妇女,notion,0,1,1,0,1,1,0.016752,4,0.279138,0.302165,0
中建(1948),中建,notion,0,2,2,0,17,17,0.010107,4,0.266447,0.280891,1166.286428
中心(1948),中心,notion,0,4,4,0,4,4,0.036213,4,0.310262,0.347254,11907.896036
中患(1948),中患,notion,0,1,1,0,1,1,0.01424,4,0.275514,0.296275,0
中来(1948),中来,notion,0,1,1,0,2,2,0.016752,4,0.279138,0.302165,0
中欧(1948),中欧,notion,0,1,1,0,1,1,0.005017,4,0.257497,0.26453,0
中正(1948),中正,notion,0,1,1,0,2,2,0.01022,4,0.267243,0.282233,0
中法(1948),中法,notion,0,1,1,0,1,1,0.005389,4,0.25849,0.266394,0
中看(1948),中看,notion,0,3,3,0,3,3,0.02545,4,0.285981,0.312991,1629.880666
中秋(1948),中秋,notion,0,1,1,0,1,1,0.016752,4,0.279138,0.302165,0
中立(1948),中立,notion,0,2,2,0,2,2,0.018002,4,0.27945,0.30272,1656.832374
中等教育(1948),中等教育,notion,0,1,1,0,1,1,0.016752,4,0.279138,0.302165,0
中篇(1948),中篇,notion,0,1,1,0,1,1,0.01424,4,0.275514,0.296275,0
中美(1948),中美,notion,0,4,4,0,4,4,0.04623,4,0.325478,0.366088,10193.819465
中美关(1948),中美关,notion,0,1,1,0,1,1,0.01424,4,0.275514,0.296275,0
中联(1948),中联,notion,0,1,1,0,1,1,0.005017,4,0.257497,0.26453,0
中能(1948),中能,notion,0,2,2,0,2,2,0.008698,4,0.258507,0.266483,0.569098
中苏(1948),中苏,notion,0,1,1,0,1,1,0.016752,4,0.279138,0.302165,0
中英(1948),中英,notion,0,1,1,0,1,1,0.01424,4,0.275514,0.296275,0
中路(1948),中路,notion,0,1,1,0,1,1,0.005389,4,0.25849,0.266394,0
中酌(1948),中酌,notion,0,1,1,0,1,1,0.01424,4,0.275514,0.296275,0
中间派(1948),中间派,notion,0,1,1,0,1,1,0.009755,4,0.266617,0.281135,0
中间路线(1948),中间路线,notion,0,6,6,0,7,7,0.064367,4,0.355477,0.398609,25478.572017
中风(1948),中风,notion,0,1,1,0,1,1,0.011322,4,0.269061,0.285394,0
丰功伟绩(1948),丰功伟绩,notion,0,1,1,0,1,1,0.009751,4,0.267186,0.282133,0
丰收(1948),丰收,notion,0,1,1,0,1,1,0.009755,4,0.266617,0.281135,0
丰满(1948),丰满,notion,0,1,1,0,1,1,0.016518,4,0.278724,0.3015,0
串演(1948),串演,notion,0,1,1,0,1,1,0.016518,4,0.278724,0.3015,0
临到(1948),临到,notion,0,1,1,0,1,1,0.016752,4,0.279138,0.302165,0
临头(1948),临头,notion,0,1,1,0,1,1,0.016518,4,0.278724,0.3015,0
临时(1948),临时,notion,0,6,6,0,7,7,0.058059,4,0.343734,0.386597,26019.191348
临汾(1948),临汾,notion,0,1,1,0,1,1,0.016518,4,0.278724,0.3015,0
丹特士(1948),丹特士,notion,0,1,1,0,1,1,0.009755,4,0.266617,0.281135,0
为九一(1948),为九一,notion,0,1,1,0,1,1,0.016752,4,0.279138,0.302165,0
为了(1948),为了,notion,0,3,3,0,3,3,0.029384,4,0.299597,0.332856,5347.098442
为什(1948),为什,notion,0,1,1,0,2,2,0.016518,4,0.278724,0.3015,0
为何(1948),为何,notion,0,2,2,0,2,2,0.019258,4,0.282157,0.307012,1389.971062
为啥(1948),为啥,notion,0,1,1,0,1,1,0.016518,4,0.278724,0.3015,0
为政之道(1948),为政之道,notion,0,1,1,0,1,1,0.004718,4,0.258401,0.266227,0
为灾(1948),为灾,notion,0,1,1,0,1,1,0.01022,4,0.267243,0.282233,0
为的是(1948),为的是,notion,0,1,1,0,1,1,0.008247,4,0.26379,0.27611,0
为虎傅翼(1948),为虎傅翼,notion,0,1,1,0,1,1,0.008247,4,0.26379,0.27611,0
主义(1948),主义,notion,0,6,6,0,9,9,0.060103,4,0.343389,0.386231,21057.374226
主义者(1948),主义者,notion,0,1,1,0,1,1,0.009751,4,0.267186,0.282133,0
主人(1948),主人,notion,0,1,1,0,2,2,0.016518,4,0.278724,0.3015,0
主任(1948),主任,notion,0,1,1,0,2,2,0.004718,4,0.258401,0.266227,0
主席(1948),主席,notion,0,2,2,0,3,3,0.030758,4,0.303347,0.337959,2812.221703
主张(1948),主张,notion,0,6,6,0,8,8,0.061285,4,0.348874,0.391954,24614.944649
主持人(1948),主持人,notion,0,1,1,0,1,1,0.016752,4,0.279138,0.302165,0
主教(1948),主教,notion,0,1,1,0,1,1,0.016752,4,0.279138,0.302165,0
主权(1948),主权,notion,0,3,3,0,4,4,0.036012,4,0.306365,0.342074,4567.575323
主流(1948),主流,notion,0,1,1,0,4,4,0.002332,4,0.253398,0.256677,0
主浙(1948),主浙,notion,0,1,1,0,1,1,0.01424,4,0.275514,0.296275,0
主皖乎(1948),主皖乎,notion,0,1,1,0,1,1,0.01424,4,0.275514,0.296275,0
主编(1948),主编,notion,0,1,1,0,1,1,0.007515,4,0.262793,0.274313,0
主要(1948),主要,notion,0,2,2,0,2,2,0.026507,4,0.294224,0.325181,2012.895914
主观(1948),主观,notion,0,1,1,0,1,1,0.009751,4,0.267186,0.282133,0
举世瞩目(1948),举世瞩目,notion,0,2,2,0,2,2,0.025562,4,0.293259,0.323783,2167.4723
举办(1948),举办,notion,0,1,1,0,1,1,0.011322,4,0.269061,0.285394,0
举动(1948),举动,notion,0,1,1,0,1,1,0.009739,4,0.265806,0.279704,0
举行(1948),举行,notion,0,4,4,0,4,4,0.050524,4,0.331305,0.372843,11301.745286
举起(1948),举起,notion,0,1,1,0,1,1,0.009755,4,0.266617,0.281135,0
乃至(1948),乃至,notion,0,1,1,0,1,1,0.005017,4,0.257497,0.26453,0
义儿(1948),义儿,notion,0,1,1,0,1,1,0.01424,4,0.275514,0.296275,0
义国(1948),义国,notion,0,1,1,0,1,1,0.01424,4,0.275514,0.296275,0
义德(1948),义德,notion,0,1,1,0,1,1,0.009755,4,0.266617,0.281135,0
之七(1948),之七,notion,0,1,1,0,1,1,0.007515,4,0.262793,0.274313,0
之上(1948),之上,notion,0,1,1,0,1,1,0.01424,4,0.275514,0.296275,0
之下(1948),之下,notion,0,1,1,0,1,1,0.01022,4,0.267243,0.282233,0
之丧(1948),之丧,notion,0,1,1,0,1,1,0.016518,4,0.278724,0.3015,0
之于(1948),之于,notion,0,1,1,0,1,1,0.007515,4,0.262793,0.274313,0
之会(1948),之会,notion,0,1,1,0,1,1,0.016752,4,0.279138,0.302165,0
之先(1948),之先,notion,0,2,2,0,2,2,0.008698,4,0.258507,0.266483,0.569098
之内(1948),之内,notion,0,2,2,0,2,2,0.012072,4,0.268484,0.284451,677.642529
之分(1948),之分,notion,0,1,1,0,1,1,0.008247,4,0.26379,0.27611,0
之前(1948),之前,notion,0,3,3,0,3,3,0.03806,4,0.311162,0.348363,5324.627604
之助(1948),之助,notion,0,1,1,0,1,1,0.011322,4,0.269061,0.285394,0
之发(1948),之发,notion,0,1,1,0,1,1,0.005017,4,0.257497,0.26453,0
之史(1948),之史,notion,0,1,1,0,1,1,0.007515,4,0.262793,0.274313,0
之国(1948),之国,notion,0,2,2,0,2,2,0.012087,4,0.269254,0.285782,752.110171
之塞宴(1948),之塞宴,notion,0,1,1,0,1,1,0.01424,4,0.275514,0.296275,0
之境(1948),之境,notion,0,1,1,0,1,1,0.01424,4,0.275514,0.296275,0
之士(1948),之士,notion,0,1,1,0,1,1,0.01424,4,0.275514,0.296275,0
之声(1948),之声,notion,0,2,2,0,2,2,0.030758,4,0.303347,0.337959,2812.221703
之处(1948),之处,notion,0,1,1,0,1,1,0.01424,4,0.275514,0.296275,0
之外(1948),之外,notion,0,1,1,0,1,1,0.01424,4,0.275514,0.296275,0
之失(1948),之失,notion,0,3,3,0,3,3,0.035589,4,0.307897,0.344104,5512.554671
之富(1948),之富,notion,0,1,1,0,1,1,0.01424,4,0.275514,0.296275,0
之局(1948),之局,notion,0,2,2,0,3,3,0.027839,4,0.295962,0.327676,1920.33989
之师(1948),之师,notion,0,1,1,0,1,1,0.016518,4,0.278724,0.3015,0
之弊(1948),之弊,notion,0,1,1,0,1,1,0.007515,4,0.262793,0.274313,0
之役(1948),之役,notion,0,2,2,0,2,2,0.024461,4,0.291756,0.321587,2304.72473
之心(1948),之心,notion,0,1,1,0,1,1,0.016752,4,0.279138,0.302165,0
之我见(1948),之我见,notion,0,1,1,0,1,1,0.008247,4,0.26379,0.27611,0
之所(1948),之所,notion,0,1,1,0,1,1,0.01424,4,0.275514,0.296275,0
之手(1948),之手,notion,0,1,1,0,1,1,0.01424,4,0.275514,0.296275,0
之捷(1948),之捷,notion,0,1,1,0,1,1,0.016518,4,0.278724,0.3015,0
之有(1948),之有,notion,0,1,1,0,1,1,0.01424,4,0.275514,0.296275,0
之术(1948),之术,notion,0,1,1,0,1,1,0.01424,4,0.275514,0.296275,0
之歌(1948),之歌,notion,0,1,1,0,1,1,0.009751,4,0.267186,0.282133,0
之死(1948),之死,notion,0,2,2,0,3,3,0.028074,4,0.296149,0.327943,1864.79583
之治(1948),之治,notion,0,1,1,0,1,1,0.007515,4,0.262793,0.274313,0
之法(1948),之法,notion,0,1,1,0,1,1,0.011322,4,0.269061,0.285394,0
之深(1948),之深,notion,0,1,1,0,1,1,0.01424,4,0.275514,0.296275,0
之游(1948),之游,notion,0,1,1,0,1,1,0.004718,4,0.258401,0.266227,0
之用(1948),之用,notion,0,1,1,0,1,1,0.007515,4,0.262793,0.274313,0
之病(1948),之病,notion,0,2,2,0,2,2,0.019569,4,0.280598,0.30455,1193.220239
之癌(1948),之癌,notion,0,1,1,0,1,1,0.016752,4,0.279138,0.302165,0
之盛(1948),之盛,notion,0,1,1,0,1,1,0.01424,4,0.275514,0.296275,0
之祸(1948),之祸,notion,0,1,1,0,1,1,0.007515,4,0.262793,0.274313,0
之窗(1948),之窗,notion,0,1,1,0,1,1,0.009751,4,0.267186,0.282133,0
之类(1948),之类,notion,0,1,1,0,1,1,0.01424,4,0.275514,0.296275,0
之纤丽(1948),之纤丽,notion,0,1,1,0,1,1,0.01424,4,0.275514,0.296275,0
之约(1948),之约,notion,0,1,1,0,1,1,0.007515,4,0.262793,0.274313,0
之胜(1948),之胜,notion,0,1,1,0,1,1,0.01424,4,0.275514,0.296275,0
之血(1948),之血,notion,0,1,1,0,1,1,0.007515,4,0.262793,0.274313,0
之言(1948),之言,notion,0,1,1,0,1,1,0.011322,4,0.269061,0.285394,0
之诉(1948),之诉,notion,0,1,1,0,1,1,0.011322,4,0.269061,0.285394,0
之谜(1948),之谜,notion,0,5,5,0,8,8,0.069052,4,0.367007,0.409601,21433.655809
之谣(1948),之谣,notion,0,1,1,0,1,1,0.016752,4,0.279138,0.302165,0
之象羣(1948),之象羣,notion,0,1,1,0,1,1,0.01424,4,0.275514,0.296275,0
之路(1948),之路,notion,0,3,3,0,3,3,0.023409,4,0.287073,0.314655,3235.851475
之辨(1948),之辨,notion,0,1,1,0,1,1,0.007515,4,0.262793,0.274313,0
之远(1948),之远,notion,0,1,1,0,1,1,0.011322,4,0.269061,0.285394,0
之速(1948),之速,notion,0,1,1,0,1,1,0.007515,4,0.262793,0.274313,0
之道(1948),之道,notion,0,3,3,0,3,3,0.030406,4,0.29874,0.331658,3794.467543
之铁输(1948),之铁输,notion,0,1,1,0,1,1,0.011322,4,0.269061,0.285394,0
之门(1948),之门,notion,0,1,1,0,1,1,0.016518,4,0.278724,0.3015,0
之页(1948),之页,notion,0,1,1,0,3,3,0.01424,4,0.275514,0.296275,0
乌克兰(1948),乌克兰,notion,0,1,1,0,1,1,0.009755,4,0.266617,0.281135,0
乌兹倍(1948),乌兹倍,notion,0,1,1,0,1,1,0.009755,4,0.266617,0.281135,0
乌鸦(1948),乌鸦,notion,0,1,1,0,1,1,0.009751,4,0.267186,0.282133,0
乔治(1948),乔治,notion,0,1,1,0,1,1,0.009755,4,0.266617,0.281135,0
乔治亚(1948),乔治亚,notion,0,1,1,0,1,1,0.009755,4,0.266617,0.281135,0
乖谬(1948),乖谬,notion,0,1,1,0,1,1,0.01424,4,0.275514,0.296275,0
九·二一(1948),九·二一,notion,0,1,1,0,1,1,0.016752,4,0.279138,0.302165,0
九一三(1948),九一三,notion,0,1,1,0,1,1,0.004718,4,0.258401,0.266227,0
九一八(1948),九一八,notion,0,6,6,0,9,9,0.057205,4,0.333896,0.375882,14416.827379
九十(1948),九十,notion,0,1,1,0,1,1,0.011322,4,0.269061,0.285394,0
九厂(1948),九厂,notion,0,2,2,0,2,2,0.026269,4,0.293695,0.324415,1931.353166
九国(1948),九国,notion,0,1,1,0,2,2,0.009755,4,0.266617,0.281135,0
九州(1948),九州,notion,0,2,2,0,2,2,0.008698,4,0.258507,0.266483,0.569098
九死一生(1948),九死一生,notion,0,1,1,0,1,1,0.011322,4,0.269061,0.285394,0
九省(1948),九省,notion,0,1,1,0,1,1,0.016518,4,0.278724,0.3015,0
九重(1948),九重,notion,0,1,1,0,1,1,0.01424,4,0.275514,0.296275,0
九龙城(1948),九龙城,notion,0,1,1,0,1,1,0.009739,4,0.265806,0.279704,0
乞儿(1948),乞儿,notion,0,1,1,0,1,1,0.009751,4,0.267186,0.282133,0
乞求(1948),乞求,notion,0,1,1,0,1,1,0.008247,4,0.26379,0.27611,0
习作(1948),习作,notion,0,1,1,0,1,1,0.009751,4,0.267186,0.282133,0
习惯(1948),习惯,notion,0,1,1,0,1,1,0.004718,4,0.258401,0.266227,0
乡下(1948),乡下,notion,0,1,1,0,1,1,0.004718,4,0.258401,0.266227,0
乡下人(1948),乡下人,notion,0,1,1,0,1,1,0.011322,4,0.269061,0.285394,0
乡下佬(1948),乡下佬,notion,0,1,1,0,1,1,0.009751,4,0.267186,0.282133,0
乡土(1948),乡土,notion,0,1,1,0,1,1,0.011322,4,0.269061,0.285394,0
乡场(1948),乡场,notion,0,1,1,0,1,1,0.016752,4,0.279138,0.302165,0
书业(1948),书业,notion,0,1,1,0,1,1,0.011322,4,0.269061,0.285394,0
书包(1948),书包,notion,0,1,1,0,1,1,0.004718,4,0.258401,0.266227,0
书后(1948),书后,notion,0,1,1,0,1,1,0.011322,4,0.269061,0.285394,0
书录(1948),书录,notion,0,1,1,0,1,1,0.01424,4,0.275514,0.296275,0
书怀(1948),书怀,notion,0,1,1,0,2,2,0.01424,4,0.275514,0.296275,0
书报(1948),书报,notion,0,1,1,0,1,1,0.009739,4,0.265806,0.279704,0
书法(1948),书法,notion,0,1,1,0,1,1,0.01424,4,0.275514,0.296275,0
书籍(1948),书籍,notion,0,1,1,0,1,1,0.016752,4,0.279138,0.302165,0
乱撞(1948),乱撞,notion,0,1,1,0,1,1,0.01424,4,0.275514,0.296275,0
乱涨(1948),乱涨,notion,0,1,1,0,1,1,0.01424,4,0.275514,0.296275,0
乱笔(1948),乱笔,notion,0,1,1,0,1,1,0.01022,4,0.267243,0.282233,0
乾儿子(1948),乾儿子,notion,0,1,1,0,1,1,0.016518,4,0.278724,0.3015,0
乾嘉时(1948),乾嘉时,notion,0,1,1,0,1,1,0.01424,4,0.275514,0.296275,0
乾脆(1948),乾脆,notion,0,1,1,0,1,1,0.008247,4,0.26379,0.27611,0
了不起(1948),了不起,notion,0,1,1,0,1,1,0.009751,4,0.267186,0.282133,0
了的(1948),了的,notion,0,2,2,0,2,2,0.026972,4,0.293947,0.324781,1749.441854
了解(1948),了解,notion,0,2,2,0,2,2,0.013636,4,0.271042,0.288844,803.589456
予子(1948),予子,notion,0,1,1,0,1,1,0.009739,4,0.265806,0.279704,0
争夺(1948),争夺,notion,0,1,1,0,1,1,0.005389,4,0.25849,0.266394,0
争夺战(1948),争夺战,notion,0,2,2,0,3,3,0.026257,4,0.292073,0.322053,1522.40889
争抢(1948),争抢,notion,0,1,1,0,1,1,0.01424,4,0.275514,0.296275,0
争粮战(1948),争粮战,notion,0,1,1,0,1,1,0.01022,4,0.267243,0.282233,0
争风(1948),争风,notion,0,1,1,0,1,1,0.016518,4,0.278724,0.3015,0
事业(1948),事业,notion,0,6,6,0,13,13,0.067311,4,0.361637,0.404599,29682.859472
事在人爲(1948),事在人爲,notion,0,1,1,0,1,1,0.01424,4,0.275514,0.296275,0
事实胜于雄辩(1948),事实胜于雄辩,notion,0,1,1,0,1,1,0.009755,4,0.266617,0.281135,0
事情(1948),事情,notion,0,1,1,0,1,1,0.011322,4,0.269061,0.285394,0
二一(1948),二一,notion,0,1,1,0,1,1,0.007515,4,0.262793,0.274313,0
二七(1948),二七,notion,0,1,1,0,1,1,0.007515,4,0.262793,0.274313,0
二万(1948),二万,notion,0,1,1,0,1,1,0.009739,4,0.265806,0.279704,0
二九(1948),二九,notion,0,2,2,0,2,2,0.024033,4,0.291281,0.320888,2559.028705
二二(1948),二二,notion,0,1,1,0,1,1,0.007515,4,0.262793,0.274313,0
二二八(1948),二二八,notion,0,1,1,0,1,1,0.016518,4,0.278724,0.3015,0
二五(1948),二五,notion,0,3,3,0,4,4,0.034019,4,0.308226,0.344536,7146.416046
二八(1948),二八,notion,0,1,1,0,1,1,0.007515,4,0.262793,0.274313,0
二六(1948),二六,notion,0,1,1,0,1,1,0.007515,4,0.262793,0.274313,0
二则(1948),二则,notion,0,2,2,0,4,4,0.008698,4,0.258507,0.266483,0.569098
二十万(1948),二十万,notion,0,1,1,0,1,1,0.016518,4,0.278724,0.3015,0
二十世纪(1948),二十世纪,notion,0,2,2,0,2,2,0.012553,4,0.269796,0.286714,703.533419
二十九(1948),二十九,notion,0,1,1,0,1,1,0.011322,4,0.269061,0.285394,0
二十四(1948),二十四,notion,0,1,1,0,1,1,0.009751,4,0.267186,0.282133,0
二千年(1948),二千年,notion,0,1,1,0,1,1,0.002332,4,0.253398,0.256677,0
二四(1948),二四,notion,0,1,1,0,1,1,0.007515,4,0.262793,0.274313,0
二局(1948),二局,notion,0,1,1,0,1,1,0.01022,4,0.267243,0.282233,0
二幅(1948),二幅,notion,0,3,3,0,4,4,0.040513,4,0.31882,0.358013,7099.850156
二年级(1948),二年级,notion,0,1,1,0,1,1,0.016752,4,0.279138,0.302165,0
二次大战(1948),二次大战,notion,0,1,1,0,1,1,0.007515,4,0.262793,0.274313,0
二次革命(1948),二次革命,notion,0,1,1,0,1,1,0.016752,4,0.279138,0.302165,0
二灶港(1948),二灶港,notion,0,1,1,0,1,1,0.004718,4,0.258401,0.266227,0
二百家(1948),二百家,notion,0,1,1,0,1,1,0.009755,4,0.266617,0.281135,0
二百年(1948),二百年,notion,0,2,2,0,2,2,0.019569,4,0.280598,0.30455,1193.220239
二种(1948),二种,notion,0,1,1,0,1,1,0.009751,4,0.267186,0.282133,0
二续(1948),二续,notion,0,2,2,0,2,2,0.009848,4,0.265524,0.27926,689.820462
二醜(1948),二醜,notion,0,1,1,0,1,1,0.016518,4,0.278724,0.3015,0
二题(1948),二题,notion,0,1,1,0,1,1,0.01022,4,0.267243,0.282233,0
二首(1948),二首,notion,0,1,1,0,1,1,0.005017,4,0.257497,0.26453,0
于子(1948),于子,notion,0,1,1,0,1,1,0.009751,4,0.267186,0.282133,0
于斌(1948),于斌,notion,0,1,1,0,1,1,0.016752,4,0.279138,0.302165,0
云丝(1948),云丝,notion,0,1,1,0,1,1,0.016752,4,0.279138,0.302165,0
云南(1948),云南,notion,0,4,4,0,7,7,0.045826,4,0.321577,0.361429,9420.831739
云大(1948),云大,notion,0,1,1,0,1,1,0.016518,4,0.278724,0.3015,0
云鹤(1948),云鹤,notion,0,1,1,0,1,1,0.016752,4,0.279138,0.302165,0
互保(1948),互保,notion,0,1,1,0,1,1,0.007515,4,0.262793,0.274313,0
互怨(1948),互怨,notion,0,1,1,0,1,1,0.016518,4,0.278724,0.3015,0
互惠(1948),互惠,notion,0,1,1,0,1,1,0.016752,4,0.279138,0.302165,0
五一(1948),五一,notion,0,4,4,0,7,7,0.053241,4,0.338164,0.380496,12884.619614
五一劳动节(1948),五一劳动节,notion,0,1,1,0,1,1,0.016518,4,0.278724,0.3015,0
五一节(1948),五一节,notion,0,1,1,0,1,1,0.016752,4,0.279138,0.302165,0
五九(1948),五九,notion,0,1,1,0,1,1,0.009755,4,0.266617,0.281135,0
五二(1948),五二,notion,0,1,1,0,1,1,0.005017,4,0.257497,0.26453,0
五十(1948),五十,notion,0,1,1,0,1,1,0.009755,4,0.266617,0.281135,0
五十周年(1948),五十周年,notion,0,2,2,0,2,2,0.01727,4,0.278352,0.300956,1619.09855
五十天(1948),五十天,notion,0,1,1,0,1,1,0.011322,4,0.269061,0.285394,0
五十年(1948),五十年,notion,0,1,1,0,1,1,0.01022,4,0.267243,0.282233,0
五十年代(1948),五十年代,notion,0,1,1,0,1,1,0.002332,4,0.253398,0.256677,0
五卅(1948),五卅,notion,0,1,1,0,1,1,0.01022,4,0.267243,0.282233,0
五四运动(1948),五四运动,notion,0,1,1,0,1,1,0.009751,4,0.267186,0.282133,0
五国(1948),五国,notion,0,1,1,0,1,1,0.016752,4,0.279138,0.302165,0
五块(1948),五块,notion,0,1,1,0,1,1,0.016518,4,0.278724,0.3015,0
五大(1948),五大,notion,0,1,1,0,1,1,0.011322,4,0.269061,0.285394,0
五年计划(1948),五年计划,notion,0,3,3,0,5,5,0.029715,4,0.296312,0.328231,4411.254811
五斗(1948),五斗,notion,0,1,1,0,1,1,0.009739,4,0.265806,0.279704,0
五更(1948),五更,notion,0,1,1,0,1,1,0.009751,4,0.267186,0.282133,0
五月节(1948),五月节,notion,0,1,1,0,1,1,0.016752,4,0.279138,0.302165,0
五校(1948),五校,notion,0,1,1,0,1,1,0.009739,4,0.265806,0.279704,0
五点(1948),五点,notion,0,1,1,0,1,1,0.011322,4,0.269061,0.285394,0
五路(1948),五路,notion,0,1,1,0,1,1,0.009751,4,0.267186,0.282133,0
五项(1948),五项,notion,0,1,1,0,1,1,0.009739,4,0.265806,0.279704,0
五项原则(1948),五项原则,notion,0,1,1,0,1,1,0.005017,4,0.257497,0.26453,0
五首(1948),五首,notion,0,1,1,0,1,1,0.009739,4,0.265806,0.279704,0
亚历山大(1948),亚历山大,notion,0,1,1,0,2,2,0.009755,4,0.266617,0.281135,0
亚洲各国(1948),亚洲各国,notion,0,2,2,0,2,2,0.023995,4,0.291507,0.321221,2493.732085
亚瑟(1948),亚瑟,notion,0,1,1,0,1,1,0.009755,4,0.266617,0.281135,0
亚美利加(1948),亚美利加,notion,0,1,1,0,1,1,0.009755,4,0.266617,0.281135,0
亟应(1948),亟应,notion,0,1,1,0,1,1,0.01424,4,0.275514,0.296275,0
亟待(1948),亟待,notion,0,2,2,0,2,2,0.023995,4,0.291507,0.321221,2493.732085
亟需(1948),亟需,notion,0,1,1,0,2,2,0.01424,4,0.275514,0.296275,0
亡国(1948),亡国,notion,0,1,1,0,1,1,0.01424,4,0.275514,0.296275,0
交侵(1948),交侵,notion,0,1,1,0,1,1,0.008247,4,0.26379,0.27611,0
交卷(1948),交卷,notion,0,1,1,0,1,1,0.01424,4,0.275514,0.296275,0
交换(1948),交换,notion,0,1,1,0,3,3,0.009755,4,0.266617,0.281135,0
交流(1948),交流,notion,0,1,1,0,1,1,0.008247,4,0.26379,0.27611,0
产业(1948),产业,notion,0,1,1,0,1,1,0.01022,4,0.267243,0.282233,0
产生(1948),产生,notion,0,2,2,0,2,2,0.009735,4,0.265411,0.279061,1057.973644
产米(1948),产米,notion,0,1,1,0,1,1,0.016752,4,0.279138,0.302165,0
产销(1948),产销,notion,0,1,1,0,1,1,0.004718,4,0.258401,0.266227,0
产鱼(1948),产鱼,notion,0,1,1,0,1,1,0.016752,4,0.279138,0.302165,0
亨利(1948),亨利,notion,0,1,1,0,1,1,0.009755,4,0.266617,0.281135,0
享乐主义(1948),享乐主义,notion,0,1,1,0,1,1,0.009751,4,0.267186,0.282133,0
京华(1948),京华,notion,0,2,2,0,2,2,0.022141,4,0.285959,0.312902,1122.074528
京沪线(1948),京沪线,notion,0,1,1,0,1,1,0.016518,4,0.278724,0.3015,0
京都(1948),京都,notion,0,1,1,0,1,1,0.016752,4,0.279138,0.302165,0
亲历(1948),亲历,notion,0,1,1,0,1,1,0.009751,4,0.267186,0.282133,0
亲日(1948),亲日,notion,0,1,1,0,1,1,0.016518,4,0.278724,0.3015,0
亲民之官(1948),亲民之官,notion,0,1,1,0,1,1,0.007515,4,0.262793,0.274313,0
亲爱(1948),亲爱,notion,0,1,1,0,1,1,0.009755,4,0.266617,0.281135,0
亲美派(1948),亲美派,notion,0,1,1,0,1,1,0.005017,4,0.257497,0.26453,0
亲自(1948),亲自,notion,0,1,1,0,1,1,0.016518,4,0.278724,0.3015,0
亲自出马(1948),亲自出马,notion,0,1,1,0,1,1,0.016518,4,0.278724,0.3015,0
人世(1948),人世,notion,0,1,1,0,1,1,0.01424,4,0.275514,0.296275,0
人事(1948),人事,notion,0,2,2,0,2,2,0.015763,4,0.275232,0.295865,1348.309636
人事制度(1948),人事制度,notion,0,1,1,0,1,1,0.01424,4,0.275514,0.296275,0
人们(1948),人们,notion,0,2,2,0,2,2,0.033269,4,0.305692,0.34112,2297.98609
人像(1948),人像,notion,0,1,1,0,1,1,0.011322,4,0.269061,0.285394,0
人口(1948),人口,notion,0,2,2,0,3,3,0.022488,4,0.288152,0.31623,2102.825587
人口普查(1948),人口普查,notion,0,1,1,0,1,1,0.011322,4,0.269061,0.285394,0
人员(1948),人员,notion,0,3,3,0,3,3,0.037591,4,0.311575,0.348895,6094.140105
人士(1948),人士,notion,0,3,3,0,4,4,0.043009,4,0.318172,0.357214,5224.220047
人心(1948),人心,notion,0,6,6,0,7,7,0.060763,4,0.348195,0.391255,22045.355309
人心思变(1948),人心思变,notion,0,1,1,0,1,1,0.01424,4,0.275514,0.296275,0
人心浮动(1948),人心浮动,notion,0,1,1,0,1,1,0.008247,4,0.26379,0.27611,0
人性(1948),人性,notion,0,5,5,0,5,5,0.053769,4,0.335897,0.378056,16783.325726
人才(1948),人才,notion,0,2,2,0,2,2,0.021542,4,0.284314,0.310373,1410.419447
人才济济(1948),人才济济,notion,0,1,1,0,1,1,0.01424,4,0.275514,0.296275,0
人文主义者(1948),人文主义者,notion,0,1,1,0,1,1,0.009755,4,0.266617,0.281135,0
人权(1948),人权,notion,0,3,3,0,3,3,0.018438,4,0.273429,0.292926,1298.292089
人权宣言(1948),人权宣言,notion,0,1,1,0,1,1,0.009755,4,0.266617,0.281135,0
人材(1948),人材,notion,0,2,2,0,2,2,0.024033,4,0.291281,0.320888,2559.028705
人枪(1948),人枪,notion,0,1,1,0,1,1,0.016518,4,0.278724,0.3015,0
人格(1948),人格,notion,0,2,2,0,4,4,0.028074,4,0.296149,0.327943,1864.79583
人民代表大会(1948),人民代表大会,notion,0,1,1,0,1,1,0.016518,4,0.278724,0.3015,0
人民共和国(1948),人民共和国,notion,0,1,1,0,1,1,0.009751,4,0.267186,0.282133,0
人民政府(1948),人民政府,notion,0,1,1,0,1,1,0.016518,4,0.278724,0.3015,0
人民政权(1948),人民政权,notion,0,1,1,0,1,1,0.009755,4,0.266617,0.281135,0
人民武装(1948),人民武装,notion,0,3,3,0,11,11,0.031287,4,0.299001,0.332024,3863.30515
人民解放战争(1948),人民解放战争,notion,0,1,1,0,1,1,0.016518,4,0.278724,0.3015,0
人治(1948),人治,notion,0,1,1,0,1,1,0.008247,4,0.26379,0.27611,0
人海(1948),人海,notion,0,1,1,0,1,1,0.016752,4,0.279138,0.302165,0
人物志(1948),人物志,notion,0,1,1,0,1,1,0.016752,4,0.279138,0.302165,0
人物誌(1948),人物誌,notion,0,1,1,0,1,1,0.008247,4,0.26379,0.27611,0
人生(1948),人生,notion,0,1,1,0,1,1,0.009739,4,0.265806,0.279704,0
人生哲学(1948),人生哲学,notion,0,1,1,0,1,1,0.007515,4,0.262793,0.274313,0
人生态度(1948),人生态度,notion,0,1,1,0,1,1,0.004718,4,0.258401,0.266227,0
人的(1948),人的,notion,0,1,1,0,1,1,0.009755,4,0.266617,0.281135,0
人祸(1948),人祸,notion,0,1,1,0,1,1,0.016752,4,0.279138,0.302165,0
人缴(1948),人缴,notion,0,1,1,0,1,1,0.016518,4,0.278724,0.3015,0
人群(1948),人群,notion,0,1,1,0,1,1,0.016752,4,0.279138,0.302165,0
人选(1948),人选,notion,0,2,2,0,3,3,0.024461,4,0.291756,0.321587,2304.72473
人间地狱(1948),人间地狱,notion,0,1,1,0,1,1,0.009739,4,0.265806,0.279704,0
什感(1948),什感,notion,0,1,1,0,1,1,0.009751,4,0.267186,0.282133,0
什谈(1948),什谈,notion,0,1,1,0,1,1,0.005017,4,0.257497,0.26453,0
仁慈(1948),仁慈,notion,0,1,1,0,1,1,0.005017,4,0.257497,0.26453,0
仇者(1948),仇者,notion,0,1,1,0,1,1,0.016518,4,0.278724,0.3015,0
今夏(1948),今夏,notion,0,1,1,0,1,1,0.011322,4,0.269061,0.285394,0
今天(1948),今天,notion,0,4,4,0,6,6,0.025037,4,0.282284,0.307323,2931.818001
今年(1948),今年,notion,0,4,4,0,4,4,0.034002,4,0.304799,0.340033,9443.504797
今昔(1948),今昔,notion,0,2,2,0,3,3,0.021535,4,0.28397,0.309841,889.229879
今罪言(1948),今罪言,notion,0,2,2,0,2,2,0.008698,4,0.258507,0.266483,0.569098
从七杀(1948),从七杀,notion,0,1,1,0,1,1,0.01022,4,0.267243,0.282233,0
从事(1948),从事,notion,0,1,1,0,1,1,0.009751,4,0.267186,0.282133,0
从伪(1948),从伪,notion,0,1,1,0,1,1,0.005017,4,0.257497,0.26453,0
从何而来(1948),从何而来,notion,0,1,1,0,1,1,0.016752,4,0.279138,0.302165,0
从大(1948),从大,notion,0,1,1,0,1,1,0.009751,4,0.267186,0.282133,0
从媚(1948),从媚,notion,0,1,1,0,1,1,0.005017,4,0.257497,0.26453,0
从平(1948),从平,notion,0,1,1,0,1,1,0.016518,4,0.278724,0.3015,0
从根本上(1948),从根本上,notion,0,1,1,0,1,1,0.01022,4,0.267243,0.282233,0
从洋(1948),从洋,notion,0,1,1,0,1,1,0.009751,4,0.267186,0.282133,0
从米(1948),从米,notion,0,1,1,0,1,1,0.016752,4,0.279138,0.302165,0
从纪德(1948),从纪德,notion,0,1,1,0,1,1,0.009755,4,0.266617,0.281135,0
从金(1948),从金,notion,0,1,1,0,1,1,0.016752,4,0.279138,0.302165,0
仓促(1948),仓促,notion,0,1,1,0,1,1,0.008247,4,0.26379,0.27611,0
仓卒(1948),仓卒,notion,0,1,1,0,1,1,0.008247,4,0.26379,0.27611,0
付出(1948),付出,notion,0,1,1,0,1,1,0.016518,4,0.278724,0.3015,0
代价(1948),代价,notion,0,4,4,0,4,4,0.043077,4,0.316217,0.35484,7864.592518
代替(1948),代替,notion,0,2,2,0,2,2,0.019506,4,0.282731,0.307911,1903.779982
代电(1948),代电,notion,0,1,1,0,1,1,0.011322,4,0.269061,0.285394,0
代表团(1948),代表团,notion,0,3,3,0,3,3,0.033772,4,0.304503,0.339578,5420.300526
代表大会(1948),代表大会,notion,0,4,4,0,5,5,0.04121,4,0.318199,0.357303,12514.502453
代言人(1948),代言人,notion,0,1,1,0,1,1,0.016752,4,0.279138,0.302165,0
代议制(1948),代议制,notion,0,1,1,0,3,3,0.011322,4,0.269061,0.285394,0
令下(1948),令下,notion,0,1,1,0,1,1,0.016752,4,0.279138,0.302165,0
令人(1948),令人,notion,0,2,2,0,2,2,0.030758,4,0.303347,0.337959,2812.221703
以为(1948),以为,notion,0,1,1,0,1,1,0.009751,4,0.267186,0.282133,0
以内(1948),以内,notion,0,1,1,0,1,1,0.016518,4,0.278724,0.3015,0
以前(1948),以前,notion,0,1,1,0,1,1,0.01424,4,0.275514,0.296275,0
以办(1948),以办,notion,0,1,1,0,1,1,0.007515,4,0.262793,0.274313,0
以及(1948),以及,notion,0,1,1,0,1,1,0.004718,4,0.258401,0.266227,0
以后(1948),以后,notion,0,9,9,0,13,13,0.095749,4,0.412643,0.447491,55880.265042
以孔(1948),以孔,notion,0,1,1,0,1,1,0.01022,4,0.267243,0.282233,0
以战(1948),以战,notion,0,1,1,0,1,1,0.011322,4,0.269061,0.285394,0
以明(1948),以明,notion,0,1,1,0,1,1,0.008247,4,0.26379,0.27611,0
以来(1948),以来,notion,0,1,1,0,1,1,0.009755,4,0.266617,0.281135,0
以爱(1948),以爱,notion,0,1,1,0,1,1,0.016752,4,0.279138,0.302165,0
以物(1948),以物,notion,0,1,1,0,1,1,0.004718,4,0.258401,0.266227,0
以绳(1948),以绳,notion,0,1,1,0,1,1,0.008247,4,0.26379,0.27611,0
以美(1948),以美,notion,0,1,1,0,1,1,0.01022,4,0.267243,0.282233,0
仪仗队(1948),仪仗队,notion,0,1,1,0,1,1,0.009755,4,0.266617,0.281135,0
仰光(1948),仰光,notion,0,1,1,0,3,3,0.016518,4,0.278724,0.3015,0
仰望(1948),仰望,notion,0,1,1,0,1,1,0.01022,4,0.267243,0.282233,0
仲夏(1948),仲夏,notion,0,1,1,0,1,1,0.016752,4,0.279138,0.302165,0
仲夏夜(1948),仲夏夜,notion,0,1,1,0,1,1,0.016752,4,0.279138,0.302165,0
仲秋(1948),仲秋,notion,0,1,1,0,1,1,0.016518,4,0.278724,0.3015,0
价值(1948),价值,notion,0,4,4,0,4,4,0.049595,4,0.333659,0.375505,12971.949281
价新评(1948),价新评,notion,0,1,1,0,1,1,0.01424,4,0.275514,0.296275,0
价格(1948),价格,notion,0,2,2,0,2,2,0.022488,4,0.288152,0.31623,2102.825587
价涨(1948),价涨,notion,0,1,1,0,1,1,0.01424,4,0.275514,0.296275,0
价钱(1948),价钱,notion,0,1,1,0,1,1,0.016518,4,0.278724,0.3015,0
任何(1948),任何,notion,0,1,1,0,1,1,0.008247,4,0.26379,0.27611,0
任务(1948),任务,notion,0,7,7,0,17,17,0.064166,4,0.352442,0.395636,30480.433839
任意(1948),任意,notion,0,1,1,0,1,1,0.01022,4,0.267243,0.282233,0
任择(1948),任择,notion,0,1,1,0,1,1,0.016518,4,0.278724,0.3015,0
任用(1948),任用,notion,0,1,1,0,1,1,0.004718,4,0.258401,0.266227,0
仿徨(1948),仿徨,notion,0,1,1,0,1,1,0.002332,4,0.253398,0.256677,0
企业(1948),企业,notion,0,2,2,0,2,2,0.009735,4,0.265411,0.279061,1057.973644
企图(1948),企图,notion,0,2,2,0,2,2,0.024461,4,0.291756,0.321587,2304.72473
企待(1948),企待,notion,0,1,1,0,1,1,0.007515,4,0.262793,0.274313,0
伊拉克(1948),伊拉克,notion,0,1,1,0,1,1,0.009739,4,0.265806,0.279704,0
伊登(1948),伊登,notion,0,1,1,0,1,1,0.009739,4,0.265806,0.279704,0
伏击战(1948),伏击战,notion,0,1,1,0,1,1,0.009751,4,0.267186,0.282133,0
休养地(1948),休养地,notion,0,1,1,0,1,1,0.009755,4,0.266617,0.281135,0
休战(1948),休战,notion,0,2,2,0,2,2,0.008698,4,0.258507,0.266483,0.569098
休矣(1948),休矣,notion,0,1,1,0,1,1,0.008247,4,0.26379,0.27611,0
众醉独醒(1948),众醉独醒,notion,0,1,1,0,1,1,0.009755,4,0.266617,0.281135,0
众院(1948),众院,notion,0,1,1,0,1,1,0.009755,4,0.266617,0.281135,0
优势(1948),优势,notion,0,1,1,0,1,1,0.016518,4,0.278724,0.3015,0
伙头(1948),伙头,notion,0,1,1,0,1,1,0.009751,4,0.267186,0.282133,0
伙食(1948),伙食,notion,0,1,1,0,1,1,0.009751,4,0.267186,0.282133,0
会场(1948),会场,notion,0,1,1,0,1,1,0.008247,4,0.26379,0.27611,0
会稽山(1948),会稽山,notion,0,1,1,0,1,1,0.016518,4,0.278724,0.3015,0
会见(1948),会见,notion,0,1,1,0,1,1,0.016518,4,0.278724,0.3015,0
会记(1948),会记,notion,0,1,1,0,1,1,0.016752,4,0.279138,0.302165,0
会长(1948),会长,notion,0,1,1,0,1,1,0.007515,4,0.262793,0.274313,0
伟大胜利(1948),伟大胜利,notion,0,1,1,0,1,1,0.016518,4,0.278724,0.3015,0
传讯(1948),传讯,notion,0,1,1,0,1,1,0.01022,4,0.267243,0.282233,0
传记(1948),传记,notion,0,3,3,0,4,4,0.032242,4,0.304158,0.339112,6253.390047
传说(1948),传说,notion,0,1,1,0,1,1,0.016518,4,0.278724,0.3015,0
传载(1948),传载,notion,0,1,1,0,1,1,0.01424,4,0.275514,0.296275,0
伤害(1948),伤害,notion,0,1,1,0,1,1,0.01424,4,0.275514,0.296275,0
伤心(1948),伤心,notion,0,1,1,0,1,1,0.016752,4,0.279138,0.302165,0
伦着(1948),伦着,notion,0,1,1,0,1,1,0.009739,4,0.265806,0.279704,0
伪装(1948),伪装,notion,0,2,2,0,2,2,0.013636,4,0.271042,0.288844,803.589456
伪谬(1948),伪谬,notion,0,1,1,0,1,1,0.007515,4,0.262793,0.274313,0
估价(1948),估价,notion,0,2,2,0,2,2,0.033269,4,0.305692,0.34112,2297.98609
估量(1948),估量,notion,0,1,1,0,1,1,0.011322,4,0.269061,0.285394,0
伴侣(1948),伴侣,notion,0,1,1,0,1,1,0.011322,4,0.269061,0.285394,0
伸向(1948),伸向,notion,0,1,1,0,1,1,0.01424,4,0.275514,0.296275,0
伸张正义(1948),伸张正义,notion,0,1,1,0,1,1,0.016752,4,0.279138,0.302165,0
但愿(1948),但愿,notion,0,1,1,0,1,1,0.008247,4,0.26379,0.27611,0
佈告(1948),佈告,notion,0,1,1,0,1,1,0.016518,4,0.278724,0.3015,0
佈置(1948),佈置,notion,0,1,1,0,1,1,0.016518,4,0.278724,0.3015,0
低估(1948),低估,notion,0,1,1,0,1,1,0.01424,4,0.275514,0.296275,0
低气压(1948),低气压,notion,0,1,1,0,1,1,0.016752,4,0.279138,0.302165,0
低调(1948),低调,notion,0,4,4,0,4,4,0.023636,4,0.282624,0.307855,5161.76868
体制(1948),体制,notion,0,1,1,0,1,1,0.016752,4,0.279138,0.302165,0
体育(1948),体育,notion,0,2,2,0,2,2,0.028074,4,0.296149,0.327943,1864.79583
体认(1948),体认,notion,0,1,1,0,1,1,0.01424,4,0.275514,0.296275,0
体难(1948),体难,notion,0,1,1,0,1,1,0.009751,4,0.267186,0.282133,0
体验(1948),体验,notion,0,1,1,0,1,1,0.004718,4,0.258401,0.266227,0
何为(1948),何为,notion,0,1,1,0,1,1,0.01424,4,0.275514,0.296275,0
何以(1948),何以,notion,0,3,3,0,3,3,0.029789,4,0.296032,0.327832,4216.728645
何其芳(1948),何其芳,notion,0,1,1,0,1,1,0.011322,4,0.269061,0.285394,0
何在(1948),何在,notion,0,3,3,0,3,3,0.033772,4,0.304503,0.339578,5420.300526
何妨(1948),何妨,notion,0,1,1,0,1,1,0.01424,4,0.275514,0.296275,0
何必(1948),何必,notion,0,1,1,0,1,1,0.01424,4,0.275514,0.296275,0
何时(1948),何时,notion,0,2,2,0,2,2,0.019569,4,0.280598,0.30455,1193.220239
何来(1948),何来,notion,0,1,1,0,1,1,0.016752,4,0.279138,0.302165,0
何爲(1948),何爲,notion,0,1,1,0,1,1,0.01424,4,0.275514,0.296275,0
何辜(1948),何辜,notion,0,1,1,0,1,1,0.011322,4,0.269061,0.285394,0
余德谋(1948),余德谋,notion,0,1,1,0,1,1,0.009751,4,0.267186,0.282133,0
余所(1948),余所,notion,0,1,1,0,1,1,0.01424,4,0.275514,0.296275,0
余绪(1948),余绪,notion,0,1,1,0,1,1,0.01022,4,0.267243,0.282233,0
佚史(1948),佚史,notion,0,1,1,0,1,1,0.007515,4,0.262793,0.274313,0
佛尔(1948),佛尔,notion,0,1,1,0,1,1,0.016752,4,0.279138,0.302165,0
佛山(1948),佛山,notion,0,1,1,0,1,1,0.009751,4,0.267186,0.282133,0
佛拉(1948),佛拉,notion,0,1,1,0,1,1,0.009755,4,0.266617,0.281135,0
佛朗哥(1948),佛朗哥,notion,0,2,2,0,6,6,0.026507,4,0.294224,0.325181,2012.895914
佛朗歌(1948),佛朗歌,notion,0,1,1,0,1,1,0.009755,4,0.266617,0.281135,0
作为(1948),作为,notion,0,1,1,0,1,1,0.007515,4,0.262793,0.274313,0
作主(1948),作主,notion,0,1,1,0,1,1,0.01022,4,0.267243,0.282233,0
作呕(1948),作呕,notion,0,1,1,0,1,1,0.016518,4,0.278724,0.3015,0
作品集(1948),作品集,notion,0,1,1,0,1,1,0.016752,4,0.279138,0.302165,0
作战(1948),作战,notion,0,1,1,0,1,1,0.01022,4,0.267243,0.282233,0
作风(1948),作风,notion,0,5,5,0,5,5,0.061979,4,0.35925,0.402247,25921.690064
佩弦(1948),佩弦,notion,0,2,2,0,2,2,0.008698,4,0.258507,0.266483,0.569098
例外(1948),例外,notion,0,2,2,0,2,2,0.01727,4,0.278352,0.300956,1619.09855
例證(1948),例證,notion,0,1,1,0,1,1,0.008247,4,0.26379,0.27611,0
例证(1948),例证,notion,0,1,1,0,1,1,0.009755,4,0.266617,0.281135,0
供应(1948),供应,notion,0,1,1,0,1,1,0.01424,4,0.275514,0.296275,0
供词(1948),供词,notion,0,1,1,0,1,1,0.008247,4,0.26379,0.27611,0
依旧(1948),依旧,notion,0,1,1,0,1,1,0.011322,4,0.269061,0.285394,0
依法(1948),依法,notion,0,1,1,0,1,1,0.01424,4,0.275514,0.296275,0
依照(1948),依照,notion,0,1,1,0,1,1,0.009755,4,0.266617,0.281135,0
依靠(1948),依靠,notion,0,1,1,0,1,1,0.009751,4,0.267186,0.282133,0
侧影(1948),侧影,notion,0,1,1,0,1,1,0.008247,4,0.26379,0.27611,0
侧评(1948),侧评,notion,0,1,1,0,1,1,0.005389,4,0.25849,0.266394,0
侧闻(1948),侧闻,notion,0,1,1,0,1,1,0.008247,4,0.26379,0.27611,0
侧面(1948),侧面,notion,0,1,1,0,1,1,0.011322,4,0.269061,0.285394,0
侨商(1948),侨商,notion,0,1,1,0,1,1,0.016518,4,0.278724,0.3015,0
侨团(1948),侨团,notion,0,1,1,0,1,1,0.005017,4,0.257497,0.26453,0
侨情(1948),侨情,notion,0,2,2,0,2,2,0.030992,4,0.303936,0.338757,2912.385696
侨眷(1948),侨眷,notion,0,1,1,0,1,1,0.009751,4,0.267186,0.282133,0
侮辱(1948),侮辱,notion,0,2,2,0,2,2,0.033269,4,0.305692,0.34112,2297.98609
侯外庐(1948),侯外庐,notion,0,1,1,0,1,1,0.01424,4,0.275514,0.296275,0
侵华(1948),侵华,notion,0,2,2,0,2,2,0.030758,4,0.303347,0.337959,2812.221703
侵台(1948),侵台,notion,0,1,1,0,1,1,0.016518,4,0.278724,0.3015,0
侵犯(1948),侵犯,notion,0,2,2,0,2,2,0.026491,4,0.291937,0.321853,1403.825067
侵略战争(1948),侵略战争,notion,0,1,1,0,1,1,0.01424,4,0.275514,0.296275,0
便宜(1948),便宜,notion,0,1,1,0,1,1,0.008247,4,0.26379,0.27611,0
便是(1948),便是,notion,0,1,1,0,1,1,0.009755,4,0.266617,0.281135,0
俄人(1948),俄人,notion,0,1,1,0,1,1,0.01022,4,0.267243,0.282233,0
俄国(1948),俄国,notion,0,2,2,0,4,4,0.023995,4,0.291507,0.321221,2493.732085
俄罗斯(1948),俄罗斯,notion,0,1,1,0,3,3,0.009755,4,0.266617,0.281135,0
俗传(1948),俗传,notion,0,1,1,0,1,1,0.007515,4,0.262793,0.274313,0
俘虏(1948),俘虏,notion,0,1,1,0,1,1,0.005017,4,0.257497,0.26453,0
保健(1948),保健,notion,0,1,1,0,1,1,0.009751,4,0.267186,0.282133,0
保加利亚(1948),保加利亚,notion,0,2,2,0,2,2,0.014772,4,0.272635,0.291539,771.57337
保卫者(1948),保卫者,notion,0,1,1,0,1,1,0.009755,4,0.266617,0.281135,0
保大(1948),保大,notion,0,1,1,0,1,1,0.01424,4,0.275514,0.296275,0
保姆(1948),保姆,notion,0,1,1,0,1,1,0.009751,4,0.267186,0.282133,0
保守政府(1948),保守政府,notion,0,1,1,0,1,1,0.008247,4,0.26379,0.27611,0
保安(1948),保安,notion,0,1,1,0,1,1,0.009751,4,0.267186,0.282133,0
保校(1948),保校,notion,0,1,1,0,1,1,0.004718,4,0.258401,0.266227,0
保甲(1948),保甲,notion,0,1,1,0,1,1,0.008247,4,0.26379,0.27611,0
保皇(1948),保皇,notion,0,1,1,0,1,1,0.009755,4,0.266617,0.281135,0
保證(1948),保證,notion,0,1,1,0,1,1,0.01424,4,0.275514,0.296275,0
保警(1948),保警,notion,0,1,1,0,1,1,0.009739,4,0.265806,0.279704,0
保镖(1948),保镖,notion,0,1,1,0,1,1,0.009755,4,0.266617,0.281135,0
保障(1948),保障,notion,0,4,4,0,4,4,0.032678,4,0.298028,0.330716,5702.451231
保障人权(1948),保障人权,notion,0,3,3,0,3,3,0.034007,4,0.303691,0.33848,4922.321601
俞鸿钧(1948),俞鸿钧,notion,0,1,1,0,1,1,0.008247,4,0.26379,0.27611,0
信仰(1948),信仰,notion,0,4,4,0,4,4,0.032122,4,0.298431,0.331281,6483.09475
信合社(1948),信合社,notion,0,1,1,0,1,1,0.004718,4,0.258401,0.266227,0
信心(1948),信心,notion,0,2,2,0,3,3,0.023992,4,0.29271,0.322985,3168.205568
信用合作(1948),信用合作,notion,0,1,1,0,1,1,0.004718,4,0.258401,0.266227,0
信箱(1948),信箱,notion,0,1,1,0,1,1,0.016518,4,0.278724,0.3015,0
信行(1948),信行,notion,0,1,1,0,1,1,0.005017,4,0.257497,0.26453,0
信袋(1948),信袋,notion,0,1,1,0,1,1,0.011322,4,0.269061,0.285394,0
信通(1948),信通,notion,0,1,1,0,1,1,0.009751,4,0.267186,0.282133,0
俨然(1948),俨然,notion,0,1,1,0,1,1,0.011322,4,0.269061,0.285394,0
修养(1948),修养,notion,0,1,1,0,1,1,0.016752,4,0.279138,0.302165,0
修改(1948),修改,notion,0,2,2,0,2,2,0.026272,4,0.29319,0.323683,1793.896368
俱乐部(1948),俱乐部,notion,0,1,1,0,1,1,0.01022,4,0.267243,0.282233,0
倒行逆施(1948),倒行逆施,notion,0,1,1,0,1,1,0.005017,4,0.257497,0.26453,0
候选(1948),候选,notion,0,1,1,0,1,1,0.007515,4,0.262793,0.274313,0
候选人(1948),候选人,notion,0,2,2,0,2,2,0.014938,4,0.275333,0.296031,2167.523118
候鸟(1948),候鸟,notion,0,1,1,0,1,1,0.016518,4,0.278724,0.3015,0
借屍(1948),借屍,notion,0,1,1,0,1,1,0.016518,4,0.278724,0.3015,0
借款(1948),借款,notion,0,1,1,0,1,1,0.009739,4,0.265806,0.279704,0
债券(1948),债券,notion,0,2,2,0,2,2,0.019569,4,0.280598,0.30455,1193.220239
值得(1948),值得,notion,0,2,2,0,2,2,0.026503,4,0.295799,0.327444,2668.961321
值得注意(1948),值得注意,notion,0,1,1,0,1,1,0.008247,4,0.26379,0.27611,0
倾销(1948),倾销,notion,0,2,2,0,2,2,0.015238,4,0.27323,0.292537,773.838752
假使(1948),假使,notion,0,1,1,0,1,1,0.009739,4,0.265806,0.279704,0
假如(1948),假如,notion,0,1,1,0,1,1,0.01424,4,0.275514,0.296275,0
假定(1948),假定,notion,0,1,1,0,1,1,0.008247,4,0.26379,0.27611,0
假想(1948),假想,notion,0,1,1,0,1,1,0.016752,4,0.279138,0.302165,0
偏向(1948),偏向,notion,0,2,2,0,3,3,0.021073,4,0.285785,0.312636,2242.44705
偏差(1948),偏差,notion,0,1,1,0,1,1,0.002332,4,0.253398,0.256677,0
偏流(1948),偏流,notion,0,1,1,0,1,1,0.002332,4,0.253398,0.256677,0
偏而(1948),偏而,notion,0,1,1,0,1,1,0.016752,4,0.279138,0.302165,0
偏见(1948),偏见,notion,0,1,1,0,1,1,0.01022,4,0.267243,0.282233,0
做事(1948),做事,notion,0,2,2,0,2,2,0.021469,4,0.287095,0.314632,2527.522512
做些(1948),做些,notion,0,2,2,0,2,2,0.016039,4,0.2771,0.298926,2122.22906
做些什(1948),做些什,notion,0,1,1,0,1,1,0.01424,4,0.275514,0.296275,0
做人(1948),做人,notion,0,2,2,0,2,2,0.014469,4,0.27493,0.295366,1965.542095
做学教(1948),做学教,notion,0,1,1,0,1,1,0.004718,4,0.258401,0.266227,0
做文章(1948),做文章,notion,0,1,1,0,1,1,0.009751,4,0.267186,0.282133,0
做法(1948),做法,notion,0,1,1,0,1,1,0.01424,4,0.275514,0.296275,0
做起(1948),做起,notion,0,1,1,0,1,1,0.009751,4,0.267186,0.282133,0
停刊(1948),停刊,notion,0,1,1,0,2,2,0.016752,4,0.279138,0.302165,0
停战协定(1948),停战协定,notion,0,1,1,0,1,1,0.009755,4,0.266617,0.281135,0
停摆(1948),停摆,notion,0,1,1,0,1,1,0.008247,4,0.26379,0.27611,0
停放(1948),停放,notion,0,2,2,0,2,2,0.019569,4,0.280598,0.30455,1193.220239
停止(1948),停止,notion,0,3,3,0,4,4,0.0342,4,0.305991,0.341575,5608.68156
停滞(1948),停滞,notion,0,1,1,0,1,1,0.01022,4,0.267243,0.282233,0
停驶(1948),停驶,notion,0,1,1,0,1,1,0.01424,4,0.275514,0.296275,0
健儿(1948),健儿,notion,0,1,1,0,1,1,0.01424,4,0.275514,0.296275,0
健全(1948),健全,notion,0,2,2,0,2,2,0.014769,4,0.273708,0.293336,1042.722106
健康(1948),健康,notion,0,2,2,0,2,2,0.026503,4,0.295799,0.327444,2668.961321
健忘(1948),健忘,notion,0,1,1,0,1,1,0.016752,4,0.279138,0.302165,0
健社(1948),健社,notion,0,1,1,0,1,1,0.004718,4,0.258401,0.266227,0
偶然(1948),偶然,notion,0,1,1,0,1,1,0.01424,4,0.275514,0.296275,0
偶笔(1948),偶笔,notion,0,1,1,0,1,1,0.016752,4,0.279138,0.302165,0
偶谈(1948),偶谈,notion,0,1,1,0,1,1,0.009751,4,0.267186,0.282133,0
傀儡(1948),傀儡,notion,0,1,1,0,1,1,0.016518,4,0.278724,0.3015,0
傅作义(1948),傅作义,notion,0,4,4,0,7,7,0.043298,4,0.321055,0.360797,11027.062833
傑作(1948),傑作,notion,0,1,1,0,1,1,0.01424,4,0.275514,0.296275,0
储安平(1948),储安平,notion,0,1,1,0,1,1,0.01424,4,0.275514,0.296275,0
储着(1948),储着,notion,0,1,1,0,1,1,0.007515,4,0.262793,0.274313,0
催紧(1948),催紧,notion,0,1,1,0,1,1,0.009739,4,0.265806,0.279704,0
傲慢(1948),傲慢,notion,0,1,1,0,1,1,0.01022,4,0.267243,0.282233,0
儿女(1948),儿女,notion,0,1,1,0,1,1,0.011322,4,0.269061,0.285394,0
儿子(1948),儿子,notion,0,1,1,0,1,1,0.009751,4,0.267186,0.282133,0
儿孙(1948),儿孙,notion,0,1,1,0,1,1,0.007515,4,0.262793,0.274313,0
儿戏(1948),儿戏,notion,0,1,1,0,1,1,0.01022,4,0.267243,0.282233,0
儿皇帝(1948),儿皇帝,notion,0,2,2,0,2,2,0.019972,4,0.283949,0.309807,2243.008915
儿童(1948),儿童,notion,0,2,2,0,2,2,0.026257,4,0.292073,0.322053,1522.40889
儿童节(1948),儿童节,notion,0,3,3,0,3,3,0.025779,4,0.291235,0.320877,5192.260081
允许(1948),允许,notion,0,2,2,0,2,2,0.015141,4,0.274909,0.295333,1225.700317
元亡于(1948),元亡于,notion,0,1,1,0,1,1,0.007515,4,0.262793,0.274313,0
元旦(1948),元旦,notion,0,1,1,0,1,1,0.016518,4,0.278724,0.3015,0
元首(1948),元首,notion,0,2,2,0,2,2,0.026272,4,0.29319,0.323683,1793.896368
兄弟(1948),兄弟,notion,0,2,2,0,3,3,0.026269,4,0.293695,0.324415,1931.353166
充足(1948),充足,notion,0,1,1,0,1,1,0.016518,4,0.278724,0.3015,0
先世(1948),先世,notion,0,1,1,0,1,1,0.01424,4,0.275514,0.296275,0
先例(1948),先例,notion,0,1,1,0,1,1,0.01424,4,0.275514,0.296275,0
先后(1948),先后,notion,0,1,1,0,1,1,0.01022,4,0.267243,0.282233,0
先知(1948),先知,notion,0,1,1,0,1,1,0.01424,4,0.275514,0.296275,0
先自孔(1948),先自孔,notion,0,1,1,0,1,1,0.008247,4,0.26379,0.27611,0
先要(1948),先要,notion,0,1,1,0,1,1,0.004718,4,0.258401,0.266227,0
先觉(1948),先觉,notion,0,1,1,0,1,1,0.016752,4,0.279138,0.302165,0
先进(1948),先进,notion,0,1,1,0,1,1,0.016752,4,0.279138,0.302165,0
先锋(1948),先锋,notion,0,1,1,0,1,1,0.009751,4,0.267186,0.282133,0
先驱者(1948),先驱者,notion,0,1,1,0,1,1,0.007515,4,0.262793,0.274313,0
光和热(1948),光和热,notion,0,1,1,0,1,1,0.016518,4,0.278724,0.3015,0
光复(1948),光复,notion,0,1,1,0,1,1,0.016752,4,0.279138,0.302165,0
光复会(1948),光复会,notion,0,1,1,0,1,1,0.016752,4,0.279138,0.302165,0
光复节(1948),光复节,notion,0,1,1,0,1,1,0.004718,4,0.258401,0.266227,0
光明(1948),光明,notion,0,4,4,0,7,7,0.048745,4,0.330663,0.372111,11884.431143
光明面(1948),光明面,notion,0,2,2,0,2,2,0.022488,4,0.288152,0.31623,2102.825587
光洋(1948),光洋,notion,0,1,1,0,1,1,0.016518,4,0.278724,0.3015,0
光芒万丈(1948),光芒万丈,notion,0,1,1,0,1,1,0.016518,4,0.278724,0.3015,0
光荣(1948),光荣,notion,0,4,4,0,5,5,0.052776,4,0.337193,0.379431,12608.87284
光说(1948),光说,notion,0,1,1,0,1,1,0.009751,4,0.267186,0.282133,0
克拉索夫(1948),克拉索夫,notion,0,1,1,0,2,2,0.009755,4,0.266617,0.281135,0
克斯(1948),克斯,notion,0,1,1,0,1,1,0.009755,4,0.266617,0.281135,0
克服(1948),克服,notion,0,3,3,0,3,3,0.028589,4,0.297556,0.329995,6008.393411
克服困难(1948),克服困难,notion,0,1,1,0,1,1,0.016518,4,0.278724,0.3015,0
克里姆林宫(1948),克里姆林宫,notion,0,1,1,0,1,1,0.005017,4,0.257497,0.26453,0
克难(1948),克难,notion,0,1,1,0,1,1,0.01022,4,0.267243,0.282233,0
兑现(1948),兑现,notion,0,1,1,0,1,1,0.005389,4,0.25849,0.266394,0
兖州(1948),兖州,notion,0,1,1,0,1,1,0.011322,4,0.269061,0.285394,0
党人(1948),党人,notion,0,1,1,0,1,1,0.005389,4,0.25849,0.266394,0
党内(1948),党内,notion,0,1,1,0,1,1,0.009755,4,0.266617,0.281135,0
党务(1948),党务,notion,0,2,2,0,2,2,0.024461,4,0.291756,0.321587,2304.72473
党史(1948),党史,notion,0,1,1,0,2,2,0.009755,4,0.266617,0.281135,0
党员(1948),党员,notion,0,1,1,0,2,2,0.007515,4,0.262793,0.274313,0
党派(1948),党派,notion,0,1,1,0,1,1,0.016752,4,0.279138,0.302165,0
党籍(1948),党籍,notion,0,1,1,0,1,1,0.011322,4,0.269061,0.285394,0
党纪(1948),党纪,notion,0,1,1,0,1,1,0.01424,4,0.275514,0.296275,0
兜圈子(1948),兜圈子,notion,0,1,1,0,1,1,0.009751,4,0.267186,0.282133,0
入侵(1948),入侵,notion,0,1,1,0,1,1,0.01022,4,0.267243,0.282233,0
入关(1948),入关,notion,0,1,1,0,2,2,0.016518,4,0.278724,0.3015,0
入康(1948),入康,notion,0,1,1,0,1,1,0.01424,4,0.275514,0.296275,0
入浙(1948),入浙,notion,0,1,1,0,1,1,0.01022,4,0.267243,0.282233,0
入社(1948),入社,notion,0,1,1,0,1,1,0.009739,4,0.265806,0.279704,0
入越(1948),入越,notion,0,1,1,0,1,1,0.01424,4,0.275514,0.296275,0
入选(1948),入选,notion,0,1,1,0,1,1,0.011322,4,0.269061,0.285394,0
全世界(1948),全世界,notion,0,2,2,0,2,2,0.026269,4,0.293695,0.324415,1931.353166
全会(1948),全会,notion,0,1,1,0,1,1,0.009755,4,0.266617,0.281135,0
全国性(1948),全国性,notion,0,2,2,0,2,2,0.008698,4,0.258507,0.266483,0.569098
全国总工会(1948),全国总工会,notion,0,1,1,0,1,1,0.016518,4,0.278724,0.3015,0
全市(1948),全市,notion,0,1,1,0,1,1,0.016752,4,0.279138,0.302165,0
全椒(1948),全椒,notion,0,1,1,0,1,1,0.01424,4,0.275514,0.296275,0
全民(1948),全民,notion,0,1,1,0,2,2,0.009755,4,0.266617,0.281135,0
全盘(1948),全盘,notion,0,2,2,0,2,2,0.021542,4,0.284314,0.310373,1410.419447
全运会(1948),全运会,notion,0,1,1,0,1,1,0.016752,4,0.279138,0.302165,0
全部(1948),全部,notion,0,1,1,0,1,1,0.016518,4,0.278724,0.3015,0
全面(1948),全面,notion,0,4,4,0,5,5,0.057249,4,0.345187,0.388016,12947.510365
全面性(1948),全面性,notion,0,1,1,0,1,1,0.01424,4,0.275514,0.296275,0
全面战争(1948),全面战争,notion,0,2,2,0,2,2,0.024765,4,0.291552,0.321288,2097.245087
八一(1948),八一,notion,0,4,4,0,4,4,0.03567,4,0.300893,0.334709,4674.496605
八十三(1948),八十三,notion,0,1,1,0,1,1,0.016752,4,0.279138,0.302165,0
八十四(1948),八十四,notion,0,1,1,0,1,1,0.009751,4,0.267186,0.282133,0
八十里(1948),八十里,notion,0,1,1,0,1,1,0.016518,4,0.278724,0.3015,0
八千(1948),八千,notion,0,1,1,0,1,1,0.016518,4,0.278724,0.3015,0
八卦(1948),八卦,notion,0,1,1,0,1,1,0.004718,4,0.258401,0.266227,0
八字(1948),八字,notion,0,1,1,0,1,1,0.016518,4,0.278724,0.3015,0
八年(1948),八年,notion,0,1,1,0,1,1,0.01022,4,0.267243,0.282233,0
八根(1948),八根,notion,0,1,1,0,1,1,0.011322,4,0.269061,0.285394,0
八章(1948),八章,notion,0,1,1,0,1,1,0.016518,4,0.278724,0.3015,0
八路军(1948),八路军,notion,0,1,1,0,1,1,0.016518,4,0.278724,0.3015,0
公会(1948),公会,notion,0,1,1,0,1,1,0.011322,4,0.269061,0.285394,0
公佈(1948),公佈,notion,0,2,2,0,2,2,0.027839,4,0.295962,0.327676,1920.33989
公债(1948),公债,notion,0,1,1,0,1,1,0.01424,4,0.275514,0.296275,0
公务员(1948),公务员,notion,0,2,2,0,3,3,0.019569,4,0.280598,0.30455,1193.220239
公司(1948),公司,notion,0,2,2,0,3,3,0.021235,4,0.286701,0.314033,2523.953101
公园(1948),公园,notion,0,1,1,0,1,1,0.016752,4,0.279138,0.302165,0
公家(1948),公家,notion,0,2,2,0,2,2,0.008698,4,0.258507,0.266483,0.569098
公布(1948),公布,notion,0,1,1,0,1,1,0.009739,4,0.265806,0.279704,0
公开(1948),公开,notion,0,2,2,0,2,2,0.022488,4,0.288152,0.31623,2102.825587
公开竞选(1948),公开竞选,notion,0,1,1,0,1,1,0.004718,4,0.258401,0.266227,0
公意(1948),公意,notion,0,1,1,0,1,1,0.016518,4,0.278724,0.3015,0
公报(1948),公报,notion,0,2,2,0,2,2,0.008698,4,0.258507,0.266483,0.569098
公教人员(1948),公教人员,notion,0,1,1,0,1,1,0.01022,4,0.267243,0.282233,0
公有(1948),公有,notion,0,1,1,0,1,1,0.008247,4,0.26379,0.27611,0
公权(1948),公权,notion,0,2,2,0,2,2,0.017736,4,0.278993,0.301988,1631.559673
公樸(1948),公樸,notion,0,1,1,0,1,1,0.005017,4,0.257497,0.26453,0
公正(1948),公正,notion,0,2,2,0,2,2,0.023992,4,0.29271,0.322985,3168.205568
公民投票(1948),公民投票,notion,0,1,1,0,1,1,0.009739,4,0.265806,0.279704,0
公然反对(1948),公然反对,notion,0,1,1,0,1,1,0.011322,4,0.269061,0.285394,0
公用事业(1948),公用事业,notion,0,4,4,0,4,4,0.04946,4,0.333215,0.375006,12612.161007
公祭(1948),公祭,notion,0,1,1,0,1,1,0.009739,4,0.265806,0.279704,0
公私(1948),公私,notion,0,1,1,0,1,1,0.01424,4,0.275514,0.296275,0
公费(1948),公费,notion,0,2,2,0,2,2,0.019569,4,0.280598,0.30455,1193.220239
公路(1948),公路,notion,0,3,3,0,3,3,0.042314,4,0.321357,0.361107,6944.653827
公道(1948),公道,notion,0,1,1,0,1,1,0.016752,4,0.279138,0.302165,0
六个(1948),六个,notion,0,1,1,0,1,1,0.016518,4,0.278724,0.3015,0
六十(1948),六十,notion,0,2,2,0,3,3,0.021756,4,0.286964,0.314433,2044.761444
六十五(1948),六十五,notion,0,1,1,0,1,1,0.009755,4,0.266617,0.281135,0
六十大寿(1948),六十大寿,notion,0,1,1,0,1,1,0.016752,4,0.279138,0.302165,0
六千(1948),六千,notion,0,2,2,0,2,2,0.019975,4,0.283071,0.308443,1854.710834
六天(1948),六天,notion,0,1,1,0,1,1,0.01022,4,0.267243,0.282233,0
六技(1948),六技,notion,0,1,1,0,1,1,0.016518,4,0.278724,0.3015,0
六载(1948),六载,notion,0,1,1,0,1,1,0.01424,4,0.275514,0.296275,0
兰州(1948),兰州,notion,0,3,3,0,4,4,0.016945,4,0.271061,0.288933,1161.334715
共产(1948),共产,notion,0,1,1,0,1,1,0.01424,4,0.275514,0.296275,0
共产主义(1948),共产主义,notion,0,2,2,0,2,2,0.01727,4,0.278352,0.300956,1619.09855
共产党员(1948),共产党员,notion,0,1,1,0,3,3,0.009751,4,0.267186,0.282133,0
共产国际(1948),共产国际,notion,0,1,1,0,1,1,0.01424,4,0.275514,0.296275,0
共党(1948),共党,notion,0,2,2,0,4,4,0.023995,4,0.291507,0.321221,2493.732085
共军(1948),共军,notion,0,1,1,0,3,3,0.01022,4,0.267243,0.282233,0
共军会(1948),共军会,notion,0,1,1,0,1,1,0.01022,4,0.267243,0.282233,0
共区(1948),共区,notion,0,1,1,0,1,1,0.011322,4,0.269061,0.285394,0
共同(1948),共同,notion,0,3,3,0,3,3,0.014865,4,0.272043,0.290596,2020.332576
共和(1948),共和,notion,0,1,1,0,1,1,0.011322,4,0.269061,0.285394,0
共荣圈(1948),共荣圈,notion,0,1,1,0,1,1,0.009755,4,0.266617,0.281135,0
共鸣(1948),共鸣,notion,0,2,2,0,7,7,0.012965,4,0.271708,0.289975,1825.821004
关东(1948),关东,notion,0,1,1,0,1,1,0.008247,4,0.26379,0.27611,0
关东军(1948),关东军,notion,0,1,1,0,1,1,0.009755,4,0.266617,0.281135,0
关中(1948),关中,notion,0,2,2,0,4,4,0.026972,4,0.293947,0.324781,1749.441854
关内(1948),关内,notion,0,2,2,0,2,2,0.021542,4,0.284314,0.310373,1410.419447
关外(1948),关外,notion,0,1,1,0,1,1,0.01022,4,0.267243,0.282233,0
关头(1948),关头,notion,0,2,2,0,2,2,0.025562,4,0.293259,0.323783,2167.4723
关心(1948),关心,notion,0,1,1,0,1,1,0.01424,4,0.275514,0.296275,0
关系(1948),关系,notion,0,2,2,0,2,2,0.021469,4,0.287095,0.314632,2527.522512
关系恶化(1948),关系恶化,notion,0,1,1,0,1,1,0.007515,4,0.262793,0.274313,0
关羽(1948),关羽,notion,0,1,1,0,1,1,0.016518,4,0.278724,0.3015,0
关联(1948),关联,notion,0,1,1,0,1,1,0.004718,4,0.258401,0.266227,0
关金券(1948),关金券,notion,0,1,1,0,1,1,0.008247,4,0.26379,0.27611,0
关键(1948),关键,notion,0,3,3,0,4,4,0.025502,4,0.289641,0.318515,4038.219526
兴奋(1948),兴奋,notion,0,1,1,0,2,2,0.009751,4,0.267186,0.282133,0
兴起(1948),兴起,notion,0,1,1,0,1,1,0.002332,4,0.253398,0.256677,0
兴趣(1948),兴趣,notion,0,1,1,0,1,1,0.004718,4,0.258401,0.266227,0
兴邦(1948),兴邦,notion,0,1,1,0,1,1,0.01424,4,0.275514,0.296275,0
兵书(1948),兵书,notion,0,1,1,0,1,1,0.01424,4,0.275514,0.296275,0
兵农(1948),兵农,notion,0,1,1,0,1,1,0.009751,4,0.267186,0.282133,0
兵变(1948),兵变,notion,0,1,1,0,1,1,0.016518,4,0.278724,0.3015,0
兵士(1948),兵士,notion,0,1,1,0,1,1,0.009755,4,0.266617,0.281135,0
兵强(1948),兵强,notion,0,1,1,0,1,1,0.016518,4,0.278724,0.3015,0
兵当(1948),兵当,notion,0,1,1,0,1,1,0.016518,4,0.278724,0.3015,0
兵心(1948),兵心,notion,0,1,1,0,1,1,0.016518,4,0.278724,0.3015,0
兵船(1948),兵船,notion,0,1,1,0,1,1,0.009751,4,0.267186,0.282133,0
兵马(1948),兵马,notion,0,1,1,0,1,1,0.009751,4,0.267186,0.282133,0
其中(1948),其中,notion,0,1,1,0,1,1,0.008247,4,0.26379,0.27611,0
其人(1948),其人,notion,0,1,1,0,1,1,0.016752,4,0.279138,0.302165,0
其他(1948),其他,notion,0,3,3,0,3,3,0.027505,4,0.294708,0.325935,4453.908022
其它(1948),其它,notion,0,2,2,0,2,2,0.008698,4,0.258507,0.266483,0.569098
其宗(1948),其宗,notion,0,1,1,0,1,1,0.016518,4,0.278724,0.3015,0
其心(1948),其心,notion,0,1,1,0,1,1,0.01424,4,0.275514,0.296275,0
其田(1948),其田,notion,0,1,1,0,1,1,0.008247,4,0.26379,0.27611,0
其美路(1948),其美路,notion,0,1,1,0,1,1,0.016518,4,0.278724,0.3015,0
具体(1948),具体,notion,0,2,2,0,3,3,0.022488,4,0.288152,0.31623,2102.825587
具体化(1948),具体化,notion,0,1,1,0,1,1,0.01424,4,0.275514,0.296275,0
具体表现(1948),具体表现,notion,0,1,1,0,1,1,0.016518,4,0.278724,0.3015,0
典型(1948),典型,notion,0,2,2,0,2,2,0.033269,4,0.305692,0.34112,2297.98609
典期(1948),典期,notion,0,1,1,0,1,1,0.01424,4,0.275514,0.296275,0
养士(1948),养士,notion,0,1,1,0,1,1,0.009739,4,0.265806,0.279704,0
兼以(1948),兼以,notion,0,1,1,0,1,1,0.004718,4,0.258401,0.266227,0
兼及(1948),兼及,notion,0,1,1,0,1,1,0.007515,4,0.262793,0.274313,0
兼容(1948),兼容,notion,0,1,1,0,1,1,0.016752,4,0.279138,0.302165,0
兼答(1948),兼答,notion,0,1,1,0,1,1,0.016752,4,0.279138,0.302165,0
兽性(1948),兽性,notion,0,1,1,0,1,1,0.01022,4,0.267243,0.282233,0
兽机(1948),兽机,notion,0,1,1,0,1,1,0.016518,4,0.278724,0.3015,0
冀东(1948),冀东,notion,0,1,1,0,1,1,0.008247,4,0.26379,0.27611,0
冀中(1948),冀中,notion,0,1,1,0,1,1,0.005017,4,0.257497,0.26453,0
冀北(1948),冀北,notion,0,1,1,0,1,1,0.008247,4,0.26379,0.27611,0
内哄(1948),内哄,notion,0,1,1,0,1,1,0.016752,4,0.279138,0.302165,0
内在(1948),内在,notion,0,1,1,0,1,1,0.011322,4,0.269061,0.285394,0
内地(1948),内地,notion,0,1,1,0,1,1,0.011322,4,0.269061,0.285394,0
内外(1948),内外,notion,0,3,3,0,9,9,0.029178,4,0.300388,0.333954,7585.806659
内容(1948),内容,notion,0,1,1,0,1,1,0.009739,4,0.265806,0.279704,0
内层(1948),内层,notion,0,1,1,0,1,1,0.008247,4,0.26379,0.27611,0
内幕消息(1948),内幕消息,notion,0,1,1,0,1,1,0.016518,4,0.278724,0.3015,0
内忧(1948),内忧,notion,0,1,1,0,1,1,0.005389,4,0.25849,0.266394,0
内政部(1948),内政部,notion,0,2,2,0,2,2,0.030992,4,0.303936,0.338757,2912.385696
内河(1948),内河,notion,0,1,1,0,3,3,0.01022,4,0.267243,0.282233,0
内蒙古(1948),内蒙古,notion,0,1,1,0,1,1,0.016752,4,0.279138,0.302165,0
内部(1948),内部,notion,0,1,1,0,1,1,0.009751,4,0.267186,0.282133,0
再来(1948),再来,notion,0,1,1,0,1,1,0.009751,4,0.267186,0.282133,0
再生(1948),再生,notion,0,1,1,0,1,1,0.016752,4,0.279138,0.302165,0
再用(1948),再用,notion,0,1,1,0,1,1,0.01424,4,0.275514,0.296275,0
再缓(1948),再缓,notion,0,1,1,0,1,1,0.01424,4,0.275514,0.296275,0
再落(1948),再落,notion,0,1,1,0,1,1,0.002332,4,0.253398,0.256677,0
再谈(1948),再谈,notion,0,3,3,0,3,3,0.040732,4,0.317178,0.355983,6314.893682
再起(1948),再起,notion,0,2,2,0,2,2,0.012233,4,0.270573,0.288045,1678.569586
再造(1948),再造,notion,0,1,1,0,1,1,0.016752,4,0.279138,0.302165,0
冒险(1948),冒险,notion,0,2,2,0,2,2,0.021061,4,0.283157,0.308576,1336.570675
冒雨(1948),冒雨,notion,0,1,1,0,1,1,0.016752,4,0.279138,0.302165,0
写了(1948),写了,notion,0,2,2,0,2,2,0.008698,4,0.258507,0.266483,0.569098
写作(1948),写作,notion,0,1,1,0,1,1,0.009739,4,0.265806,0.279704,0
写作技巧(1948),写作技巧,notion,0,1,1,0,1,1,0.01022,4,0.267243,0.282233,0
写出(1948),写出,notion,0,1,1,0,1,1,0.008247,4,0.26379,0.27611,0
写文章(1948),写文章,notion,0,1,1,0,1,1,0.009751,4,0.267186,0.282133,0
写新页(1948),写新页,notion,0,1,1,0,1,1,0.009739,4,0.265806,0.279704,0
写真(1948),写真,notion,0,1,1,0,1,1,0.016752,4,0.279138,0.302165,0
写稿(1948),写稿,notion,0,1,1,0,1,1,0.01424,4,0.275514,0.296275,0
写给(1948),写给,notion,0,1,1,0,1,1,0.01022,4,0.267243,0.282233,0
军与政(1948),军与政,notion,0,1,1,0,1,1,0.007515,4,0.262793,0.274313,0
军事化(1948),军事化,notion,0,1,1,0,1,1,0.009755,4,0.266617,0.281135,0
军事援助(1948),军事援助,notion,0,1,1,0,2,2,0.01424,4,0.275514,0.296275,0
军力(1948),军力,notion,0,1,1,0,1,1,0.016518,4,0.278724,0.3015,0
军功(1948),军功,notion,0,1,1,0,1,1,0.007515,4,0.262793,0.274313,0
军国主义(1948),军国主义,notion,0,1,1,0,2,2,0.009755,4,0.266617,0.281135,0
军官(1948),军官,notion,0,1,1,0,1,1,0.016518,4,0.278724,0.3015,0
军情(1948),军情,notion,0,1,1,0,3,3,0.01022,4,0.267243,0.282233,0
军政(1948),军政,notion,0,1,1,0,1,1,0.01022,4,0.267243,0.282233,0
军民(1948),军民,notion,0,2,2,0,2,2,0.026269,4,0.293695,0.324415,1931.353166
军火库(1948),军火库,notion,0,1,1,0,1,1,0.011322,4,0.269061,0.285394,0
军纪(1948),军纪,notion,0,1,1,0,1,1,0.007515,4,0.262793,0.274313,0
军统(1948),军统,notion,0,1,1,0,2,2,0.016518,4,0.278724,0.3015,0
军训(1948),军训,notion,0,1,1,0,1,1,0.016752,4,0.279138,0.302165,0
军长(1948),军长,notion,0,1,1,0,1,1,0.016518,4,0.278724,0.3015,0
农业(1948),农业,notion,0,5,5,0,6,6,0.04353,4,0.320288,0.359921,17868.663329
农会(1948),农会,notion,0,1,1,0,1,1,0.009751,4,0.267186,0.282133,0
农地(1948),农地,notion,0,3,3,0,3,3,0.027084,4,0.291846,0.321776,4009.655113
农场主(1948),农场主,notion,0,1,1,0,1,1,0.004718,4,0.258401,0.266227,0
农工民主党(1948),农工民主党,notion,0,1,1,0,1,1,0.016752,4,0.279138,0.302165,0
农忙(1948),农忙,notion,0,1,1,0,1,1,0.004718,4,0.258401,0.266227,0
农情(1948),农情,notion,0,1,1,0,1,1,0.016752,4,0.279138,0.302165,0
农贷(1948),农贷,notion,0,1,1,0,1,1,0.004718,4,0.258401,0.266227,0
冠盖(1948),冠盖,notion,0,1,1,0,1,1,0.005389,4,0.25849,0.266394,0
冬令营(1948),冬令营,notion,0,1,1,0,1,1,0.011322,4,0.269061,0.285394,0
冬天(1948),冬天,notion,0,1,1,0,2,2,0.016752,4,0.279138,0.302165,0
冬季(1948),冬季,notion,0,2,2,0,2,2,0.026738,4,0.294408,0.325447,1993.868267
冬宫(1948),冬宫,notion,0,1,1,0,1,1,0.009755,4,0.266617,0.281135,0
冬景(1948),冬景,notion,0,1,1,0,1,1,0.016752,4,0.279138,0.302165,0
冬防(1948),冬防,notion,0,1,1,0,1,1,0.016752,4,0.279138,0.302165,0
冯玉神氏(1948),冯玉神氏,notion,0,1,1,0,1,1,0.016518,4,0.278724,0.3015,0
冯玉祥(1948),冯玉祥,notion,0,7,7,0,14,14,0.080003,4,0.383767,0.424586,35762.772079
冲击(1948),冲击,notion,0,1,1,0,2,2,0.01022,4,0.267243,0.282233,0
冲淡(1948),冲淡,notion,0,1,1,0,1,1,0.008247,4,0.26379,0.27611,0
冲突(1948),冲突,notion,0,1,1,0,1,1,0.009755,4,0.266617,0.281135,0
决不能(1948),决不能,notion,0,1,1,0,1,1,0.01424,4,0.275514,0.296275,0
决定(1948),决定,notion,0,3,3,0,5,5,0.040513,4,0.31882,0.358013,7099.850156
决定性(1948),决定性,notion,0,2,2,0,2,2,0.033269,4,0.305692,0.34112,2297.98609
决心(1948),决心,notion,0,1,1,0,1,1,0.009751,4,0.267186,0.282133,0
决战(1948),决战,notion,0,1,1,0,1,1,0.016752,4,0.279138,0.302165,0
决斗(1948),决斗,notion,0,2,2,0,3,3,0.026507,4,0.294224,0.325181,2012.895914
决策(1948),决策,notion,0,1,1,0,1,1,0.007515,4,0.262793,0.274313,0
决议(1948),决议,notion,0,4,4,0,4,4,0.045763,4,0.322267,0.362261,10052.592216
决议案(1948),决议案,notion,0,1,1,0,1,1,0.016518,4,0.278724,0.3015,0
冷仗(1948),冷仗,notion,0,1,1,0,1,1,0.016752,4,0.279138,0.302165,0
冷战(1948),冷战,notion,0,7,7,0,10,10,0.064735,4,0.354638,0.397833,31402.884745
冷落(1948),冷落,notion,0,2,2,0,2,2,0.019258,4,0.282157,0.307012,1389.971062
冷饮(1948),冷饮,notion,0,1,1,0,1,1,0.01424,4,0.275514,0.296275,0
凄迷(1948),凄迷,notion,0,1,1,0,1,1,0.005389,4,0.25849,0.266394,0
准备(1948),准备,notion,0,6,6,0,7,7,0.055161,4,0.331978,0.373719,17016.255097
减租(1948),减租,notion,0,3,3,0,6,6,0.021984,4,0.287205,0.314854,5941.932804
减租减息(1948),减租减息,notion,0,2,2,0,2,2,0.021535,4,0.28397,0.309841,889.229879
减税(1948),减税,notion,0,1,1,0,1,1,0.016752,4,0.279138,0.302165,0
几付(1948),几付,notion,0,1,1,0,1,1,0.016518,4,0.278724,0.3015,0
几件(1948),几件,notion,0,1,1,0,1,1,0.009751,4,0.267186,0.282133,0
几件事(1948),几件事,notion,0,1,1,0,1,1,0.005389,4,0.25849,0.266394,0
几句(1948),几句,notion,0,1,1,0,1,1,0.009739,4,0.265806,0.279704,0
几多(1948),几多,notion,0,1,1,0,1,1,0.009751,4,0.267186,0.282133,0
几天(1948),几天,notion,0,1,1,0,1,1,0.009739,4,0.265806,0.279704,0
几小时(1948),几小时,notion,0,1,1,0,1,1,0.01022,4,0.267243,0.282233,0
几点(1948),几点,notion,0,4,4,0,5,5,0.042829,4,0.323321,0.363525,13388.832724
几种(1948),几种,notion,0,2,2,0,3,3,0.026972,4,0.293947,0.324781,1749.441854
几篇(1948),几篇,notion,0,1,1,0,1,1,0.009755,4,0.266617,0.281135,0
几课(1948),几课,notion,0,1,1,0,1,1,0.008247,4,0.26379,0.27611,0
几阵(1948),几阵,notion,0,1,1,0,1,1,0.01022,4,0.267243,0.282233,0
凤凰(1948),凤凰,notion,0,1,1,0,1,1,0.009751,4,0.267186,0.282133,0
出关(1948),出关,notion,0,1,1,0,1,1,0.011322,4,0.269061,0.285394,0
出击(1948),出击,notion,0,2,2,0,2,2,0.019972,4,0.283949,0.309807,2243.008915
出动(1948),出动,notion,0,1,1,0,1,1,0.009751,4,0.267186,0.282133,0
出卖(1948),出卖,notion,0,4,4,0,5,5,0.041507,4,0.315182,0.353543,8874.021084
出发(1948),出发,notion,0,1,1,0,1,1,0.016752,4,0.279138,0.302165,0
出国(1948),出国,notion,0,1,1,0,1,1,0.007515,4,0.262793,0.274313,0
出处(1948),出处,notion,0,1,1,0,1,1,0.01022,4,0.267243,0.282233,0
出席(1948),出席,notion,0,2,2,0,2,2,0.024033,4,0.291281,0.320888,2559.028705
出彩(1948),出彩,notion,0,1,1,0,1,1,0.016518,4,0.278724,0.3015,0
出来(1948),出来,notion,0,2,2,0,2,2,0.022488,4,0.288152,0.31623,2102.825587
出殡(1948),出殡,notion,0,1,1,0,1,1,0.011322,4,0.269061,0.285394,0
出洋(1948),出洋,notion,0,1,1,0,1,1,0.009739,4,0.265806,0.279704,0
出炉(1948),出炉,notion,0,1,1,0,1,1,0.009751,4,0.267186,0.282133,0
出版(1948),出版,notion,0,4,4,0,7,7,0.042983,4,0.318118,0.357203,8794.246402
出版事业(1948),出版事业,notion,0,1,1,0,1,1,0.004718,4,0.258401,0.266227,0
出版法(1948),出版法,notion,0,2,2,0,2,2,0.022488,4,0.288152,0.31623,2102.825587
出版社(1948),出版社,notion,0,3,3,0,3,3,0.013416,4,0.266466,0.28098,1699.071477
出现(1948),出现,notion,0,4,4,0,4,4,0.030552,4,0.299287,0.332479,8423.538642
出社版(1948),出社版,notion,0,1,1,0,1,1,0.016752,4,0.279138,0.302165,0
出笼(1948),出笼,notion,0,1,1,0,1,1,0.011322,4,0.269061,0.285394,0
出路(1948),出路,notion,0,7,7,0,14,14,0.0789,4,0.384868,0.425518,36966.385293
出身(1948),出身,notion,0,2,2,0,2,2,0.030758,4,0.303347,0.337959,2812.221703
击毙(1948),击毙,notion,0,1,1,0,1,1,0.01022,4,0.267243,0.282233,0
击退(1948),击退,notion,0,2,2,0,2,2,0.021535,4,0.28397,0.309841,889.229879
函件(1948),函件,notion,0,1,1,0,2,2,0.009755,4,0.266617,0.281135,0
函授学校(1948),函授学校,notion,0,1,1,0,1,1,0.004718,4,0.258401,0.266227,0
分会(1948),分会,notion,0,3,3,0,3,3,0.034007,4,0.303691,0.33848,4922.321601
分别(1948),分别,notion,0,2,2,0,3,3,0.030758,4,0.303347,0.337959,2812.221703
分化(1948),分化,notion,0,1,1,0,1,1,0.016518,4,0.278724,0.3015,0
分区(1948),分区,notion,0,1,1,0,1,1,0.01022,4,0.267243,0.282233,0
分外(1948),分外,notion,0,1,1,0,1,1,0.016752,4,0.279138,0.302165,0
分崩离析(1948),分崩离析,notion,0,1,1,0,1,1,0.009751,4,0.267186,0.282133,0
分工(1948),分工,notion,0,1,1,0,1,1,0.009739,4,0.265806,0.279704,0
分开(1948),分开,notion,0,1,1,0,1,1,0.008247,4,0.26379,0.27611,0
分水岭(1948),分水岭,notion,0,1,1,0,1,1,0.016518,4,0.278724,0.3015,0
分治(1948),分治,notion,0,1,1,0,1,1,0.009755,4,0.266617,0.281135,0
分立(1948),分立,notion,0,1,1,0,1,1,0.009739,4,0.265806,0.279704,0
分肥(1948),分肥,notion,0,1,1,0,1,1,0.009751,4,0.267186,0.282133,0
分裂(1948),分裂,notion,0,4,4,0,4,4,0.036761,4,0.308682,0.345191,10060.716397
分赋(1948),分赋,notion,0,1,1,0,1,1,0.009751,4,0.267186,0.282133,0
分配(1948),分配,notion,0,1,1,0,1,1,0.01022,4,0.267243,0.282233,0
分释(1948),分释,notion,0,1,1,0,1,1,0.01022,4,0.267243,0.282233,0
分野(1948),分野,notion,0,1,1,0,1,1,0.016518,4,0.278724,0.3015,0
切勿(1948),切勿,notion,0,1,1,0,1,1,0.01424,4,0.275514,0.296275,0
切实(1948),切实,notion,0,1,1,0,1,1,0.004718,4,0.258401,0.266227,0
刊专(1948),刊专,notion,0,1,1,0,1,1,0.016518,4,0.278724,0.3015,0
刊登(1948),刊登,notion,0,1,1,0,1,1,0.009755,4,0.266617,0.281135,0
刊载(1948),刊载,notion,0,1,1,0,1,1,0.005389,4,0.25849,0.266394,0
刍荛之言(1948),刍荛之言,notion,0,2,2,0,3,3,0.022141,4,0.285959,0.312902,1122.074528
刍议(1948),刍议,notion,0,4,4,0,4,4,0.023636,4,0.282624,0.307855,5161.76868
刑事法庭(1948),刑事法庭,notion,0,2,2,0,2,2,0.018468,4,0.27997,0.303552,1613.088959
划分(1948),划分,notion,0,1,1,0,1,1,0.007515,4,0.262793,0.274313,0
列举(1948),列举,notion,0,1,1,0,1,1,0.008247,4,0.26379,0.27611,0
列传(1948),列传,notion,0,1,1,0,1,1,0.009739,4,0.265806,0.279704,0
刘伯承(1948),刘伯承,notion,0,4,4,0,5,5,0.053241,4,0.338164,0.380496,12884.619614
刘备(1948),刘备,notion,0,1,1,0,1,1,0.009751,4,0.267186,0.282133,0
刘大中(1948),刘大中,notion,0,1,1,0,1,1,0.008247,4,0.26379,0.27611,0
刘家(1948),刘家,notion,0,1,1,0,1,1,0.016518,4,0.278724,0.3015,0
刘建绪(1948),刘建绪,notion,0,2,2,0,3,3,0.021542,4,0.284314,0.310373,1410.419447
刘成禺(1948),刘成禺,notion,0,1,1,0,1,1,0.01022,4,0.267243,0.282233,0
刘永图(1948),刘永图,notion,0,1,1,0,1,1,0.009751,4,0.267186,0.282133,0
刘裕(1948),刘裕,notion,0,2,2,0,2,2,0.008698,4,0.258507,0.266483,0.569098
创作(1948),创作,notion,0,5,5,0,6,6,0.05722,4,0.346429,0.38937,19283.702874
创作实践(1948),创作实践,notion,0,1,1,0,1,1,0.009751,4,0.267186,0.282133,0
创办(1948),创办,notion,0,1,1,0,1,1,0.004718,4,0.258401,0.266227,0
创建(1948),创建,notion,0,2,2,0,3,3,0.014469,4,0.27493,0.295366,1965.542095
创生(1948),创生,notion,0,1,1,0,1,1,0.016752,4,0.279138,0.302165,0
创立(1948),创立,notion,0,2,2,0,2,2,0.026507,4,0.294224,0.325181,2012.895914
创造(1948),创造,notion,0,2,2,0,2,2,0.016039,4,0.2771,0.298926,2122.22906
创造力(1948),创造力,notion,0,1,1,0,1,1,0.009751,4,0.267186,0.282133,0
创造者(1948),创造者,notion,0,1,1,0,1,1,0.009755,4,0.266617,0.281135,0
初中(1948),初中,notion,0,1,1,0,1,1,0.016752,4,0.279138,0.302165,0
初夏(1948),初夏,notion,0,1,1,0,1,1,0.01022,4,0.267243,0.282233,0
初旅(1948),初旅,notion,0,1,1,0,1,1,0.004718,4,0.258401,0.266227,0
初步(1948),初步,notion,0,6,6,0,6,6,0.058462,4,0.346269,0.389259,28542.117574
初稿(1948),初稿,notion,0,1,1,0,1,1,0.007515,4,0.262793,0.274313,0
初访(1948),初访,notion,0,1,1,0,1,1,0.004718,4,0.258401,0.266227,0
初阶(1948),初阶,notion,0,1,1,0,1,1,0.01022,4,0.267243,0.282233,0
判决(1948),判决,notion,0,1,1,0,1,1,0.007515,4,0.262793,0.274313,0
利刃(1948),利刃,notion,0,1,1,0,1,1,0.011322,4,0.269061,0.285394,0
利害(1948),利害,notion,0,1,1,0,1,1,0.008247,4,0.26379,0.27611,0
利弊(1948),利弊,notion,0,1,1,0,1,1,0.011322,4,0.269061,0.285394,0
利息(1948),利息,notion,0,1,1,0,1,1,0.01424,4,0.275514,0.296275,0
利率(1948),利率,notion,0,1,1,0,1,1,0.008247,4,0.26379,0.27611,0
利用(1948),利用,notion,0,2,2,0,2,2,0.023992,4,0.29271,0.322985,3168.205568
利用外资(1948),利用外资,notion,0,1,1,0,1,1,0.007515,4,0.262793,0.274313,0
利益(1948),利益,notion,0,4,4,0,4,4,0.04553,4,0.324046,0.364391,10150.624466
别哭(1948),别哭,notion,0,1,1,0,1,1,0.016752,4,0.279138,0.302165,0
到来(1948),到来,notion,0,1,1,0,2,2,0.002332,4,0.253398,0.256677,0
制度化(1948),制度化,notion,0,1,1,0,1,1,0.008247,4,0.26379,0.27611,0
制止(1948),制止,notion,0,2,2,0,2,2,0.026257,4,0.292073,0.322053,1522.40889
制片(1948),制片,notion,0,1,1,0,1,1,0.01022,4,0.267243,0.282233,0
制裁(1948),制裁,notion,0,1,1,0,1,1,0.008247,4,0.26379,0.27611,0
制订(1948),制订,notion,0,1,1,0,1,1,0.008247,4,0.26379,0.27611,0
刷子(1948),刷子,notion,0,1,1,0,1,1,0.016518,4,0.278724,0.3015,0
刷新(1948),刷新,notion,0,1,1,0,1,1,0.009751,4,0.267186,0.282133,0
刻不容缓(1948),刻不容缓,notion,0,1,1,0,1,1,0.007515,4,0.262793,0.274313,0
刽子手(1948),刽子手,notion,0,2,2,0,2,2,0.026272,4,0.29319,0.323683,1793.896368
削弱(1948),削弱,notion,0,1,1,0,1,1,0.01022,4,0.267243,0.282233,0
前义(1948),前义,notion,0,1,1,0,1,1,0.009755,4,0.266617,0.281135,0
前些时(1948),前些时,notion,0,1,1,0,1,1,0.016518,4,0.278724,0.3015,0
前叶(1948),前叶,notion,0,1,1,0,1,1,0.016752,4,0.279138,0.302165,0
前哨(1948),前哨,notion,0,2,2,0,2,2,0.030758,4,0.303347,0.337959,2812.221703
前因后果(1948),前因后果,notion,0,1,1,0,1,1,0.007515,4,0.262793,0.274313,0
前夕(1948),前夕,notion,0,4,4,0,8,8,0.054331,4,0.336107,0.378233,10345.926443
前夜(1948),前夜,notion,0,2,2,0,2,2,0.014772,4,0.272635,0.291539,771.57337
前大(1948),前大,notion,0,1,1,0,1,1,0.016752,4,0.279138,0.302165,0
前奏(1948),前奏,notion,0,1,1,0,1,1,0.016752,4,0.279138,0.302165,0
前奏曲(1948),前奏曲,notion,0,1,1,0,1,1,0.009739,4,0.265806,0.279704,0
前所(1948),前所,notion,0,1,1,0,1,1,0.009751,4,0.267186,0.282133,0
前拥(1948),前拥,notion,0,1,1,0,1,1,0.005017,4,0.257497,0.26453,0
前提(1948),前提,notion,0,1,1,0,1,1,0.005017,4,0.257497,0.26453,0
前期(1948),前期,notion,0,1,1,0,2,2,0.01424,4,0.275514,0.296275,0
前瞻(1948),前瞻,notion,0,2,2,0,2,2,0.024999,4,0.291484,0.321188,1929.694181
前线(1948),前线,notion,0,2,2,0,4,4,0.026269,4,0.293695,0.324415,1931.353166
前进(1948),前进,notion,0,4,4,0,8,8,0.052227,4,0.341174,0.383757,16187.627914
前途(1948),前途,notion,0,8,8,0,14,14,0.075347,4,0.377367,0.419118,47640.477307
前面(1948),前面,notion,0,1,1,0,1,1,0.009755,4,0.266617,0.281135,0
剖析(1948),剖析,notion,0,1,1,0,1,1,0.01424,4,0.275514,0.296275,0
剖视(1948),剖视,notion,0,2,2,0,2,2,0.014472,4,0.274708,0.295,2180.550764
剥削(1948),剥削,notion,0,2,2,0,3,3,0.016339,4,0.275312,0.295998,876.896283
剧作家(1948),剧作家,notion,0,1,1,0,2,2,0.009755,4,0.266617,0.281135,0
剧变(1948),剧变,notion,0,1,1,0,2,2,0.01022,4,0.267243,0.282233,0
剧场(1948),剧场,notion,0,1,1,0,1,1,0.009755,4,0.266617,0.281135,0
剧本(1948),剧本,notion,0,1,1,0,1,1,0.009751,4,0.267186,0.282133,0
剩余劳力(1948),剩余劳力,notion,0,1,1,0,1,1,0.004718,4,0.258401,0.266227,0
剷除(1948),剷除,notion,0,1,1,0,1,1,0.01424,4,0.275514,0.296275,0
剿共(1948),剿共,notion,0,1,1,0,1,1,0.01424,4,0.275514,0.296275,0
剿匪(1948),剿匪,notion,0,3,3,0,4,4,0.033077,4,0.30475,0.339911,5680.358983
劄记(1948),劄记,notion,0,1,1,0,1,1,0.009751,4,0.267186,0.282133,0
力促(1948),力促,notion,0,1,1,0,1,1,0.009739,4,0.265806,0.279704,0
力量(1948),力量,notion,0,9,9,0,14,14,0.089353,4,0.396611,0.435246,48855.781047
劝募(1948),劝募,notion,0,1,1,0,1,1,0.009739,4,0.265806,0.279704,0
劝告(1948),劝告,notion,0,1,1,0,1,1,0.01424,4,0.275514,0.296275,0
办好(1948),办好,notion,0,1,1,0,1,1,0.01424,4,0.275514,0.296275,0
办报(1948),办报,notion,0,1,1,0,1,1,0.009751,4,0.267186,0.282133,0
功之别(1948),功之别,notion,0,1,1,0,1,1,0.01424,4,0.275514,0.296275,0
功课(1948),功课,notion,0,1,1,0,1,1,0.007515,4,0.262793,0.274313,0
加以(1948),加以,notion,0,1,1,0,1,1,0.01424,4,0.275514,0.296275,0
加价(1948),加价,notion,0,2,2,0,2,2,0.019569,4,0.280598,0.30455,1193.220239
加城(1948),加城,notion,0,1,1,0,1,1,0.016752,4,0.279138,0.302165,0
加尔各答(1948),加尔各答,notion,0,2,2,0,2,2,0.026257,4,0.292073,0.322053,1522.40889
加强(1948),加强,notion,0,6,6,0,8,8,0.076755,4,0.381274,0.422401,31821.488579
加强团结(1948),加强团结,notion,0,2,2,0,4,4,0.033269,4,0.305692,0.34112,2297.98609
加拿大(1948),加拿大,notion,0,1,1,0,1,1,0.01424,4,0.275514,0.296275,0
加盟(1948),加盟,notion,0,1,1,0,1,1,0.009755,4,0.266617,0.281135,0
加紧(1948),加紧,notion,0,2,2,0,2,2,0.030992,4,0.303936,0.338757,2912.385696
加速(1948),加速,notion,0,1,1,0,1,1,0.016752,4,0.279138,0.302165,0
劣势(1948),劣势,notion,0,1,1,0,1,1,0.016518,4,0.278724,0.3015,0
劣绅(1948),劣绅,notion,0,1,1,0,1,1,0.009751,4,0.267186,0.282133,0
动乱(1948),动乱,notion,0,2,2,0,5,5,0.022141,4,0.285959,0.312902,1122.074528
动向(1948),动向,notion,0,2,2,0,4,4,0.022141,4,0.285959,0.312902,1122.074528
动员(1948),动员,notion,0,1,1,0,1,1,0.009751,4,0.267186,0.282133,0
动员戡乱(1948),动员戡乱,notion,0,1,1,0,1,1,0.011322,4,0.269061,0.285394,0
动摇(1948),动摇,notion,0,1,1,0,1,1,0.009751,4,0.267186,0.282133,0
动机(1948),动机,notion,0,1,1,0,1,1,0.016752,4,0.279138,0.302165,0
动盪(1948),动盪,notion,0,1,1,0,2,2,0.016518,4,0.278724,0.3015,0
动荡(1948),动荡,notion,0,3,3,0,3,3,0.021152,4,0.282603,0.307767,3176.639604
助学(1948),助学,notion,0,3,3,0,4,4,0.040497,4,0.317232,0.35605,6333.313511
助手(1948),助手,notion,0,1,1,0,1,1,0.009739,4,0.265806,0.279704,0
助日(1948),助日,notion,0,1,1,0,2,2,0.016752,4,0.279138,0.302165,0
努力(1948),努力,notion,0,4,4,0,4,4,0.049226,4,0.333156,0.374939,12923.974333
劫难(1948),劫难,notion,0,1,1,0,1,1,0.016752,4,0.279138,0.302165,0
劳作(1948),劳作,notion,0,1,1,0,1,1,0.016518,4,0.278724,0.3015,0
劳军(1948),劳军,notion,0,1,1,0,1,1,0.01424,4,0.275514,0.296275,0
劳农(1948),劳农,notion,0,1,1,0,1,1,0.002332,4,0.253398,0.256677,0
劳力(1948),劳力,notion,0,1,1,0,1,1,0.016752,4,0.279138,0.302165,0
劳动(1948),劳动,notion,0,4,4,0,4,4,0.040741,4,0.317339,0.356238,12299.075476
劳动者(1948),劳动者,notion,0,2,2,0,2,2,0.026507,4,0.294224,0.325181,2012.895914
劳勤者对(1948),劳勤者对,notion,0,1,1,0,1,1,0.016518,4,0.278724,0.3015,0
劳协(1948),劳协,notion,0,1,1,0,1,1,0.009739,4,0.265806,0.279704,0
劳大(1948),劳大,notion,0,1,1,0,1,1,0.016518,4,0.278724,0.3015,0
劳工(1948),劳工,notion,0,5,5,0,8,8,0.055096,4,0.336077,0.378255,14050.559021
劳心(1948),劳心,notion,0,1,1,0,1,1,0.016752,4,0.279138,0.302165,0
劳联(1948),劳联,notion,0,1,1,0,1,1,0.009739,4,0.265806,0.279704,0
劳资关系(1948),劳资关系,notion,0,1,1,0,1,1,0.009739,4,0.265806,0.279704,0
势利(1948),势利,notion,0,1,1,0,1,1,0.01424,4,0.275514,0.296275,0
势力范围(1948),势力范围,notion,0,1,1,0,1,1,0.009755,4,0.266617,0.281135,0
势在必行(1948),势在必行,notion,0,1,1,0,1,1,0.016752,4,0.279138,0.302165,0
势必(1948),势必,notion,0,1,1,0,1,1,0.005389,4,0.25849,0.266394,0
勃勃的(1948),勃勃的,notion,0,1,1,0,1,1,0.011322,4,0.269061,0.285394,0
勇敢(1948),勇敢,notion,0,1,1,0,1,1,0.016518,4,0.278724,0.3015,0
勇气(1948),勇气,notion,0,1,1,0,1,1,0.008247,4,0.26379,0.27611,0
勉励(1948),勉励,notion,0,1,1,0,1,1,0.007515,4,0.262793,0.274313,0
勋合(1948),勋合,notion,0,1,1,0,1,1,0.009739,4,0.265806,0.279704,0
勘乱(1948),勘乱,notion,0,1,1,0,1,1,0.016752,4,0.279138,0.302165,0
勘界(1948),勘界,notion,0,1,1,0,1,1,0.008247,4,0.26379,0.27611,0
募捐(1948),募捐,notion,0,1,1,0,1,1,0.009739,4,0.265806,0.279704,0
勤俭(1948),勤俭,notion,0,2,2,0,2,2,0.033269,4,0.305692,0.34112,2297.98609
勤俭建国(1948),勤俭建国,notion,0,1,1,0,1,1,0.01424,4,0.275514,0.296275,0
勤王(1948),勤王,notion,0,1,1,0,1,1,0.016518,4,0.278724,0.3015,0
勾当(1948),勾当,notion,0,2,2,0,2,2,0.026272,4,0.29319,0.323683,1793.896368
勾结(1948),勾结,notion,0,1,1,0,1,1,0.016518,4,0.278724,0.3015,0
包围(1948),包围,notion,0,1,1,0,1,1,0.01022,4,0.267243,0.282233,0
包尔文(1948),包尔文,notion,0,1,1,0,1,1,0.016752,4,0.279138,0.302165,0
包工(1948),包工,notion,0,1,1,0,1,1,0.009751,4,0.267186,0.282133,0
匆匆(1948),匆匆,notion,0,1,1,0,1,1,0.009739,4,0.265806,0.279704,0
匈牙利(1948),匈牙利,notion,0,1,1,0,3,3,0.009755,4,0.266617,0.281135,0
化身(1948),化身,notion,0,1,1,0,1,1,0.008247,4,0.26379,0.27611,0
北京(1948),北京,notion,0,2,2,0,2,2,0.021756,4,0.286964,0.314433,2044.761444
北京大学(1948),北京大学,notion,0,2,2,0,4,4,0.008698,4,0.258507,0.266483,0.569098
北国(1948),北国,notion,0,1,1,0,1,1,0.016752,4,0.279138,0.302165,0
北大(1948),北大,notion,0,6,6,0,7,7,0.060517,4,0.34342,0.386264,18556.358711
北宋(1948),北宋,notion,0,1,1,0,1,1,0.007515,4,0.262793,0.274313,0
北山(1948),北山,notion,0,2,2,0,2,2,0.030758,4,0.303347,0.337959,2812.221703
北方(1948),北方,notion,0,6,6,0,12,12,0.064642,4,0.356049,0.399175,24563.056882
北方大学(1948),北方大学,notion,0,1,1,0,1,1,0.016518,4,0.278724,0.3015,0
北方工业(1948),北方工业,notion,0,2,2,0,2,2,0.008698,4,0.258507,0.266483,0.569098
北朝鲜(1948),北朝鲜,notion,0,2,2,0,6,6,0.019506,4,0.282731,0.307911,1903.779982
北极星(1948),北极星,notion,0,1,1,0,1,1,0.009755,4,0.266617,0.281135,0
北欧(1948),北欧,notion,0,2,2,0,2,2,0.021076,4,0.284616,0.310839,1735.877057
北江(1948),北江,notion,0,1,1,0,3,3,0.009751,4,0.267186,0.282133,0
北游(1948),北游,notion,0,1,1,0,1,1,0.01022,4,0.267243,0.282233,0
北窗(1948),北窗,notion,0,1,1,0,1,1,0.01424,4,0.275514,0.296275,0
北非(1948),北非,notion,0,3,3,0,3,3,0.018438,4,0.273429,0.292926,1298.292089
北韩(1948),北韩,notion,0,1,1,0,1,1,0.009739,4,0.265806,0.279704,0
匪军(1948),匪军,notion,0,1,1,0,1,1,0.01424,4,0.275514,0.296275,0
匪徒(1948),匪徒,notion,0,1,1,0,1,1,0.01424,4,0.275514,0.296275,0
匪患(1948),匪患,notion,0,1,1,0,1,1,0.009739,4,0.265806,0.279704,0
匪情(1948),匪情,notion,0,1,1,0,1,1,0.01424,4,0.275514,0.296275,0
匪谍(1948),匪谍,notion,0,1,1,0,1,1,0.016752,4,0.279138,0.302165,0
匮乏(1948),匮乏,notion,0,1,1,0,1,1,0.01424,4,0.275514,0.296275,0
匹夫有责(1948),匹夫有责,notion,0,1,1,0,1,1,0.01424,4,0.275514,0.296275,0
区别(1948),区别,notion,0,1,1,0,2,2,0.016518,4,0.278724,0.3015,0
区域(1948),区域,notion,0,1,1,0,2,2,0.016752,4,0.279138,0.302165,0
医务人员(1948),医务人员,notion,0,1,1,0,1,1,0.016518,4,0.278724,0.3015,0
医学(1948),医学,notion,0,2,2,0,2,2,0.008698,4,0.258507,0.266483,0.569098
医学院(1948),医学院,notion,0,2,2,0,2,2,0.008698,4,0.258507,0.266483,0.569098
医理(1948),医理,notion,0,1,1,0,1,1,0.01424,4,0.275514,0.296275,0
医生(1948),医生,notion,0,3,3,0,3,3,0.037987,4,0.314128,0.352156,7349.461704
医药(1948),医药,notion,0,1,1,0,1,1,0.004718,4,0.258401,0.266227,0
医院(1948),医院,notion,0,1,1,0,1,1,0.004718,4,0.258401,0.266227,0
十一(1948),十一,notion,0,1,1,0,2,2,0.01022,4,0.267243,0.282233,0
十七年(1948),十七年,notion,0,1,1,0,1,1,0.016752,4,0.279138,0.302165,0
十万(1948),十万,notion,0,2,2,0,2,2,0.026257,4,0.292073,0.322053,1522.40889
十万大山(1948),十万大山,notion,0,1,1,0,1,1,0.016518,4,0.278724,0.3015,0
十三(1948),十三,notion,0,1,1,0,2,2,0.01022,4,0.267243,0.282233,0
十九(1948),十九,notion,0,1,1,0,1,1,0.011322,4,0.269061,0.285394,0
十九号(1948),十九号,notion,0,1,1,0,1,1,0.002332,4,0.253398,0.256677,0
十二(1948),十二,notion,0,4,4,0,7,7,0.047814,4,0.326666,0.367485,10709.111863
十五(1948),十五,notion,0,2,2,0,4,4,0.026972,4,0.293947,0.324781,1749.441854
十人桥(1948),十人桥,notion,0,1,1,0,1,1,0.016518,4,0.278724,0.3015,0
十八年(1948),十八年,notion,0,1,1,0,1,1,0.009739,4,0.265806,0.279704,0
十六(1948),十六,notion,0,2,2,0,3,3,0.019975,4,0.283071,0.308443,1854.710834
十六名(1948),十六名,notion,0,1,1,0,1,1,0.016518,4,0.278724,0.3015,0
十则(1948),十则,notion,0,1,1,0,1,1,0.016752,4,0.279138,0.302165,0
十周年(1948),十周年,notion,0,1,1,0,1,1,0.009755,4,0.266617,0.281135,0
十四(1948),十四,notion,0,1,1,0,2,2,0.01022,4,0.267243,0.282233,0
十年间(1948),十年间,notion,0,1,1,0,1,1,0.009751,4,0.267186,0.282133,0
十点钟(1948),十点钟,notion,0,1,1,0,1,1,0.011322,4,0.269061,0.285394,0
十荒(1948),十荒,notion,0,1,1,0,1,1,0.004718,4,0.258401,0.266227,0
十讲(1948),十讲,notion,0,1,1,0,1,1,0.007515,4,0.262793,0.274313,0
十足(1948),十足,notion,0,1,1,0,1,1,0.016518,4,0.278724,0.3015,0
十週年(1948),十週年,notion,0,1,1,0,1,1,0.016518,4,0.278724,0.3015,0
千万(1948),千万,notion,0,1,1,0,1,1,0.01022,4,0.267243,0.282233,0
千奇百怪(1948),千奇百怪,notion,0,1,1,0,1,1,0.016518,4,0.278724,0.3015,0
升学(1948),升学,notion,0,1,1,0,1,1,0.016752,4,0.279138,0.302165,0
升降(1948),升降,notion,0,1,1,0,1,1,0.009755,4,0.266617,0.281135,0
升陟之疑(1948),升陟之疑,notion,0,1,1,0,1,1,0.007515,4,0.262793,0.274313,0
半个(1948),半个,notion,0,1,1,0,1,1,0.016518,4,0.278724,0.3015,0
半价(1948),半价,notion,0,1,1,0,1,1,0.011322,4,0.269061,0.285394,0
半壁(1948),半壁,notion,0,1,1,0,1,1,0.01022,4,0.267243,0.282233,0
半封建(1948),半封建,notion,0,1,1,0,1,1,0.016518,4,0.278724,0.3015,0
半岁(1948),半岁,notion,0,1,1,0,1,1,0.004718,4,0.258401,0.266227,0
半年(1948),半年,notion,0,3,3,0,3,3,0.038287,4,0.310827,0.34793,4250.67334
半日閒(1948),半日閒,notion,0,1,1,0,1,1,0.01424,4,0.275514,0.296275,0
半月(1948),半月,notion,0,1,1,0,3,3,0.005389,4,0.25849,0.266394,0
半殖民地(1948),半殖民地,notion,0,1,1,0,1,1,0.016518,4,0.278724,0.3015,0
华东(1948),华东,notion,0,1,1,0,1,1,0.01022,4,0.267243,0.282233,0
华中(1948),华中,notion,0,3,3,0,3,3,0.016214,4,0.270592,0.288134,1477.557689
华娜(1948),华娜,notion,0,1,1,0,1,1,0.009751,4,0.267186,0.282133,0
华府(1948),华府,notion,0,1,1,0,1,1,0.009739,4,0.265806,0.279704,0
华罗庚(1948),华罗庚,notion,0,1,1,0,1,1,0.01022,4,0.267243,0.282233,0
华莹山(1948),华莹山,notion,0,1,1,0,1,1,0.016518,4,0.278724,0.3015,0
华西(1948),华西,notion,0,1,1,0,1,1,0.005389,4,0.25849,0.266394,0
华西大学(1948),华西大学,notion,0,1,1,0,1,1,0.007515,4,0.262793,0.274313,0
华鎣(1948),华鎣,notion,0,1,1,0,1,1,0.01022,4,0.267243,0.282233,0
协会(1948),协会,notion,0,4,4,0,6,6,0.043761,4,0.318766,0.358002,9805.58613
协力(1948),协力,notion,0,1,1,0,1,1,0.016518,4,0.278724,0.3015,0
协动(1948),协动,notion,0,1,1,0,1,1,0.004718,4,0.258401,0.266227,0
协同(1948),协同,notion,0,1,1,0,1,1,0.016518,4,0.278724,0.3015,0
协商(1948),协商,notion,0,1,1,0,1,1,0.009751,4,0.267186,0.282133,0
协定(1948),协定,notion,0,3,3,0,4,4,0.03452,4,0.306241,0.341907,5547.973829
卑劣(1948),卑劣,notion,0,1,1,0,1,1,0.01424,4,0.275514,0.296275,0
卒子(1948),卒子,notion,0,1,1,0,1,1,0.005017,4,0.257497,0.26453,0
单帮(1948),单帮,notion,0,1,1,0,1,1,0.008247,4,0.26379,0.27611,0
卖国(1948),卖国,notion,0,3,3,0,3,3,0.040978,4,0.319498,0.358845,7110.8147
卖狗肉(1948),卖狗肉,notion,0,1,1,0,1,1,0.01424,4,0.275514,0.296275,0
卖身投靠(1948),卖身投靠,notion,0,2,2,0,3,3,0.023995,4,0.291507,0.321221,2493.732085
南下(1948),南下,notion,0,1,1,0,1,1,0.016518,4,0.278724,0.3015,0
南共(1948),南共,notion,0,4,4,0,4,4,0.050264,4,0.335687,0.377767,14103.188871
南北(1948),南北,notion,0,2,2,0,2,2,0.008698,4,0.258507,0.266483,0.569098
南北朝鲜(1948),南北朝鲜,notion,0,2,2,0,6,6,0.026272,4,0.29319,0.323683,1793.896368
南北极(1948),南北极,notion,0,1,1,0,1,1,0.01424,4,0.275514,0.296275,0
南区(1948),南区,notion,0,1,1,0,1,1,0.009751,4,0.267186,0.282133,0
南国(1948),南国,notion,0,1,1,0,1,1,0.002332,4,0.253398,0.256677,0
南岸(1948),南岸,notion,0,1,1,0,1,1,0.01022,4,0.267243,0.282233,0
南开(1948),南开,notion,0,2,2,0,2,2,0.027839,4,0.295962,0.327676,1920.33989
南斯拉夫(1948),南斯拉夫,notion,0,3,3,0,5,5,0.043024,4,0.320397,0.359943,6104.778372
南方(1948),南方,notion,0,1,1,0,1,1,0.016752,4,0.279138,0.302165,0
南无(1948),南无,notion,0,1,1,0,1,1,0.005017,4,0.257497,0.26453,0
南朝(1948),南朝,notion,0,4,4,0,4,4,0.033463,4,0.298811,0.331814,5140.82571
南来(1948),南来,notion,0,1,1,0,1,1,0.01022,4,0.267243,0.282233,0
南欧(1948),南欧,notion,0,1,1,0,1,1,0.011322,4,0.269061,0.285394,0
南汇(1948),南汇,notion,0,1,1,0,5,5,0.004718,4,0.258401,0.266227,0
南汇县(1948),南汇县,notion,0,1,1,0,1,1,0.004718,4,0.258401,0.266227,0
南海(1948),南海,notion,0,1,1,0,1,1,0.009751,4,0.267186,0.282133,0
南渡(1948),南渡,notion,0,1,1,0,1,1,0.01022,4,0.267243,0.282233,0
南移(1948),南移,notion,0,1,1,0,2,2,0.016752,4,0.279138,0.302165,0
南行(1948),南行,notion,0,1,1,0,1,1,0.016752,4,0.279138,0.302165,0
南角(1948),南角,notion,0,1,1,0,1,1,0.008247,4,0.26379,0.27611,0
南迁(1948),南迁,notion,0,2,2,0,2,2,0.026738,4,0.294408,0.325447,1993.868267
南逃声(1948),南逃声,notion,0,1,1,0,1,1,0.016518,4,0.278724,0.3015,0
南通(1948),南通,notion,0,1,1,0,1,1,0.016518,4,0.278724,0.3015,0
南部(1948),南部,notion,0,1,1,0,1,1,0.016518,4,0.278724,0.3015,0
南针(1948),南针,notion,0,1,1,0,1,1,0.009751,4,0.267186,0.282133,0
南雄(1948),南雄,notion,0,1,1,0,1,1,0.009751,4,0.267186,0.282133,0
南韩(1948),南韩,notion,0,2,2,0,2,2,0.026491,4,0.291937,0.321853,1403.825067
博士(1948),博士,notion,0,1,1,0,2,2,0.016752,4,0.279138,0.302165,0
博物院(1948),博物院,notion,0,1,1,0,1,1,0.016752,4,0.279138,0.302165,0
占纳(1948),占纳,notion,0,1,1,0,1,1,0.016518,4,0.278724,0.3015,0
占领区(1948),占领区,notion,0,2,2,0,2,2,0.019494,4,0.280535,0.30445,1251.270065
卡尔宾斯(1948),卡尔宾斯,notion,0,1,1,0,1,1,0.009755,4,0.266617,0.281135,0
卡车(1948),卡车,notion,0,1,1,0,1,1,0.016518,4,0.278724,0.3015,0
卢沟桥(1948),卢沟桥,notion,0,1,1,0,1,1,0.016752,4,0.279138,0.302165,0
卫立煌(1948),卫立煌,notion,0,1,1,0,1,1,0.008247,4,0.26379,0.27611,0
印共(1948),印共,notion,0,1,1,0,1,1,0.016518,4,0.278724,0.3015,0
印刷所(1948),印刷所,notion,0,1,1,0,1,1,0.004718,4,0.258401,0.266227,0
印荷(1948),印荷,notion,0,1,1,0,1,1,0.009755,4,0.266617,0.281135,0
印藏(1948),印藏,notion,0,1,1,0,1,1,0.016752,4,0.279138,0.302165,0
印象(1948),印象,notion,0,2,2,0,2,2,0.021076,4,0.284616,0.310839,1735.877057
危害(1948),危害,notion,0,3,3,0,3,3,0.044591,4,0.323126,0.363237,6083.12181
危急(1948),危急,notion,0,1,1,0,1,1,0.01424,4,0.275514,0.296275,0
危机四伏(1948),危机四伏,notion,0,1,1,0,1,1,0.016752,4,0.279138,0.302165,0
危难(1948),危难,notion,0,1,1,0,1,1,0.01424,4,0.275514,0.296275,0
即将(1948),即将,notion,0,1,1,0,1,1,0.011322,4,0.269061,0.285394,0
即景(1948),即景,notion,0,2,2,0,2,2,0.021235,4,0.286701,0.314033,2523.953101
厂商(1948),厂商,notion,0,1,1,0,2,2,0.016752,4,0.279138,0.302165,0
厄尔(1948),厄尔,notion,0,1,1,0,1,1,0.005017,4,0.257497,0.26453,0
厄言(1948),厄言,notion,0,1,1,0,1,1,0.004718,4,0.258401,0.266227,0
历史性(1948),历史性,notion,0,1,1,0,1,1,0.009755,4,0.266617,0.281135,0
压不住(1948),压不住,notion,0,1,1,0,1,1,0.009739,4,0.265806,0.279704,0
压平(1948),压平,notion,0,1,1,0,1,1,0.01424,4,0.275514,0.296275,0
压得(1948),压得,notion,0,1,1,0,1,1,0.009739,4,0.265806,0.279704,0
压抑(1948),压抑,notion,0,1,1,0,1,1,0.011322,4,0.269061,0.285394,0
压轴戏(1948),压轴戏,notion,0,1,1,0,1,1,0.016752,4,0.279138,0.302165,0
压迫(1948),压迫,notion,0,2,2,0,2,2,0.022141,4,0.285959,0.312902,1122.074528
厌恶(1948),厌恶,notion,0,1,1,0,1,1,0.008247,4,0.26379,0.27611,0
原为(1948),原为,notion,0,2,2,0,2,2,0.008698,4,0.258507,0.266483,0.569098
原则(1948),原则,notion,0,4,4,0,6,6,0.043539,4,0.321742,0.361629,12104.977893
原原本本(1948),原原本本,notion,0,1,1,0,1,1,0.011322,4,0.269061,0.285394,0
原名(1948),原名,notion,0,1,1,0,1,1,0.011322,4,0.269061,0.285394,0
原子时代(1948),原子时代,notion,0,1,1,0,1,1,0.011322,4,0.269061,0.285394,0
原子能(1948),原子能,notion,0,2,2,0,3,3,0.018837,4,0.280346,0.304151,1468.125238
原形(1948),原形,notion,0,1,1,0,1,1,0.016518,4,0.278724,0.3015,0
原文(1948),原文,notion,0,1,1,0,1,1,0.009751,4,0.267186,0.282133,0
原来如此(1948),原来如此,notion,0,1,1,0,1,1,0.009739,4,0.265806,0.279704,0
原棉(1948),原棉,notion,0,1,1,0,1,1,0.004718,4,0.258401,0.266227,0
原班人马(1948),原班人马,notion,0,1,1,0,1,1,0.016518,4,0.278724,0.3015,0
原理(1948),原理,notion,0,1,1,0,1,1,0.007515,4,0.262793,0.274313,0
原路(1948),原路,notion,0,1,1,0,1,1,0.016752,4,0.279138,0.302165,0
原载(1948),原载,notion,0,1,1,0,1,1,0.01424,4,0.275514,0.296275,0
原野(1948),原野,notion,0,1,1,0,1,1,0.016752,4,0.279138,0.302165,0
原题(1948),原题,notion,0,1,1,0,1,1,0.016752,4,0.279138,0.302165,0
去了(1948),去了,notion,0,1,1,0,1,1,0.01424,4,0.275514,0.296275,0
去处(1948),去处,notion,0,1,1,0,1,1,0.009751,4,0.267186,0.282133,0
去夏(1948),去夏,notion,0,1,1,0,1,1,0.016752,4,0.279138,0.302165,0
去年(1948),去年,notion,0,1,1,0,2,2,0.016518,4,0.278724,0.3015,0
去职(1948),去职,notion,0,1,1,0,1,1,0.016752,4,0.279138,0.302165,0
县单(1948),县单,notion,0,1,1,0,1,1,0.004718,4,0.258401,0.266227,0
县政(1948),县政,notion,0,3,3,0,3,3,0.021984,4,0.287205,0.314854,5941.932804
县政府(1948),县政府,notion,0,1,1,0,1,1,0.004718,4,0.258401,0.266227,0
县联社(1948),县联社,notion,0,1,1,0,1,1,0.004718,4,0.258401,0.266227,0
县道(1948),县道,notion,0,1,1,0,1,1,0.004718,4,0.258401,0.266227,0
参军(1948),参军,notion,0,1,1,0,1,1,0.009751,4,0.267186,0.282133,0
参加(1948),参加,notion,0,4,4,0,6,6,0.04523,4,0.327978,0.369016,14917.912832
参政会(1948),参政会,notion,0,1,1,0,1,1,0.009739,4,0.265806,0.279704,0
参考资料(1948),参考资料,notion,0,1,1,0,2,2,0.009755,4,0.266617,0.281135,0
参观(1948),参观,notion,0,1,1,0,1,1,0.004718,4,0.258401,0.266227,0
参观记(1948),参观记,notion,0,1,1,0,1,1,0.016752,4,0.279138,0.302165,0
参议会(1948),参议会,notion,0,1,1,0,1,1,0.016518,4,0.278724,0.3015,0
参议员(1948),参议员,notion,0,1,1,0,1,1,0.007515,4,0.262793,0.274313,0
及早(1948),及早,notion,0,1,1,0,1,1,0.002332,4,0.253398,0.256677,0
友人(1948),友人,notion,0,1,1,0,1,1,0.01424,4,0.275514,0.296275,0
友谊(1948),友谊,notion,0,3,3,0,4,4,0.027741,4,0.29319,0.323739,4259.149398
双十(1948),双十,notion,0,1,1,0,1,1,0.016752,4,0.279138,0.302165,0
双十国庆(1948),双十国庆,notion,0,1,1,0,1,1,0.016752,4,0.279138,0.302165,0
双手(1948),双手,notion,0,1,1,0,1,1,0.009755,4,0.266617,0.281135,0
双方(1948),双方,notion,0,1,1,0,1,1,0.01424,4,0.275514,0.296275,0
双星(1948),双星,notion,0,2,2,0,2,2,0.008698,4,0.258507,0.266483,0.569098
双边(1948),双边,notion,0,1,1,0,1,1,0.016752,4,0.279138,0.302165,0
双边协定(1948),双边协定,notion,0,5,5,0,7,7,0.058262,4,0.341982,0.384678,15200.898698
反共(1948),反共,notion,0,2,2,0,2,2,0.030992,4,0.303936,0.338757,2912.385696
反动(1948),反动,notion,0,2,2,0,2,2,0.026272,4,0.29319,0.323683,1793.896368
反动派(1948),反动派,notion,0,4,4,0,9,9,0.041041,4,0.313708,0.351679,8332.554869
反华(1948),反华,notion,0,1,1,0,1,1,0.01424,4,0.275514,0.296275,0
反响(1948),反响,notion,0,2,2,0,2,2,0.030992,4,0.303936,0.338757,2912.385696
反常(1948),反常,notion,0,1,1,0,1,1,0.01424,4,0.275514,0.296275,0
反应(1948),反应,notion,0,1,1,0,1,1,0.016752,4,0.279138,0.302165,0
反扶日(1948),反扶日,notion,0,5,5,0,8,8,0.053063,4,0.334521,0.376525,15935.98893
反拨(1948),反拨,notion,0,1,1,0,1,1,0.016752,4,0.279138,0.302165,0
反攻(1948),反攻,notion,0,2,2,0,3,3,0.026269,4,0.293695,0.324415,1931.353166
反日(1948),反日,notion,0,1,1,0,1,1,0.016518,4,0.278724,0.3015,0
反映(1948),反映,notion,0,1,1,0,1,1,0.016752,4,0.279138,0.302165,0
反正(1948),反正,notion,0,1,1,0,1,1,0.009751,4,0.267186,0.282133,0
反民主(1948),反民主,notion,0,2,2,0,3,3,0.019494,4,0.280535,0.30445,1251.270065
反省(1948),反省,notion,0,1,1,0,4,4,0.009751,4,0.267186,0.282133,0
反美(1948),反美,notion,0,5,5,0,6,6,0.058247,4,0.33954,0.382049,13654.591532
反美帝(1948),反美帝,notion,0,1,1,0,1,1,0.016518,4,0.278724,0.3015,0
反苏(1948),反苏,notion,0,1,1,0,3,3,0.009755,4,0.266617,0.281135,0
反革命(1948),反革命,notion,0,1,1,0,1,1,0.01424,4,0.275514,0.296275,0
发人深思(1948),发人深思,notion,0,1,1,0,1,1,0.01022,4,0.267243,0.282233,0
发令员(1948),发令员,notion,0,1,1,0,1,1,0.009755,4,0.266617,0.281135,0
发出(1948),发出,notion,0,3,3,0,3,3,0.043021,4,0.321604,0.361407,6898.300577
发动群众(1948),发动群众,notion,0,1,1,0,1,1,0.009751,4,0.267186,0.282133,0
发哀吟(1948),发哀吟,notion,0,1,1,0,1,1,0.01424,4,0.275514,0.296275,0
发展前途(1948),发展前途,notion,0,1,1,0,1,1,0.01022,4,0.267243,0.282233,0
发展史(1948),发展史,notion,0,1,1,0,1,1,0.011322,4,0.269061,0.285394,0
发抖(1948),发抖,notion,0,1,1,0,1,1,0.016518,4,0.278724,0.3015,0
发挥(1948),发挥,notion,0,1,1,0,1,1,0.009751,4,0.267186,0.282133,0
发明人(1948),发明人,notion,0,1,1,0,1,1,0.016752,4,0.279138,0.302165,0
发横财(1948),发横财,notion,0,1,1,0,1,1,0.016518,4,0.278724,0.3015,0
发源地(1948),发源地,notion,0,1,1,0,1,1,0.009755,4,0.266617,0.281135,0
发现(1948),发现,notion,0,1,1,0,1,1,0.002332,4,0.253398,0.256677,0
发端(1948),发端,notion,0,1,1,0,1,1,0.004718,4,0.258401,0.266227,0
发表声明(1948),发表声明,notion,0,1,1,0,1,1,0.009739,4,0.265806,0.279704,0
发言人(1948),发言人,notion,0,2,2,0,3,3,0.026272,4,0.29319,0.323683,1793.896368
发财梦(1948),发财梦,notion,0,1,1,0,1,1,0.009751,4,0.267186,0.282133,0
发达(1948),发达,notion,0,1,1,0,1,1,0.01022,4,0.267243,0.282233,0
取宠(1948),取宠,notion,0,1,1,0,1,1,0.01424,4,0.275514,0.296275,0
取得(1948),取得,notion,0,1,1,0,1,1,0.016518,4,0.278724,0.3015,0
取材(1948),取材,notion,0,1,1,0,1,1,0.009751,4,0.267186,0.282133,0
取消(1948),取消,notion,0,1,1,0,1,1,0.008247,4,0.26379,0.27611,0
取缔(1948),取缔,notion,0,1,1,0,1,1,0.01424,4,0.275514,0.296275,0
受到(1948),受到,notion,0,1,1,0,1,1,0.009755,4,0.266617,0.281135,0
受施(1948),受施,notion,0,1,1,0,1,1,0.008247,4,0.26379,0.27611,0
受阻(1948),受阻,notion,0,2,2,0,2,2,0.014757,4,0.271708,0.289975,655.261449
受降(1948),受降,notion,0,1,1,0,1,1,0.01424,4,0.275514,0.296275,0
变不出(1948),变不出,notion,0,1,1,0,1,1,0.016518,4,0.278724,0.3015,0
变中(1948),变中,notion,0,1,1,0,1,1,0.016752,4,0.279138,0.302165,0
变乱(1948),变乱,notion,0,1,1,0,1,1,0.016752,4,0.279138,0.302165,0
变则通(1948),变则通,notion,0,1,1,0,1,1,0.009739,4,0.265806,0.279704,0
变动(1948),变动,notion,0,1,1,0,1,1,0.011322,4,0.269061,0.285394,0
变成(1948),变成,notion,0,1,1,0,1,1,0.009751,4,0.267186,0.282133,0
变更(1948),变更,notion,0,2,2,0,2,2,0.012905,4,0.270573,0.288045,1024.740512
变法(1948),变法,notion,0,1,1,0,1,1,0.009751,4,0.267186,0.282133,0
变色(1948),变色,notion,0,1,1,0,1,1,0.016752,4,0.279138,0.302165,0
变质(1948),变质,notion,0,1,1,0,1,1,0.01424,4,0.275514,0.296275,0
变起(1948),变起,notion,0,1,1,0,1,1,0.01022,4,0.267243,0.282233,0
变迁(1948),变迁,notion,0,2,2,0,2,2,0.017736,4,0.278993,0.301988,1631.559673
变革(1948),变革,notion,0,2,2,0,2,2,0.021542,4,0.284314,0.310373,1410.419447
叛兵(1948),叛兵,notion,0,1,1,0,1,1,0.01022,4,0.267243,0.282233,0
叛变(1948),叛变,notion,0,1,1,0,1,1,0.01022,4,0.267243,0.282233,0
叛徒(1948),叛徒,notion,0,2,2,0,2,2,0.026507,4,0.294224,0.325181,2012.895914
口中(1948),口中,notion,0,1,1,0,1,1,0.01424,4,0.275514,0.296275,0
口号(1948),口号,notion,0,3,3,0,5,5,0.036009,4,0.307318,0.343338,5103.645801
口拙(1948),口拙,notion,0,1,1,0,1,1,0.01424,4,0.275514,0.296275,0
口授(1948),口授,notion,0,1,1,0,1,1,0.01424,4,0.275514,0.296275,0
古人(1948),古人,notion,0,1,1,0,1,1,0.01424,4,0.275514,0.296275,0
古代(1948),古代,notion,0,1,1,0,1,1,0.007515,4,0.262793,0.274313,0
古城(1948),古城,notion,0,1,1,0,1,1,0.016752,4,0.279138,0.302165,0
古巴(1948),古巴,notion,0,1,1,0,1,1,0.009739,4,0.265806,0.279704,0
古谚(1948),古谚,notion,0,1,1,0,1,1,0.01424,4,0.275514,0.296275,0
古蹟(1948),古蹟,notion,0,1,1,0,1,1,0.01424,4,0.275514,0.296275,0
古迹(1948),古迹,notion,0,1,1,0,1,1,0.016752,4,0.279138,0.302165,0
另一面(1948),另一面,notion,0,1,1,0,1,1,0.016518,4,0.278724,0.3015,0
只为(1948),只为,notion,0,1,1,0,1,1,0.016752,4,0.279138,0.302165,0
只能(1948),只能,notion,0,1,1,0,1,1,0.016518,4,0.278724,0.3015,0
只要(1948),只要,notion,0,1,1,0,1,1,0.016518,4,0.278724,0.3015,0
只谈(1948),只谈,notion,0,1,1,0,1,1,0.005017,4,0.257497,0.26453,0
叫嚣(1948),叫嚣,notion,0,1,1,0,1,1,0.009755,4,0.266617,0.281135,0
叫屈(1948),叫屈,notion,0,1,1,0,1,1,0.011322,4,0.269061,0.285394,0
叫岗村(1948),叫岗村,notion,0,1,1,0,1,1,0.016518,4,0.278724,0.3015,0
召唤(1948),召唤,notion,0,1,1,0,1,1,0.009755,4,0.266617,0.281135,0
召开(1948),召开,notion,0,3,3,0,4,4,0.031756,4,0.29943,0.332623,3656.936897
召开大会(1948),召开大会,notion,0,1,1,0,1,1,0.009739,4,0.265806,0.279704,0
召集(1948),召集,notion,0,1,1,0,1,1,0.011322,4,0.269061,0.285394,0
叮噹(1948),叮噹,notion,0,1,1,0,1,1,0.016518,4,0.278724,0.3015,0
可不(1948),可不,notion,0,1,1,0,1,1,0.008247,4,0.26379,0.27611,0
可以(1948),可以,notion,0,4,4,0,8,8,0.048745,4,0.330663,0.372111,11884.431143
可分(1948),可分,notion,0,1,1,0,1,1,0.008247,4,0.26379,0.27611,0
可口可乐(1948),可口可乐,notion,0,1,1,0,1,1,0.016518,4,0.278724,0.3015,0
可哀(1948),可哀,notion,0,1,1,0,1,1,0.01022,4,0.267243,0.282233,0
可怕(1948),可怕,notion,0,2,2,0,2,2,0.017267,4,0.279595,0.302953,2297.821122
可怜(1948),可怜,notion,0,2,2,0,2,2,0.017267,4,0.279595,0.302953,2297.821122
可怜相(1948),可怜相,notion,0,1,1,0,1,1,0.008247,4,0.26379,0.27611,0
可汗(1948),可汗,notion,0,1,1,0,1,1,0.01424,4,0.275514,0.296275,0
可畏(1948),可畏,notion,0,1,1,0,1,1,0.016752,4,0.279138,0.302165,0
可知(1948),可知,notion,0,1,1,0,1,1,0.005017,4,0.257497,0.26453,0
可能(1948),可能,notion,0,2,2,0,2,2,0.017987,4,0.278331,0.300923,1351.046959
可虑(1948),可虑,notion,0,1,1,0,1,1,0.009751,4,0.267186,0.282133,0
可言(1948),可言,notion,0,1,1,0,1,1,0.01424,4,0.275514,0.296275,0
可诛(1948),可诛,notion,0,1,1,0,1,1,0.01424,4,0.275514,0.296275,0
可说是(1948),可说是,notion,0,1,1,0,1,1,0.009751,4,0.267186,0.282133,0
台下(1948),台下,notion,0,1,1,0,1,1,0.009751,4,0.267186,0.282133,0
台北(1948),台北,notion,0,4,4,0,6,6,0.034872,4,0.307067,0.343061,9721.854676
台湾人(1948),台湾人,notion,0,3,3,0,3,3,0.02545,4,0.285981,0.312991,1629.880666
台省(1948),台省,notion,0,1,1,0,1,1,0.016752,4,0.279138,0.302165,0
台糖(1948),台糖,notion,0,1,1,0,1,1,0.008247,4,0.26379,0.27611,0
台风(1948),台风,notion,0,1,1,0,1,1,0.016752,4,0.279138,0.302165,0
史上(1948),史上,notion,0,1,1,0,1,1,0.007515,4,0.262793,0.274313,0
史事(1948),史事,notion,0,1,1,0,1,1,0.007515,4,0.262793,0.274313,0
史大林宪法(1948),史大林宪法,notion,0,1,1,0,1,1,0.009755,4,0.266617,0.281135,0
史太林(1948),史太林,notion,0,1,1,0,1,1,0.007515,4,0.262793,0.274313,0
史学(1948),史学,notion,0,1,1,0,1,1,0.007515,4,0.262793,0.274313,0
史实(1948),史实,notion,0,2,2,0,2,2,0.01727,4,0.278352,0.300956,1619.09855
史特(1948),史特,notion,0,1,1,0,1,1,0.009739,4,0.265806,0.279704,0
史着(1948),史着,notion,0,1,1,0,1,1,0.01424,4,0.275514,0.296275,0
史籍(1948),史籍,notion,0,1,1,0,1,1,0.01424,4,0.275514,0.296275,0
史观(1948),史观,notion,0,1,1,0,1,1,0.01022,4,0.267243,0.282233,0
史达林(1948),史达林,notion,0,1,1,0,1,1,0.016752,4,0.279138,0.302165,0
史进(1948),史进,notion,0,1,1,0,1,1,0.009751,4,0.267186,0.282133,0
史迪威(1948),史迪威,notion,0,1,1,0,1,1,0.005389,4,0.25849,0.266394,0
史量(1948),史量,notion,0,1,1,0,1,1,0.007515,4,0.262793,0.274313,0
右翼(1948),右翼,notion,0,1,1,0,2,2,0.009755,4,0.266617,0.281135,0
叶凡(1948),叶凡,notion,0,1,1,0,1,1,0.009751,4,0.267186,0.282133,0
叶名琛(1948),叶名琛,notion,0,1,1,0,1,1,0.007515,4,0.262793,0.274313,0
号召(1948),号召,notion,0,4,4,0,5,5,0.041507,4,0.315182,0.353543,8874.021084
司令部(1948),司令部,notion,0,1,1,0,1,1,0.016518,4,0.278724,0.3015,0
司徒(1948),司徒,notion,0,4,4,0,9,9,0.044974,4,0.322654,0.362727,10816.664116
司徒雷登(1948),司徒雷登,notion,0,5,5,0,6,6,0.058259,4,0.34364,0.386441,16653.867721
司机(1948),司机,notion,0,1,1,0,1,1,0.004718,4,0.258401,0.266227,0
司法(1948),司法,notion,0,3,3,0,4,4,0.025216,4,0.286155,0.313257,1882.815007
司法独立(1948),司法独立,notion,0,1,1,0,1,1,0.016752,4,0.279138,0.302165,0
吁求(1948),吁求,notion,0,1,1,0,1,1,0.009739,4,0.265806,0.279704,0
吃药(1948),吃药,notion,0,1,1,0,1,1,0.007515,4,0.262793,0.274313,0
吃重(1948),吃重,notion,0,1,1,0,1,1,0.011322,4,0.269061,0.285394,0
吃饭(1948),吃饭,notion,0,2,2,0,2,2,0.021061,4,0.283157,0.308576,1336.570675
吃饭问题(1948),吃饭问题,notion,0,1,1,0,1,1,0.007515,4,0.262793,0.274313,0
各位(1948),各位,notion,0,1,1,0,1,1,0.016518,4,0.278724,0.3015,0
各党(1948),各党,notion,0,1,1,0,1,1,0.01022,4,0.267243,0.282233,0
各报(1948),各报,notion,0,1,1,0,1,1,0.009739,4,0.265806,0.279704,0
各方(1948),各方,notion,0,3,3,0,3,3,0.028824,4,0.294593,0.325769,3263.275062
各有(1948),各有,notion,0,1,1,0,1,1,0.01424,4,0.275514,0.296275,0
各派(1948),各派,notion,0,1,1,0,1,1,0.01022,4,0.267243,0.282233,0
各界(1948),各界,notion,0,4,4,0,4,4,0.050952,4,0.333274,0.375072,11674.334178
各省(1948),各省,notion,0,1,1,0,1,1,0.01424,4,0.275514,0.296275,0
各种(1948),各种,notion,0,1,1,0,1,1,0.01022,4,0.267243,0.282233,0
各院校(1948),各院校,notion,0,1,1,0,1,1,0.016752,4,0.279138,0.302165,0
合众社(1948),合众社,notion,0,1,1,0,1,1,0.016752,4,0.279138,0.302165,0
合作社(1948),合作社,notion,0,2,2,0,5,5,0.018958,4,0.283863,0.309674,3113.558811
合奏(1948),合奏,notion,0,1,1,0,1,1,0.009755,4,0.266617,0.281135,0
合拢(1948),合拢,notion,0,1,1,0,1,1,0.011322,4,0.269061,0.285394,0
合水(1948),合水,notion,0,1,1,0,1,1,0.009751,4,0.267186,0.282133,0
合流(1948),合流,notion,0,2,2,0,2,2,0.030992,4,0.303936,0.338757,2912.385696
合演(1948),合演,notion,0,1,1,0,1,1,0.01022,4,0.267243,0.282233,0
合理(1948),合理,notion,0,1,1,0,1,1,0.011322,4,0.269061,0.285394,0
合算(1948),合算,notion,0,1,1,0,1,1,0.011322,4,0.269061,0.285394,0
合肥(1948),合肥,notion,0,1,1,0,1,1,0.016752,4,0.279138,0.302165,0
吉洛(1948),吉洛,notion,0,1,1,0,1,1,0.007515,4,0.262793,0.274313,0
同乡(1948),同乡,notion,0,1,1,0,1,1,0.016518,4,0.278724,0.3015,0
同事(1948),同事,notion,0,1,1,0,1,1,0.016752,4,0.279138,0.302165,0
同僚(1948),同僚,notion,0,1,1,0,1,1,0.009755,4,0.266617,0.281135,0
同学们(1948),同学们,notion,0,1,1,0,1,1,0.009751,4,0.267186,0.282133,0
同志(1948),同志,notion,0,6,6,0,14,14,0.059999,4,0.350862,0.393984,29038.263704
同情(1948),同情,notion,0,3,3,0,4,4,0.040732,4,0.317178,0.355983,6314.893682
同意(1948),同意,notion,0,1,1,0,1,1,0.01424,4,0.275514,0.296275,0
同时(1948),同时,notion,0,1,1,0,1,1,0.008247,4,0.26379,0.27611,0
同样(1948),同样,notion,0,1,1,0,1,1,0.009751,4,0.267186,0.282133,0
同根(1948),同根,notion,0,1,1,0,1,1,0.005389,4,0.25849,0.266394,0
同治(1948),同治,notion,0,1,1,0,1,1,0.007515,4,0.262793,0.274313,0
同济大学(1948),同济大学,notion,0,1,1,0,1,1,0.016518,4,0.278724,0.3015,0
同盟会(1948),同盟会,notion,0,1,1,0,1,1,0.016752,4,0.279138,0.302165,0
同等(1948),同等,notion,0,1,1,0,1,1,0.009751,4,0.267186,0.282133,0
同胞(1948),同胞,notion,0,3,3,0,5,5,0.04751,4,0.331714,0.373253,8022.59349
同袍(1948),同袍,notion,0,1,1,0,1,1,0.01424,4,0.275514,0.296275,0
同路(1948),同路,notion,0,1,1,0,1,1,0.009755,4,0.266617,0.281135,0
名人(1948),名人,notion,0,1,1,0,2,2,0.01424,4,0.275514,0.296275,0
名利(1948),名利,notion,0,1,1,0,1,1,0.01424,4,0.275514,0.296275,0
名士风流(1948),名士风流,notion,0,1,1,0,1,1,0.01424,4,0.275514,0.296275,0
名字(1948),名字,notion,0,1,1,0,1,1,0.016518,4,0.278724,0.3015,0
名宿(1948),名宿,notion,0,1,1,0,1,1,0.01424,4,0.275514,0.296275,0
名山(1948),名山,notion,0,1,1,0,1,1,0.01424,4,0.275514,0.296275,0
名教授(1948),名教授,notion,0,1,1,0,1,1,0.009739,4,0.265806,0.279704,0
名流(1948),名流,notion,0,2,2,0,2,2,0.02398,4,0.290133,0.319191,1998.682918
名画(1948),名画,notion,0,1,1,0,1,1,0.01424,4,0.275514,0.296275,0
名词(1948),名词,notion,0,1,1,0,1,1,0.008247,4,0.26379,0.27611,0
后事(1948),后事,notion,0,1,1,0,1,1,0.016518,4,0.278724,0.3015,0
后和义(1948),后和义,notion,0,1,1,0,1,1,0.009755,4,0.266617,0.281135,0
后护(1948),后护,notion,0,1,1,0,1,1,0.005017,4,0.257497,0.26453,0
后方(1948),后方,notion,0,2,2,0,2,2,0.026257,4,0.292073,0.322053,1522.40889
后果(1948),后果,notion,0,2,2,0,2,2,0.024267,4,0.290987,0.320456,2179.633602
后生(1948),后生,notion,0,1,1,0,1,1,0.009751,4,0.267186,0.282133,0
后记(1948),后记,notion,0,1,1,0,1,1,0.009751,4,0.267186,0.282133,0
后面(1948),后面,notion,0,1,1,0,1,1,0.016518,4,0.278724,0.3015,0
吏治(1948),吏治,notion,0,1,1,0,1,1,0.007515,4,0.262793,0.274313,0
向前(1948),向前,notion,0,1,1,0,2,2,0.016518,4,0.278724,0.3015,0
向南(1948),向南,notion,0,1,1,0,1,1,0.016518,4,0.278724,0.3015,0
向左转(1948),向左转,notion,0,3,3,0,3,3,0.022938,4,0.283542,0.309231,2406.045322
向着(1948),向着,notion,0,2,2,0,2,2,0.021235,4,0.286701,0.314033,2523.953101
吓人(1948),吓人,notion,0,1,1,0,1,1,0.008247,4,0.26379,0.27611,0
吓住(1948),吓住,notion,0,1,1,0,1,1,0.016518,4,0.278724,0.3015,0
君的(1948),君的,notion,0,1,1,0,1,1,0.009751,4,0.267186,0.282133,0
吞吞吐吐(1948),吞吞吐吐,notion,0,1,1,0,1,1,0.01424,4,0.275514,0.296275,0
否决权(1948),否决权,notion,0,2,2,0,2,2,0.018002,4,0.27945,0.30272,1656.832374
否认(1948),否认,notion,0,1,1,0,1,1,0.016752,4,0.279138,0.302165,0
听审(1948),听审,notion,0,1,1,0,1,1,0.009739,4,0.265806,0.279704,0
听者(1948),听者,notion,0,1,1,0,1,1,0.01424,4,0.275514,0.296275,0
听话(1948),听话,notion,0,2,2,0,2,2,0.027839,4,0.295962,0.327676,1920.33989
启事(1948),启事,notion,0,1,1,0,1,1,0.011322,4,0.269061,0.285394,0
启发(1948),启发,notion,0,1,1,0,1,1,0.016752,4,0.279138,0.302165,0
启示(1948),启示,notion,0,2,2,0,2,2,0.010107,4,0.266447,0.280891,1166.286428
吴化(1948),吴化,notion,0,1,1,0,1,1,0.016752,4,0.279138,0.302165,0
吴化文(1948),吴化文,notion,0,1,1,0,2,2,0.016518,4,0.278724,0.3015,0
吴嘉棠(1948),吴嘉棠,notion,0,1,1,0,1,1,0.01022,4,0.267243,0.282233,0
吴国(1948),吴国,notion,0,1,1,0,1,1,0.011322,4,0.269061,0.285394,0
吴国桢(1948),吴国桢,notion,0,2,2,0,2,2,0.008698,4,0.258507,0.266483,0.569098
吴有训(1948),吴有训,notion,0,1,1,0,1,1,0.011322,4,0.269061,0.285394,0
吴靓云(1948),吴靓云,notion,0,1,1,0,1,1,0.004718,4,0.258401,0.266227,0
吸尽(1948),吸尽,notion,0,1,1,0,1,1,0.016518,4,0.278724,0.3015,0
吸收(1948),吸收,notion,0,1,1,0,1,1,0.008247,4,0.26379,0.27611,0
吹遍(1948),吹遍,notion,0,1,1,0,1,1,0.009739,4,0.265806,0.279704,0
吼声(1948),吼声,notion,0,1,1,0,1,1,0.005017,4,0.257497,0.26453,0
吾兄(1948),吾兄,notion,0,1,1,0,2,2,0.01424,4,0.275514,0.296275,0
吾国(1948),吾国,notion,0,2,2,0,3,3,0.021756,4,0.286964,0.314433,2044.761444
吾师(1948),吾师,notion,0,1,1,0,1,1,0.01022,4,0.267243,0.282233,0
吾爱(1948),吾爱,notion,0,1,1,0,1,1,0.01022,4,0.267243,0.282233,0
告一段落(1948),告一段落,notion,0,1,1,0,1,1,0.016752,4,0.279138,0.302165,0
告别(1948),告别,notion,0,1,1,0,1,1,0.009739,4,0.265806,0.279704,0
告急(1948),告急,notion,0,1,1,0,1,1,0.016752,4,0.279138,0.302165,0
告慰(1948),告慰,notion,0,1,1,0,1,1,0.005017,4,0.257497,0.26453,0
告警(1948),告警,notion,0,1,1,0,1,1,0.01022,4,0.267243,0.282233,0
呓语(1948),呓语,notion,0,1,1,0,1,1,0.01424,4,0.275514,0.296275,0
员工(1948),员工,notion,0,2,2,0,3,3,0.01996,4,0.281333,0.305715,1305.273912
呜呼(1948),呜呼,notion,0,1,1,0,1,1,0.01424,4,0.275514,0.296275,0
周佛海(1948),周佛海,notion,0,1,1,0,1,1,0.009751,4,0.267186,0.282133,0
周作人(1948),周作人,notion,0,1,1,0,1,1,0.01022,4,0.267243,0.282233,0
周先生(1948),周先生,notion,0,1,1,0,1,1,0.01424,4,0.275514,0.296275,0
周刊(1948),周刊,notion,0,2,2,0,2,2,0.023995,4,0.291507,0.321221,2493.732085
周在法(1948),周在法,notion,0,1,1,0,1,1,0.009739,4,0.265806,0.279704,0
周密(1948),周密,notion,0,1,1,0,1,1,0.009755,4,0.266617,0.281135,0
周年纪念(1948),周年纪念,notion,0,1,1,0,1,1,0.004718,4,0.258401,0.266227,0
周建人(1948),周建人,notion,0,1,1,0,1,1,0.01424,4,0.275514,0.296275,0
周旋(1948),周旋,notion,0,2,2,0,2,2,0.01561,4,0.274548,0.294734,907.836731
周未(1948),周未,notion,0,1,1,0,1,1,0.009751,4,0.267186,0.282133,0
周浦(1948),周浦,notion,0,1,1,0,2,2,0.004718,4,0.258401,0.266227,0
周行记(1948),周行记,notion,0,1,1,0,1,1,0.016752,4,0.279138,0.302165,0
周记(1948),周记,notion,0,1,1,0,1,1,0.009739,4,0.265806,0.279704,0
呼号(1948),呼号,notion,0,1,1,0,1,1,0.009739,4,0.265806,0.279704,0
呼唤(1948),呼唤,notion,0,3,3,0,4,4,0.026793,4,0.294339,0.325403,4178.136914
呼救(1948),呼救,notion,0,1,1,0,1,1,0.009751,4,0.267186,0.282133,0
呼救声(1948),呼救声,notion,0,1,1,0,1,1,0.009739,4,0.265806,0.279704,0
呼籲(1948),呼籲,notion,0,3,3,0,9,9,0.04208,4,0.32089,0.360542,6900.033893
命令(1948),命令,notion,0,2,2,0,2,2,0.027839,4,0.295962,0.327676,1920.33989
命定(1948),命定,notion,0,1,1,0,1,1,0.004718,4,0.258401,0.266227,0
命运(1948),命运,notion,0,4,4,0,8,8,0.048262,4,0.332154,0.373808,13262.507292
咀咒(1948),咀咒,notion,0,1,1,0,1,1,0.01424,4,0.275514,0.296275,0
咄咄逼人(1948),咄咄逼人,notion,0,1,1,0,1,1,0.011322,4,0.269061,0.285394,0
咆哮山庄(1948),咆哮山庄,notion,0,1,1,0,1,1,0.01022,4,0.267243,0.282233,0
和平共处(1948),和平共处,notion,0,1,1,0,1,1,0.008247,4,0.26379,0.27611,0
和平力量(1948),和平力量,notion,0,1,1,0,1,1,0.009755,4,0.266617,0.281135,0
和平建议(1948),和平建议,notion,0,1,1,0,1,1,0.016752,4,0.279138,0.302165,0
和平攻势(1948),和平攻势,notion,0,1,1,0,1,1,0.005017,4,0.257497,0.26453,0
和林(1948),和林,notion,0,1,1,0,1,1,0.01424,4,0.275514,0.296275,0
和棋(1948),和棋,notion,0,1,1,0,1,1,0.016518,4,0.278724,0.3015,0
和眞比(1948),和眞比,notion,0,1,1,0,1,1,0.011322,4,0.269061,0.285394,0
和约(1948),和约,notion,0,3,3,0,4,4,0.036246,4,0.306866,0.342739,4667.991046
和衷共济(1948),和衷共济,notion,0,1,1,0,1,1,0.01424,4,0.275514,0.296275,0
和谈(1948),和谈,notion,0,2,2,0,2,2,0.026972,4,0.293947,0.324781,1749.441854
咬文嚼字(1948),咬文嚼字,notion,0,1,1,0,1,1,0.009751,4,0.267186,0.282133,0
哀呼(1948),哀呼,notion,0,1,1,0,1,1,0.01424,4,0.275514,0.296275,0
哀哀(1948),哀哀,notion,0,1,1,0,1,1,0.005389,4,0.25849,0.266394,0
哀念(1948),哀念,notion,0,1,1,0,1,1,0.008247,4,0.26379,0.27611,0
哀悼(1948),哀悼,notion,0,1,1,0,1,1,0.011322,4,0.269061,0.285394,0
哀鸣(1948),哀鸣,notion,0,1,1,0,1,1,0.008247,4,0.26379,0.27611,0
哈尔滨(1948),哈尔滨,notion,0,1,1,0,1,1,0.016518,4,0.278724,0.3015,0
哥哥(1948),哥哥,notion,0,1,1,0,1,1,0.011322,4,0.269061,0.285394,0
哭佩弦(1948),哭佩弦,notion,0,2,2,0,2,2,0.008698,4,0.258507,0.266483,0.569098
哲学思想(1948),哲学思想,notion,0,2,2,0,2,2,0.019975,4,0.283071,0.308443,1854.710834
唁电(1948),唁电,notion,0,1,1,0,1,1,0.016518,4,0.278724,0.3015,0
唉呀(1948),唉呀,notion,0,1,1,0,1,1,0.016518,4,0.278724,0.3015,0
唐代(1948),唐代,notion,0,1,1,0,1,1,0.01022,4,0.267243,0.282233,0
唐山市(1948),唐山市,notion,0,2,2,0,2,2,0.013265,4,0.270534,0.287979,961.111373
唐甄(1948),唐甄,notion,0,2,2,0,2,2,0.008698,4,0.258507,0.266483,0.569098
唐申(1948),唐申,notion,0,1,1,0,1,1,0.007515,4,0.262793,0.274313,0
唐顺宗(1948),唐顺宗,notion,0,1,1,0,1,1,0.007515,4,0.262793,0.274313,0
唤起(1948),唤起,notion,0,1,1,0,1,1,0.007515,4,0.262793,0.274313,0
唱和(1948),唱和,notion,0,1,1,0,1,1,0.016752,4,0.279138,0.302165,0
商业(1948),商业,notion,0,2,2,0,2,2,0.024033,4,0.291281,0.320888,2559.028705
商务(1948),商务,notion,0,1,1,0,1,1,0.011322,4,0.269061,0.285394,0
商场(1948),商场,notion,0,1,1,0,1,1,0.016752,4,0.279138,0.302165,0
商女(1948),商女,notion,0,1,1,0,1,1,0.009739,4,0.265806,0.279704,0
商店(1948),商店,notion,0,1,1,0,2,2,0.016518,4,0.278724,0.3015,0
商榷(1948),商榷,notion,0,4,4,0,4,4,0.038724,4,0.312118,0.349649,10861.874045
商瘦(1948),商瘦,notion,0,1,1,0,1,1,0.01424,4,0.275514,0.296275,0
商股(1948),商股,notion,0,2,2,0,2,2,0.024765,4,0.291552,0.321288,2097.245087
商贾(1948),商贾,notion,0,1,1,0,1,1,0.011322,4,0.269061,0.285394,0
商量(1948),商量,notion,0,1,1,0,1,1,0.016518,4,0.278724,0.3015,0
啼痕(1948),啼痕,notion,0,1,1,0,1,1,0.016752,4,0.279138,0.302165,0
啼笑(1948),啼笑,notion,0,1,1,0,1,1,0.01424,4,0.275514,0.296275,0
啼笑皆非(1948),啼笑皆非,notion,0,1,1,0,1,1,0.016752,4,0.279138,0.302165,0
啼饥哀(1948),啼饥哀,notion,0,1,1,0,1,1,0.016752,4,0.279138,0.302165,0
喂饱(1948),喂饱,notion,0,1,1,0,1,1,0.016518,4,0.278724,0.3015,0
善於(1948),善於,notion,0,1,1,0,1,1,0.016518,4,0.278724,0.3015,0
喘息(1948),喘息,notion,0,1,1,0,1,1,0.004718,4,0.258401,0.266227,0
喜儿(1948),喜儿,notion,0,1,1,0,1,1,0.009751,4,0.267186,0.282133,0
喜剧(1948),喜剧,notion,0,1,1,0,1,1,0.016518,4,0.278724,0.3015,0
喻英奇(1948),喻英奇,notion,0,1,1,0,3,3,0.009751,4,0.267186,0.282133,0
嗜好(1948),嗜好,notion,0,1,1,0,1,1,0.01424,4,0.275514,0.296275,0
嘉州(1948),嘉州,notion,0,1,1,0,1,1,0.01424,4,0.275514,0.296275,0
嘴脸(1948),嘴脸,notion,0,1,1,0,1,1,0.016518,4,0.278724,0.3015,0
噩梦(1948),噩梦,notion,0,2,2,0,2,2,0.024999,4,0.291484,0.321188,1929.694181
噱头(1948),噱头,notion,0,1,1,0,1,1,0.01424,4,0.275514,0.296275,0
囚犯(1948),囚犯,notion,0,1,1,0,1,1,0.009755,4,0.266617,0.281135,0
四个(1948),四个,notion,0,2,2,0,2,2,0.019506,4,0.282731,0.307911,1903.779982
四事(1948),四事,notion,0,1,1,0,1,1,0.01424,4,0.275514,0.296275,0
四亿(1948),四亿,notion,0,1,1,0,1,1,0.009755,4,0.266617,0.281135,0
四八(1948),四八,notion,0,3,3,0,3,3,0.02117,4,0.282816,0.308099,2905.809948
四分法(1948),四分法,notion,0,1,1,0,3,3,0.011322,4,0.269061,0.285394,0
四十八(1948),四十八,notion,0,1,1,0,1,1,0.009751,4,0.267186,0.282133,0
四卷(1948),四卷,notion,0,1,1,0,2,2,0.011322,4,0.269061,0.285394,0
四周(1948),四周,notion,0,1,1,0,1,1,0.009751,4,0.267186,0.282133,0
四国(1948),四国,notion,0,2,2,0,2,2,0.023995,4,0.291507,0.321221,2493.732085
四处(1948),四处,notion,0,1,1,0,1,1,0.009751,4,0.267186,0.282133,0
四大(1948),四大,notion,0,1,1,0,1,1,0.016518,4,0.278724,0.3015,0
四大家族(1948),四大家族,notion,0,1,1,0,1,1,0.016518,4,0.278724,0.3015,0
四失(1948),四失,notion,0,1,1,0,1,1,0.016752,4,0.279138,0.302165,0
四川省(1948),四川省,notion,0,1,1,0,1,1,0.007515,4,0.262793,0.274313,0
四平(1948),四平,notion,0,1,1,0,1,1,0.002332,4,0.253398,0.256677,0
四年(1948),四年,notion,0,1,1,0,1,1,0.011322,4,0.269061,0.285394,0
四强(1948),四强,notion,0,2,2,0,2,2,0.026272,4,0.29319,0.323683,1793.896368
四战(1948),四战,notion,0,1,1,0,1,1,0.009751,4,0.267186,0.282133,0
四捷(1948),四捷,notion,0,1,1,0,1,1,0.009751,4,0.267186,0.282133,0
四时(1948),四时,notion,0,4,4,0,4,4,0.03024,4,0.291213,0.320899,3918.810743
四明山(1948),四明山,notion,0,1,1,0,1,1,0.016752,4,0.279138,0.302165,0
四次(1948),四次,notion,0,1,1,0,1,1,0.016752,4,0.279138,0.302165,0
四种(1948),四种,notion,0,1,1,0,1,1,0.011322,4,0.269061,0.285394,0
四章(1948),四章,notion,0,1,1,0,1,1,0.009755,4,0.266617,0.281135,0
四续(1948),四续,notion,0,1,1,0,1,1,0.004718,4,0.258401,0.266227,0
四行(1948),四行,notion,0,1,1,0,1,1,0.01022,4,0.267243,0.282233,0
四角(1948),四角,notion,0,1,1,0,1,1,0.011322,4,0.269061,0.285394,0
四顾(1948),四顾,notion,0,1,1,0,1,1,0.016518,4,0.278724,0.3015,0
回乡(1948),回乡,notion,0,1,1,0,1,1,0.004718,4,0.258401,0.266227,0
回到(1948),回到,notion,0,2,2,0,2,2,0.014769,4,0.273708,0.293336,1042.722106
回合(1948),回合,notion,0,2,2,0,2,2,0.022141,4,0.285959,0.312902,1122.074528
回国(1948),回国,notion,0,1,1,0,2,2,0.007515,4,0.262793,0.274313,0
回头是岸(1948),回头是岸,notion,0,1,1,0,1,1,0.016752,4,0.279138,0.302165,0
回忆(1948),回忆,notion,0,6,6,0,9,9,0.058996,4,0.343106,0.385931,22939.899905
回忆录(1948),回忆录,notion,0,1,1,0,1,1,0.011322,4,0.269061,0.285394,0
回教徒(1948),回教徒,notion,0,2,2,0,2,2,0.008698,4,0.258507,0.266483,0.569098
回来(1948),回来,notion,0,1,1,0,1,1,0.009755,4,0.266617,0.281135,0
回营(1948),回营,notion,0,1,1,0,1,1,0.009751,4,0.267186,0.282133,0
回顾(1948),回顾,notion,0,1,1,0,1,1,0.016752,4,0.279138,0.302165,0
因为(1948),因为,notion,0,1,1,0,1,1,0.01022,4,0.267243,0.282233,0
因士坦(1948),因士坦,notion,0,1,1,0,1,1,0.011322,4,0.269061,0.285394,0
因斯(1948),因斯,notion,0,1,1,0,1,1,0.011322,4,0.269061,0.285394,0
因果(1948),因果,notion,0,1,1,0,1,1,0.01424,4,0.275514,0.296275,0
因素(1948),因素,notion,0,1,1,0,2,2,0.011322,4,0.269061,0.285394,0
因缘(1948),因缘,notion,0,1,1,0,1,1,0.01424,4,0.275514,0.296275,0
团体(1948),团体,notion,0,7,7,0,11,11,0.07477,4,0.379195,0.42066,43175.436975
团保(1948),团保,notion,0,1,1,0,1,1,0.004718,4,0.258401,0.266227,0
团员(1948),团员,notion,0,1,1,0,1,1,0.005017,4,0.257497,0.26453,0
团结(1948),团结,notion,0,5,5,0,8,8,0.064097,4,0.356455,0.399519,20372.332668
团结起来(1948),团结起来,notion,0,3,3,0,3,3,0.036009,4,0.307318,0.343338,5103.645801
团队(1948),团队,notion,0,1,1,0,1,1,0.01424,4,0.275514,0.296275,0
团防(1948),团防,notion,0,1,1,0,1,1,0.011322,4,0.269061,0.285394,0
团集(1948),团集,notion,0,1,1,0,1,1,0.004718,4,0.258401,0.266227,0
囤粮(1948),囤粮,notion,0,1,1,0,1,1,0.005389,4,0.25849,0.266394,0
囤货(1948),囤货,notion,0,1,1,0,1,1,0.01424,4,0.275514,0.296275,0
困苦(1948),困苦,notion,0,1,1,0,1,1,0.01424,4,0.275514,0.296275,0
困难重重(1948),困难重重,notion,0,1,1,0,1,1,0.016518,4,0.278724,0.3015,0
围剿(1948),围剿,notion,0,2,2,0,2,2,0.026269,4,0.293695,0.324415,1931.353166
围城(1948),围城,notion,0,2,2,0,2,2,0.028074,4,0.296149,0.327943,1864.79583
围攻(1948),围攻,notion,0,1,1,0,1,1,0.01022,4,0.267243,0.282233,0
国事(1948),国事,notion,0,2,2,0,2,2,0.026972,4,0.293947,0.324781,1749.441854
国产(1948),国产,notion,0,1,1,0,1,1,0.01022,4,0.267243,0.282233,0
国代(1948),国代,notion,0,2,2,0,3,3,0.018837,4,0.280346,0.304151,1468.125238
国共(1948),国共,notion,0,1,1,0,1,1,0.007515,4,0.262793,0.274313,0
国内(1948),国内,notion,0,6,6,0,9,9,0.069475,4,0.359835,0.402868,22511.098571
国内外(1948),国内外,notion,0,2,2,0,2,2,0.019975,4,0.283071,0.308443,1854.710834
国军(1948),国军,notion,0,2,2,0,2,2,0.02398,4,0.290133,0.319191,1998.682918
国厚恩(1948),国厚恩,notion,0,1,1,0,1,1,0.01424,4,0.275514,0.296275,0
国外(1948),国外,notion,0,3,3,0,3,3,0.030816,4,0.298028,0.33066,4323.717798
国大代表(1948),国大代表,notion,0,1,1,0,1,1,0.011322,4,0.269061,0.285394,0
国家(1948),国家,notion,0,9,9,0,28,28,0.104309,4,0.434805,0.462931,66276.13276
国家兴亡(1948),国家兴亡,notion,0,1,1,0,1,1,0.01424,4,0.275514,0.296275,0
国家银行(1948),国家银行,notion,0,2,2,0,2,2,0.022488,4,0.288152,0.31623,2102.825587
国币(1948),国币,notion,0,1,1,0,1,1,0.01424,4,0.275514,0.296275,0
国师(1948),国师,notion,0,1,1,0,1,1,0.01022,4,0.267243,0.282233,0
国庆(1948),国庆,notion,0,2,2,0,2,2,0.021469,4,0.287095,0.314632,2527.522512
国庆日(1948),国庆日,notion,0,1,1,0,1,1,0.016752,4,0.279138,0.302165,0
国文(1948),国文,notion,0,1,1,0,1,1,0.009739,4,0.265806,0.279704,0
国有(1948),国有,notion,0,2,2,0,2,2,0.033269,4,0.305692,0.34112,2297.98609
国有化(1948),国有化,notion,0,2,2,0,2,2,0.014772,4,0.272635,0.291539,771.57337
国棉(1948),国棉,notion,0,1,1,0,1,1,0.01424,4,0.275514,0.296275,0
国民(1948),国民,notion,0,1,1,0,1,1,0.009755,4,0.266617,0.281135,0
国民党(1948),国民党,notion,0,6,6,0,9,9,0.058068,4,0.34192,0.384667,19747.416767
国民外交(1948),国民外交,notion,0,1,1,0,1,1,0.007515,4,0.262793,0.274313,0
国民大会(1948),国民大会,notion,0,4,4,0,4,4,0.036994,4,0.309546,0.346322,9081.203743
国民所得(1948),国民所得,notion,0,1,1,0,1,1,0.011322,4,0.269061,0.285394,0
国法(1948),国法,notion,0,2,2,0,2,2,0.025562,4,0.293259,0.323783,2167.4723
国泰民安(1948),国泰民安,notion,0,1,1,0,1,1,0.009739,4,0.265806,0.279704,0
国父(1948),国父,notion,0,3,3,0,3,3,0.028697,4,0.298621,0.331492,6845.702075
国王(1948),国王,notion,0,1,1,0,1,1,0.016518,4,0.278724,0.3015,0
国祯(1948),国祯,notion,0,1,1,0,1,1,0.005017,4,0.257497,0.26453,0
国立(1948),国立,notion,0,2,2,0,2,2,0.022141,4,0.285959,0.312902,1122.074528
国策(1948),国策,notion,0,1,1,0,1,1,0.016752,4,0.279138,0.302165,0
国粹(1948),国粹,notion,0,1,1,0,1,1,0.016752,4,0.279138,0.302165,0
国舅(1948),国舅,notion,0,1,1,0,1,1,0.005017,4,0.257497,0.26453,0
国营事业(1948),国营事业,notion,0,1,1,0,1,1,0.01424,4,0.275514,0.296275,0
国行(1948),国行,notion,0,1,1,0,1,1,0.009739,4,0.265806,0.279704,0
国讯(1948),国讯,notion,0,1,1,0,3,3,0.009739,4,0.265806,0.279704,0
国货(1948),国货,notion,0,1,1,0,1,1,0.016752,4,0.279138,0.302165,0
国运(1948),国运,notion,0,1,1,0,1,1,0.01424,4,0.275514,0.296275,0
国防部(1948),国防部,notion,0,1,1,0,1,1,0.016518,4,0.278724,0.3015,0
国际主义(1948),国际主义,notion,0,1,1,0,2,2,0.016518,4,0.278724,0.3015,0
国际劳工局(1948),国际劳工局,notion,0,1,1,0,1,1,0.008247,4,0.26379,0.27611,0
国际化(1948),国际化,notion,0,1,1,0,1,1,0.016752,4,0.279138,0.302165,0
国际友人(1948),国际友人,notion,0,1,1,0,1,1,0.016518,4,0.278724,0.3015,0
国际妇女节(1948),国际妇女节,notion,0,2,2,0,7,7,0.019494,4,0.280535,0.30445,1251.270065
国际局势(1948),国际局势,notion,0,3,3,0,3,3,0.038508,4,0.316031,0.354552,7136.780743
国际形势(1948),国际形势,notion,0,4,4,0,5,5,0.038752,4,0.31142,0.348751,8560.490949
国魂(1948),国魂,notion,0,1,1,0,2,2,0.016752,4,0.279138,0.302165,0
国魔(1948),国魔,notion,0,1,1,0,1,1,0.016752,4,0.279138,0.302165,0
图书馆(1948),图书馆,notion,0,2,2,0,2,2,0.012233,4,0.270573,0.288045,1678.569586
图画(1948),图画,notion,0,1,1,0,1,1,0.016752,4,0.279138,0.302165,0
图考(1948),图考,notion,0,1,1,0,1,1,0.01424,4,0.275514,0.296275,0
圈儿(1948),圈儿,notion,0,1,1,0,1,1,0.008247,4,0.26379,0.27611,0
圈圈(1948),圈圈,notion,0,1,1,0,1,1,0.016518,4,0.278724,0.3015,0
圈子裏(1948),圈子裏,notion,0,1,1,0,1,1,0.011322,4,0.269061,0.285394,0
圈甲长(1948),圈甲长,notion,0,1,1,0,1,1,0.004718,4,0.258401,0.266227,0
土共(1948),土共,notion,0,1,1,0,1,1,0.01022,4,0.267243,0.282233,0
土劣(1948),土劣,notion,0,1,1,0,1,1,0.016518,4,0.278724,0.3015,0
土匪(1948),土匪,notion,0,1,1,0,1,1,0.009739,4,0.265806,0.279704,0
土地法(1948),土地法,notion,0,2,2,0,2,2,0.02398,4,0.290133,0.319191,1998.682918
土崩(1948),土崩,notion,0,1,1,0,1,1,0.009751,4,0.267186,0.282133,0
土崩瓦解(1948),土崩瓦解,notion,0,1,1,0,1,1,0.011322,4,0.269061,0.285394,0
土改(1948),土改,notion,0,4,4,0,8,8,0.045227,4,0.328466,0.369582,15514.834444
土耳其(1948),土耳其,notion,0,1,1,0,1,1,0.008247,4,0.26379,0.27611,0
土蒋(1948),土蒋,notion,0,1,1,0,1,1,0.009751,4,0.267186,0.282133,0
土邦(1948),土邦,notion,0,1,1,0,1,1,0.011322,4,0.269061,0.285394,0
土革(1948),土革,notion,0,1,1,0,1,1,0.004718,4,0.258401,0.266227,0
圣彼德(1948),圣彼德,notion,0,1,1,0,1,1,0.016752,4,0.279138,0.302165,0
圣诞(1948),圣诞,notion,0,2,2,0,2,2,0.019972,4,0.283949,0.309807,2243.008915
圣雄甘地(1948),圣雄甘地,notion,0,1,1,0,1,1,0.009739,4,0.265806,0.279704,0
在乎(1948),在乎,notion,0,1,1,0,1,1,0.008247,4,0.26379,0.27611,0
在工作中(1948),在工作中,notion,0,1,1,0,1,1,0.009751,4,0.267186,0.282133,0
在日(1948),在日,notion,0,1,1,0,1,1,0.009755,4,0.266617,0.281135,0
在美(1948),在美,notion,0,1,1,0,1,1,0.005017,4,0.257497,0.26453,0
地下(1948),地下,notion,0,1,1,0,1,1,0.016518,4,0.278724,0.3015,0
地中海(1948),地中海,notion,0,2,2,0,2,2,0.024267,4,0.290987,0.320456,2179.633602
地主(1948),地主,notion,0,7,7,0,7,7,0.063952,4,0.35264,0.395836,31091.071385
地主阶级(1948),地主阶级,notion,0,1,1,0,1,1,0.008247,4,0.26379,0.27611,0
地位(1948),地位,notion,0,5,5,0,5,5,0.056506,4,0.348744,0.391765,22549.884167
地区(1948),地区,notion,0,2,2,0,2,2,0.026738,4,0.294408,0.325447,1993.868267
地变(1948),地变,notion,0,1,1,0,1,1,0.016752,4,0.279138,0.302165,0
地名(1948),地名,notion,0,1,1,0,1,1,0.011322,4,0.269061,0.285394,0
地图(1948),地图,notion,0,2,2,0,2,2,0.008698,4,0.258507,0.266483,0.569098
地大(1948),地大,notion,0,1,1,0,1,1,0.01424,4,0.275514,0.296275,0
地开(1948),地开,notion,0,1,1,0,1,1,0.016752,4,0.279138,0.302165,0
地方主义(1948),地方主义,notion,0,1,1,0,1,1,0.016518,4,0.278724,0.3015,0
地步(1948),地步,notion,0,2,2,0,2,2,0.017987,4,0.278331,0.300923,1351.046959
地狱(1948),地狱,notion,0,1,1,0,1,1,0.008247,4,0.26379,0.27611,0
地理(1948),地理,notion,0,1,1,0,1,1,0.016752,4,0.279138,0.302165,0
坐失良机(1948),坐失良机,notion,0,1,1,0,1,1,0.01022,4,0.267243,0.282233,0
坐牢(1948),坐牢,notion,0,2,2,0,2,2,0.027839,4,0.295962,0.327676,1920.33989
坚冰(1948),坚冰,notion,0,1,1,0,1,1,0.009739,4,0.265806,0.279704,0
坚决(1948),坚决,notion,0,1,1,0,1,1,0.005017,4,0.257497,0.26453,0
坚决执行(1948),坚决执行,notion,0,1,1,0,1,1,0.016518,4,0.278724,0.3015,0
坚定(1948),坚定,notion,0,3,3,0,4,4,0.036243,4,0.308707,0.345168,5722.670135
坚定信念(1948),坚定信念,notion,0,1,1,0,1,1,0.01424,4,0.275514,0.296275,0
坚强(1948),坚强,notion,0,2,2,0,2,2,0.030758,4,0.303347,0.337959,2812.221703
坚持(1948),坚持,notion,0,1,1,0,1,1,0.016752,4,0.279138,0.302165,0
坟墓(1948),坟墓,notion,0,1,1,0,1,1,0.016518,4,0.278724,0.3015,0
坦白(1948),坦白,notion,0,2,2,0,2,2,0.017999,4,0.280116,0.303785,1897.286008
垃圾(1948),垃圾,notion,0,2,2,0,2,2,0.026738,4,0.294408,0.325447,1993.868267
垃圾桶(1948),垃圾桶,notion,0,1,1,0,1,1,0.016518,4,0.278724,0.3015,0
垄断资本(1948),垄断资本,notion,0,1,1,0,1,1,0.016518,4,0.278724,0.3015,0
型态(1948),型态,notion,0,1,1,0,1,1,0.002332,4,0.253398,0.256677,0
埃及(1948),埃及,notion,0,1,1,0,1,1,0.009739,4,0.265806,0.279704,0
埃城(1948),埃城,notion,0,1,1,0,1,1,0.016518,4,0.278724,0.3015,0
埋头(1948),埋头,notion,0,1,1,0,1,1,0.008247,4,0.26379,0.27611,0
城下(1948),城下,notion,0,1,1,0,1,1,0.016752,4,0.279138,0.302165,0
城乡(1948),城乡,notion,0,4,4,0,4,4,0.026697,4,0.287403,0.315209,4831.703262
城内(1948),城内,notion,0,1,1,0,1,1,0.016518,4,0.278724,0.3015,0
城镇(1948),城镇,notion,0,1,1,0,1,1,0.016752,4,0.279138,0.302165,0
城阙(1948),城阙,notion,0,1,1,0,1,1,0.01424,4,0.275514,0.296275,0
基地(1948),基地,notion,0,2,2,0,3,3,0.014472,4,0.274708,0.295,2180.550764
基斯(1948),基斯,notion,0,1,1,0,1,1,0.007515,4,0.262793,0.274313,0
基本(1948),基本,notion,0,6,6,0,9,9,0.073024,4,0.379157,0.420571,34247.718918
基本纲领(1948),基本纲领,notion,0,1,1,0,1,1,0.004718,4,0.258401,0.266227,0
基洛夫(1948),基洛夫,notion,0,1,1,0,1,1,0.009755,4,0.266617,0.281135,0
基準(1948),基準,notion,0,1,1,0,1,1,0.01424,4,0.275514,0.296275,0
基着(1948),基着,notion,0,1,1,0,1,1,0.009755,4,0.266617,0.281135,0
基石(1948),基石,notion,0,1,1,0,1,1,0.009755,4,0.266617,0.281135,0
基隆(1948),基隆,notion,0,1,1,0,2,2,0.016518,4,0.278724,0.3015,0
堕落(1948),堕落,notion,0,1,1,0,1,1,0.009755,4,0.266617,0.281135,0
堤围(1948),堤围,notion,0,1,1,0,1,1,0.009751,4,0.267186,0.282133,0
堪虞(1948),堪虞,notion,0,2,2,0,2,2,0.024461,4,0.291756,0.321587,2304.72473
塔斯社(1948),塔斯社,notion,0,2,2,0,2,2,0.026272,4,0.29319,0.323683,1793.896368
塞上(1948),塞上,notion,0,1,1,0,1,1,0.01022,4,0.267243,0.282233,0
塞外(1948),塞外,notion,0,1,1,0,1,1,0.005389,4,0.25849,0.266394,0
墙壁(1948),墙壁,notion,0,1,1,0,1,1,0.016752,4,0.279138,0.302165,0
增产(1948),增产,notion,0,3,3,0,3,3,0.018919,4,0.274568,0.294822,1295.743183
增加(1948),增加,notion,0,1,1,0,1,1,0.011322,4,0.269061,0.285394,0
增设(1948),增设,notion,0,1,1,0,2,2,0.011322,4,0.269061,0.285394,0
增辟(1948),增辟,notion,0,1,1,0,1,1,0.01022,4,0.267243,0.282233,0
墨西(1948),墨西,notion,0,1,1,0,1,1,0.016752,4,0.279138,0.302165,0
士兵(1948),士兵,notion,0,2,2,0,2,2,0.023992,4,0.29271,0.322985,3168.205568
士大夫(1948),士大夫,notion,0,3,3,0,4,4,0.018919,4,0.274568,0.294822,1295.743183
士气(1948),士气,notion,0,1,1,0,1,1,0.01424,4,0.275514,0.296275,0
壮丁(1948),壮丁,notion,0,2,2,0,3,3,0.021542,4,0.284314,0.310373,1410.419447
声中(1948),声中,notion,0,1,1,0,2,2,0.01022,4,0.267243,0.282233,0
声中话(1948),声中话,notion,0,1,1,0,2,2,0.016752,4,0.279138,0.302165,0
声光(1948),声光,notion,0,1,1,0,1,1,0.008247,4,0.26379,0.27611,0
声张(1948),声张,notion,0,1,1,0,1,1,0.016518,4,0.278724,0.3015,0
声明(1948),声明,notion,0,5,5,0,14,14,0.049992,4,0.32815,0.369271,14386.644981
声调(1948),声调,notion,0,1,1,0,1,1,0.01022,4,0.267243,0.282233,0
声音(1948),声音,notion,0,3,3,0,3,3,0.030975,4,0.300196,0.333688,5779.822337
处分(1948),处分,notion,0,1,1,0,1,1,0.002332,4,0.253398,0.256677,0
处境(1948),处境,notion,0,2,2,0,2,2,0.01996,4,0.281333,0.305715,1305.273912
处理(1948),处理,notion,0,4,4,0,5,5,0.033697,4,0.29817,0.330915,4720.340464
备受(1948),备受,notion,0,1,1,0,1,1,0.016752,4,0.279138,0.302165,0
备战(1948),备战,notion,0,2,2,0,4,4,0.026972,4,0.293947,0.324781,1749.441854
复刊(1948),复刊,notion,0,1,1,0,1,1,0.01022,4,0.267243,0.282233,0
复华(1948),复华,notion,0,1,1,0,1,1,0.009739,4,0.265806,0.279704,0
复员(1948),复员,notion,0,1,1,0,1,1,0.009739,4,0.265806,0.279704,0
复旦(1948),复旦,notion,0,2,2,0,2,2,0.033269,4,0.305692,0.34112,2297.98609
复活(1948),复活,notion,0,6,6,0,8,8,0.069336,4,0.364833,0.407627,25437.460188
夏季(1948),夏季,notion,0,1,1,0,1,1,0.016518,4,0.278724,0.3015,0
夏日(1948),夏日,notion,0,1,1,0,1,1,0.008247,4,0.26379,0.27611,0
夏景(1948),夏景,notion,0,1,1,0,1,1,0.008247,4,0.26379,0.27611,0
夏洛宫(1948),夏洛宫,notion,0,1,1,0,1,1,0.005017,4,0.257497,0.26453,0
夏虫疑冰(1948),夏虫疑冰,notion,0,1,1,0,1,1,0.01022,4,0.267243,0.282233,0
夔门(1948),夔门,notion,0,1,1,0,1,1,0.002332,4,0.253398,0.256677,0
外交(1948),外交,notion,0,11,11,0,22,22,0.107804,4,0.430421,0.460114,73589.381291
外交事务(1948),外交事务,notion,0,1,1,0,1,1,0.009755,4,0.266617,0.281135,0
外交家(1948),外交家,notion,0,1,1,0,1,1,0.009755,4,0.266617,0.281135,0
外人(1948),外人,notion,0,2,2,0,2,2,0.021756,4,0.286964,0.314433,2044.761444
外勤(1948),外勤,notion,0,1,1,0,1,1,0.004718,4,0.258401,0.266227,0
外围(1948),外围,notion,0,1,1,0,1,1,0.01022,4,0.267243,0.282233,0
外国(1948),外国,notion,0,2,2,0,3,3,0.025562,4,0.293259,0.323783,2167.4723
外币(1948),外币,notion,0,2,2,0,2,2,0.022141,4,0.285959,0.312902,1122.074528
外患(1948),外患,notion,0,1,1,0,1,1,0.005389,4,0.25849,0.266394,0
外援(1948),外援,notion,0,2,2,0,2,2,0.01561,4,0.274548,0.294734,907.836731
外汇(1948),外汇,notion,0,1,1,0,1,1,0.007515,4,0.262793,0.274313,0
外相(1948),外相,notion,0,1,1,0,1,1,0.01424,4,0.275514,0.296275,0
外资(1948),外资,notion,0,1,1,0,1,1,0.01424,4,0.275514,0.296275,0
外长(1948),外长,notion,0,3,3,0,3,3,0.031495,4,0.301642,0.335685,5382.307293
多么(1948),多么,notion,0,1,1,0,1,1,0.005017,4,0.257497,0.26453,0
多事(1948),多事,notion,0,1,1,0,1,1,0.01022,4,0.267243,0.282233,0
多多益善(1948),多多益善,notion,0,1,1,0,1,1,0.01424,4,0.275514,0.296275,0
多少(1948),多少,notion,0,1,1,0,2,2,0.011322,4,0.269061,0.285394,0
多线(1948),多线,notion,0,1,1,0,1,1,0.01022,4,0.267243,0.282233,0
多脑(1948),多脑,notion,0,1,1,0,1,1,0.01424,4,0.275514,0.296275,0
多边(1948),多边,notion,0,1,1,0,1,1,0.016752,4,0.279138,0.302165,0
多长(1948),多长,notion,0,1,1,0,1,1,0.016518,4,0.278724,0.3015,0
多阻(1948),多阻,notion,0,1,1,0,1,1,0.01424,4,0.275514,0.296275,0
多难(1948),多难,notion,0,3,3,0,4,4,0.033325,4,0.306791,0.342639,5264.071928
夜宴(1948),夜宴,notion,0,1,1,0,1,1,0.01424,4,0.275514,0.296275,0
夜景(1948),夜景,notion,0,1,1,0,1,1,0.009739,4,0.265806,0.279704,0
夜校(1948),夜校,notion,0,2,2,0,2,2,0.021235,4,0.286701,0.314033,2523.953101
夜长梦多(1948),夜长梦多,notion,0,1,1,0,1,1,0.016752,4,0.279138,0.302165,0
大三(1948),大三,notion,0,1,1,0,1,1,0.016752,4,0.279138,0.302165,0
大中(1948),大中,notion,0,1,1,0,1,1,0.009739,4,0.265806,0.279704,0
大中小(1948),大中小,notion,0,1,1,0,1,1,0.016518,4,0.278724,0.3015,0
大为(1948),大为,notion,0,1,1,0,1,1,0.009739,4,0.265806,0.279704,0
大乱(1948),大乱,notion,0,1,1,0,1,1,0.016518,4,0.278724,0.3015,0
大事(1948),大事,notion,0,1,1,0,1,1,0.009751,4,0.267186,0.282133,0
大二(1948),大二,notion,0,1,1,0,1,1,0.016518,4,0.278724,0.3015,0
大亨(1948),大亨,notion,0,1,1,0,1,1,0.016752,4,0.279138,0.302165,0
大众(1948),大众,notion,0,1,1,0,1,1,0.009739,4,0.265806,0.279704,0
大众化(1948),大众化,notion,0,1,1,0,1,1,0.016752,4,0.279138,0.302165,0
大会战(1948),大会战,notion,0,1,1,0,1,1,0.016752,4,0.279138,0.302165,0
大作(1948),大作,notion,0,1,1,0,1,1,0.016752,4,0.279138,0.302165,0
大使(1948),大使,notion,0,5,5,0,7,7,0.042979,4,0.314786,0.353099,12194.008047
大使馆(1948),大使馆,notion,0,1,1,0,1,1,0.016752,4,0.279138,0.302165,0
大侠(1948),大侠,notion,0,1,1,0,1,1,0.016752,4,0.279138,0.302165,0
大关(1948),大关,notion,0,1,1,0,1,1,0.01022,4,0.267243,0.282233,0
大兵(1948),大兵,notion,0,1,1,0,1,1,0.01424,4,0.275514,0.296275,0
大势(1948),大势,notion,0,1,1,0,1,1,0.016752,4,0.279138,0.302165,0
大南山(1948),大南山,notion,0,1,1,0,1,1,0.009751,4,0.267186,0.282133,0
大变(1948),大变,notion,0,1,1,0,1,1,0.016752,4,0.279138,0.302165,0
大国(1948),大国,notion,0,3,3,0,4,4,0.03452,4,0.306241,0.341907,5547.973829
大地回春(1948),大地回春,notion,0,1,1,0,1,1,0.009751,4,0.267186,0.282133,0
大城市(1948),大城市,notion,0,2,2,0,3,3,0.026269,4,0.293695,0.324415,1931.353166
大埔(1948),大埔,notion,0,1,1,0,1,1,0.016518,4,0.278724,0.3015,0
大妹(1948),大妹,notion,0,1,1,0,1,1,0.009751,4,0.267186,0.282133,0
大娘(1948),大娘,notion,0,1,1,0,1,1,0.009751,4,0.267186,0.282133,0
大学教授(1948),大学教授,notion,0,2,2,0,2,2,0.021542,4,0.284314,0.310373,1410.419447
大官(1948),大官,notion,0,1,1,0,1,1,0.009751,4,0.267186,0.282133,0
大家(1948),大家,notion,0,3,3,0,3,3,0.031209,4,0.300124,0.333588,5664.807925
大局(1948),大局,notion,0,5,5,0,10,10,0.046992,4,0.317554,0.35656,9162.359996
大屠杀(1948),大屠杀,notion,0,1,1,0,1,1,0.016518,4,0.278724,0.3015,0
大巴山(1948),大巴山,notion,0,2,2,0,2,2,0.026257,4,0.292073,0.322053,1522.40889
大开(1948),大开,notion,0,1,1,0,1,1,0.016518,4,0.278724,0.3015,0
大快人心(1948),大快人心,notion,0,1,1,0,1,1,0.01424,4,0.275514,0.296275,0
大总统(1948),大总统,notion,0,1,1,0,1,1,0.01424,4,0.275514,0.296275,0
大批(1948),大批,notion,0,1,1,0,1,1,0.01022,4,0.267243,0.282233,0
大拍卖(1948),大拍卖,notion,0,1,1,0,1,1,0.005017,4,0.257497,0.26453,0
大捕(1948),大捕,notion,0,1,1,0,1,1,0.011322,4,0.269061,0.285394,0
大旗(1948),大旗,notion,0,2,2,0,2,2,0.026272,4,0.29319,0.323683,1793.896368
大本营(1948),大本营,notion,0,1,1,0,1,1,0.009755,4,0.266617,0.281135,0
大步(1948),大步,notion,0,1,1,0,1,1,0.016518,4,0.278724,0.3015,0
大法官(1948),大法官,notion,0,1,1,0,1,1,0.008247,4,0.26379,0.27611,0
大洪山(1948),大洪山,notion,0,1,1,0,1,1,0.016518,4,0.278724,0.3015,0
大涨(1948),大涨,notion,0,1,1,0,1,1,0.01424,4,0.275514,0.296275,0
大炮(1948),大炮,notion,0,1,1,0,1,1,0.009755,4,0.266617,0.281135,0
大爷(1948),大爷,notion,0,1,1,0,1,1,0.008247,4,0.26379,0.27611,0
大生产(1948),大生产,notion,0,1,1,0,1,1,0.01424,4,0.275514,0.296275,0
大纲(1948),大纲,notion,0,3,3,0,4,4,0.031495,4,0.301642,0.335685,5382.307293
大维(1948),大维,notion,0,1,1,0,1,1,0.01022,4,0.267243,0.282233,0
大胆(1948),大胆,notion,0,1,1,0,1,1,0.01424,4,0.275514,0.296275,0
大英帝国(1948),大英帝国,notion,0,1,1,0,1,1,0.009755,4,0.266617,0.281135,0
大街(1948),大街,notion,0,1,1,0,1,1,0.007515,4,0.262793,0.274313,0
大西北(1948),大西北,notion,0,1,1,0,1,1,0.016518,4,0.278724,0.3015,0
大西洋(1948),大西洋,notion,0,1,1,0,1,1,0.016752,4,0.279138,0.302165,0
大观(1948),大观,notion,0,1,1,0,1,1,0.009751,4,0.267186,0.282133,0
大谈其(1948),大谈其,notion,0,1,1,0,1,1,0.016752,4,0.279138,0.302165,0
大谋(1948),大谋,notion,0,1,1,0,1,1,0.016752,4,0.279138,0.302165,0
大赦(1948),大赦,notion,0,1,1,0,1,1,0.007515,4,0.262793,0.274313,0
大跃进(1948),大跃进,notion,0,1,1,0,1,1,0.009751,4,0.267186,0.282133,0
大道(1948),大道,notion,0,1,1,0,1,1,0.008247,4,0.26379,0.27611,0
大量(1948),大量,notion,0,1,1,0,1,1,0.01424,4,0.275514,0.296275,0
大鉴(1948),大鉴,notion,0,1,1,0,2,2,0.01424,4,0.275514,0.296275,0
大钞(1948),大钞,notion,0,4,4,0,5,5,0.036537,4,0.303127,0.33777,5015.80301
大陆(1948),大陆,notion,0,1,1,0,1,1,0.016752,4,0.279138,0.302165,0
大雪(1948),大雪,notion,0,1,1,0,1,1,0.009739,4,0.265806,0.279704,0
大革命(1948),大革命,notion,0,1,1,0,1,1,0.016518,4,0.278724,0.3015,0
大额(1948),大额,notion,0,1,1,0,1,1,0.008247,4,0.26379,0.27611,0
大鱼吃小鱼(1948),大鱼吃小鱼,notion,0,1,1,0,1,1,0.009755,4,0.266617,0.281135,0
天下乌鸦一般黑(1948),天下乌鸦一般黑,notion,0,1,1,0,1,1,0.016752,4,0.279138,0.302165,0
天下事(1948),天下事,notion,0,1,1,0,2,2,0.01424,4,0.275514,0.296275,0
天主教徒(1948),天主教徒,notion,0,1,1,0,1,1,0.009751,4,0.267186,0.282133,0
天亮(1948),天亮,notion,0,1,1,0,1,1,0.016518,4,0.278724,0.3015,0
天到(1948),天到,notion,0,1,1,0,1,1,0.016518,4,0.278724,0.3015,0
天地(1948),天地,notion,0,1,1,0,1,1,0.008247,4,0.26379,0.27611,0
天堂(1948),天堂,notion,0,2,2,0,2,2,0.024999,4,0.291484,0.321188,1929.694181
天天(1948),天天,notion,0,1,1,0,1,1,0.009751,4,0.267186,0.282133,0
天寒(1948),天寒,notion,0,1,1,0,1,1,0.01022,4,0.267243,0.282233,0
天山(1948),天山,notion,0,1,1,0,1,1,0.002332,4,0.253398,0.256677,0
天山南北(1948),天山南北,notion,0,1,1,0,1,1,0.008247,4,0.26379,0.27611,0
天才(1948),天才,notion,0,2,2,0,2,2,0.014472,4,0.274708,0.295,2180.550764
天文数字(1948),天文数字,notion,0,1,1,0,1,1,0.01424,4,0.275514,0.296275,0
天时地利人和(1948),天时地利人和,notion,0,1,1,0,1,1,0.01424,4,0.275514,0.296275,0
天气(1948),天气,notion,0,1,1,0,1,1,0.01424,4,0.275514,0.296275,0
天灾(1948),天灾,notion,0,2,2,0,2,2,0.033269,4,0.305692,0.34112,2297.98609
天真(1948),天真,notion,0,1,1,0,1,1,0.016752,4,0.279138,0.302165,0
天良(1948),天良,notion,0,1,1,0,1,1,0.01424,4,0.275514,0.296275,0
天顶(1948),天顶,notion,0,1,1,0,1,1,0.009751,4,0.267186,0.282133,0
太凶了(1948),太凶了,notion,0,1,1,0,1,1,0.01424,4,0.275514,0.296275,0
太大(1948),太大,notion,0,1,1,0,1,1,0.01424,4,0.275514,0.296275,0
太太(1948),太太,notion,0,1,1,0,1,1,0.016518,4,0.278724,0.3015,0
太子(1948),太子,notion,0,1,1,0,1,1,0.016518,4,0.278724,0.3015,0
太少(1948),太少,notion,0,1,1,0,1,1,0.01424,4,0.275514,0.296275,0
太平(1948),太平,notion,0,3,3,0,3,3,0.037813,4,0.309012,0.345568,4605.191573
太平军(1948),太平军,notion,0,1,1,0,1,1,0.007515,4,0.262793,0.274313,0
太平天国(1948),太平天国,notion,0,1,1,0,1,1,0.007515,4,0.262793,0.274313,0
太早(1948),太早,notion,0,1,1,0,1,1,0.016518,4,0.278724,0.3015,0
太晚(1948),太晚,notion,0,1,1,0,1,1,0.009739,4,0.265806,0.279704,0
夫人(1948),夫人,notion,0,2,2,0,3,3,0.019569,4,0.280598,0.30455,1193.220239
夫在(1948),夫在,notion,0,1,1,0,1,1,0.009755,4,0.266617,0.281135,0
夫妻(1948),夫妻,notion,0,1,1,0,1,1,0.016752,4,0.279138,0.302165,0
夫编(1948),夫编,notion,0,1,1,0,1,1,0.009755,4,0.266617,0.281135,0
失业问题(1948),失业问题,notion,0,1,1,0,1,1,0.008247,4,0.26379,0.27611,0
失事(1948),失事,notion,0,1,1,0,1,1,0.01022,4,0.267243,0.282233,0
失去(1948),失去,notion,0,3,3,0,3,3,0.042314,4,0.321357,0.361107,6944.653827
失学(1948),失学,notion,0,3,3,0,3,3,0.043009,4,0.318172,0.357214,5224.220047
失守(1948),失守,notion,0,2,2,0,2,2,0.021542,4,0.284314,0.310373,1410.419447
失实(1948),失实,notion,0,1,1,0,1,1,0.01022,4,0.267243,0.282233,0
失常(1948),失常,notion,0,1,1,0,1,1,0.011322,4,0.269061,0.285394,0
失当(1948),失当,notion,0,1,1,0,1,1,0.008247,4,0.26379,0.27611,0
失态(1948),失态,notion,0,1,1,0,1,1,0.01022,4,0.267243,0.282233,0
失灵(1948),失灵,notion,0,1,1,0,1,1,0.008247,4,0.26379,0.27611,0
失眠症(1948),失眠症,notion,0,1,1,0,1,1,0.01424,4,0.275514,0.296275,0
失败(1948),失败,notion,0,7,7,0,8,8,0.067826,4,0.363597,0.406518,39961.326084
失陷(1948),失陷,notion,0,1,1,0,1,1,0.011322,4,0.269061,0.285394,0
头子(1948),头子,notion,0,1,1,0,1,1,0.009755,4,0.266617,0.281135,0
夷区(1948),夷区,notion,0,1,1,0,1,1,0.01424,4,0.275514,0.296275,0
夹缝(1948),夹缝,notion,0,1,1,0,1,1,0.016752,4,0.279138,0.302165,0
夺回(1948),夺回,notion,0,1,1,0,1,1,0.009755,4,0.266617,0.281135,0
奇侠(1948),奇侠,notion,0,1,1,0,1,1,0.009751,4,0.267186,0.282133,0
奇想(1948),奇想,notion,0,1,1,0,1,1,0.016518,4,0.278724,0.3015,0
奇缘(1948),奇缘,notion,0,1,1,0,1,1,0.009739,4,0.265806,0.279704,0
奇荒(1948),奇荒,notion,0,1,1,0,1,1,0.01022,4,0.267243,0.282233,0
奇迹(1948),奇迹,notion,0,1,1,0,1,1,0.016752,4,0.279138,0.302165,0
奉劝(1948),奉劝,notion,0,1,1,0,1,1,0.009751,4,0.267186,0.282133,0
奋斗(1948),奋斗,notion,0,4,4,0,5,5,0.036242,4,0.307796,0.344026,9613.973575
奋鬥(1948),奋鬥,notion,0,1,1,0,3,3,0.016518,4,0.278724,0.3015,0
契诃夫(1948),契诃夫,notion,0,1,1,0,1,1,0.011322,4,0.269061,0.285394,0
奖励(1948),奖励,notion,0,1,1,0,1,1,0.005389,4,0.25849,0.266394,0
奖品(1948),奖品,notion,0,1,1,0,1,1,0.007515,4,0.262793,0.274313,0
奖金(1948),奖金,notion,0,1,1,0,1,1,0.009755,4,0.266617,0.281135,0
奥古斯丁(1948),奥古斯丁,notion,0,1,1,0,1,1,0.008247,4,0.26379,0.27611,0
奥秘(1948),奥秘,notion,0,1,1,0,1,1,0.009739,4,0.265806,0.279704,0
女子(1948),女子,notion,0,1,1,0,1,1,0.009755,4,0.266617,0.281135,0
女工(1948),女工,notion,0,1,1,0,3,3,0.009751,4,0.267186,0.282133,0
女战士(1948),女战士,notion,0,1,1,0,1,1,0.009755,4,0.266617,0.281135,0
女节(1948),女节,notion,0,1,1,0,1,1,0.009739,4,0.265806,0.279704,0
奴性(1948),奴性,notion,0,2,2,0,2,2,0.017736,4,0.278993,0.301988,1631.559673
奴隶制度(1948),奴隶制度,notion,0,1,1,0,1,1,0.009755,4,0.266617,0.281135,0
奶头(1948),奶头,notion,0,1,1,0,1,1,0.011322,4,0.269061,0.285394,0
奸商(1948),奸商,notion,0,1,1,0,2,2,0.01424,4,0.275514,0.296275,0
好书(1948),好书,notion,0,1,1,0,1,1,0.009751,4,0.267186,0.282133,0
好人(1948),好人,notion,0,2,2,0,2,2,0.024267,4,0.290987,0.320456,2179.633602
好好(1948),好好,notion,0,1,1,0,1,1,0.009751,4,0.267186,0.282133,0
好心(1948),好心,notion,0,1,1,0,1,1,0.009755,4,0.266617,0.281135,0
好战(1948),好战,notion,0,1,1,0,1,1,0.009739,4,0.265806,0.279704,0
好消息(1948),好消息,notion,0,1,1,0,1,1,0.016518,4,0.278724,0.3015,0
好莱坞(1948),好莱坞,notion,0,3,3,0,3,3,0.019955,4,0.281165,0.305504,3999.335514
如之何(1948),如之何,notion,0,1,1,0,1,1,0.01022,4,0.267243,0.282233,0
如何是好(1948),如何是好,notion,0,1,1,0,1,1,0.004718,4,0.258401,0.266227,0
如是(1948),如是,notion,0,1,1,0,1,1,0.016752,4,0.279138,0.302165,0
如是说(1948),如是说,notion,0,1,1,0,1,1,0.01424,4,0.275514,0.296275,0
如此(1948),如此,notion,0,7,7,0,12,12,0.081939,4,0.393619,0.432739,45993.791828
如此这般(1948),如此这般,notion,0,1,1,0,1,1,0.01424,4,0.275514,0.296275,0
如矢(1948),如矢,notion,0,1,1,0,1,1,0.009739,4,0.265806,0.279704,0
妇女节(1948),妇女节,notion,0,2,2,0,2,2,0.01996,4,0.281333,0.305715,1305.273912
妇女解放(1948),妇女解放,notion,0,1,1,0,1,1,0.01022,4,0.267243,0.282233,0
妇女运动(1948),妇女运动,notion,0,2,2,0,2,2,0.021076,4,0.284616,0.310839,1735.877057
妇权(1948),妇权,notion,0,1,1,0,1,1,0.008247,4,0.26379,0.27611,0
妇联(1948),妇联,notion,0,1,1,0,1,1,0.009739,4,0.265806,0.279704,0
妓女(1948),妓女,notion,0,2,2,0,2,2,0.030758,4,0.303347,0.337959,2812.221703
妙处(1948),妙处,notion,0,1,1,0,1,1,0.011322,4,0.269061,0.285394,0
妥协(1948),妥协,notion,0,1,1,0,1,1,0.01424,4,0.275514,0.296275,0
妥适(1948),妥适,notion,0,1,1,0,1,1,0.004718,4,0.258401,0.266227,0
妻子(1948),妻子,notion,0,1,1,0,1,1,0.009755,4,0.266617,0.281135,0
始业(1948),始业,notion,0,1,1,0,1,1,0.016752,4,0.279138,0.302165,0
始末(1948),始末,notion,0,2,2,0,2,2,0.021535,4,0.28397,0.309841,889.229879
始终(1948),始终,notion,0,1,1,0,1,1,0.004718,4,0.258401,0.266227,0
姐妹(1948),姐妹,notion,0,1,1,0,2,2,0.009751,4,0.267186,0.282133,0
委员(1948),委员,notion,0,2,2,0,2,2,0.021073,4,0.285785,0.312636,2242.44705
姚有章(1948),姚有章,notion,0,1,1,0,1,1,0.009751,4,0.267186,0.282133,0
姨太太(1948),姨太太,notion,0,1,1,0,1,1,0.016518,4,0.278724,0.3015,0
姻缘(1948),姻缘,notion,0,1,1,0,1,1,0.01424,4,0.275514,0.296275,0
姿态(1948),姿态,notion,0,2,2,0,2,2,0.030758,4,0.303347,0.337959,2812.221703
威信(1948),威信,notion,0,1,1,0,1,1,0.016518,4,0.278724,0.3015,0
威力(1948),威力,notion,0,1,1,0,1,1,0.009755,4,0.266617,0.281135,0
威廉(1948),威廉,notion,0,1,1,0,1,1,0.009755,4,0.266617,0.281135,0
威胁(1948),威胁,notion,0,8,8,0,11,11,0.091962,4,0.406218,0.442644,47692.645231
威风(1948),威风,notion,0,1,1,0,1,1,0.016518,4,0.278724,0.3015,0
娱乐(1948),娱乐,notion,0,1,1,0,1,1,0.004718,4,0.258401,0.266227,0
娱亲(1948),娱亲,notion,0,1,1,0,1,1,0.016518,4,0.278724,0.3015,0
婚后(1948),婚后,notion,0,1,1,0,1,1,0.016752,4,0.279138,0.302165,0
婚姻(1948),婚姻,notion,0,2,2,0,3,3,0.019569,4,0.280598,0.30455,1193.220239
媚外(1948),媚外,notion,0,1,1,0,1,1,0.01022,4,0.267243,0.282233,0
媚日(1948),媚日,notion,0,1,1,0,1,1,0.005017,4,0.257497,0.26453,0
嫌命长(1948),嫌命长,notion,0,1,1,0,1,1,0.009751,4,0.267186,0.282133,0
嬗变(1948),嬗变,notion,0,1,1,0,1,1,0.007515,4,0.262793,0.274313,0
子夜(1948),子夜,notion,0,1,1,0,1,1,0.01022,4,0.267243,0.282233,0
子手(1948),子手,notion,0,1,1,0,1,1,0.016518,4,0.278724,0.3015,0
孕育(1948),孕育,notion,0,1,1,0,1,1,0.008247,4,0.26379,0.27611,0
字样(1948),字样,notion,0,1,1,0,1,1,0.01022,4,0.267243,0.282233,0
存亡(1948),存亡,notion,0,1,1,0,1,1,0.007515,4,0.262793,0.274313,0
存在(1948),存在,notion,0,1,1,0,1,1,0.008247,4,0.26379,0.27611,0
存废(1948),存废,notion,0,1,1,0,1,1,0.008247,4,0.26379,0.27611,0
存款(1948),存款,notion,0,1,1,0,1,1,0.005389,4,0.25849,0.266394,0
孙子(1948),孙子,notion,0,1,1,0,1,1,0.016518,4,0.278724,0.3015,0
孙科(1948),孙科,notion,0,1,1,0,1,1,0.016752,4,0.279138,0.302165,0
孙起孟(1948),孙起孟,notion,0,1,1,0,2,2,0.009739,4,0.265806,0.279704,0
季芾(1948),季芾,notion,0,1,1,0,1,1,0.005017,4,0.257497,0.26453,0
孤儿(1948),孤儿,notion,0,2,2,0,2,2,0.033269,4,0.305692,0.34112,2297.98609
孤城(1948),孤城,notion,0,1,1,0,1,1,0.01022,4,0.267243,0.282233,0
孤岛(1948),孤岛,notion,0,1,1,0,1,1,0.016518,4,0.278724,0.3015,0
学习团(1948),学习团,notion,0,1,1,0,1,1,0.004718,4,0.258401,0.266227,0
学会(1948),学会,notion,0,2,2,0,2,2,0.007722,4,0.261404,0.27184,467.460247
学位(1948),学位,notion,0,1,1,0,1,1,0.009755,4,0.266617,0.281135,0
学保会(1948),学保会,notion,0,1,1,0,1,1,0.009739,4,0.265806,0.279704,0
学名(1948),学名,notion,0,1,1,0,1,1,0.009739,4,0.265806,0.279704,0
学团(1948),学团,notion,0,1,1,0,1,1,0.004718,4,0.258401,0.266227,0
学府(1948),学府,notion,0,3,3,0,4,4,0.043009,4,0.318172,0.357214,5224.220047
学术会议(1948),学术会议,notion,0,2,2,0,4,4,0.008698,4,0.258507,0.266483,0.569098
学校(1948),学校,notion,0,5,5,0,12,12,0.037683,4,0.305966,0.341652,11191.097336
学案(1948),学案,notion,0,1,1,0,1,1,0.009739,4,0.265806,0.279704,0
学治会(1948),学治会,notion,0,1,1,0,1,1,0.016518,4,0.278724,0.3015,0
学潮(1948),学潮,notion,0,6,6,0,8,8,0.057182,4,0.343514,0.386364,21445.908134
学生家长(1948),学生家长,notion,0,2,2,0,2,2,0.030992,4,0.303936,0.338757,2912.385696
学生手册(1948),学生手册,notion,0,1,1,0,1,1,0.016752,4,0.279138,0.302165,0
学生自治(1948),学生自治,notion,0,1,1,0,2,2,0.009739,4,0.265806,0.279704,0
学者(1948),学者,notion,0,4,4,0,4,4,0.04246,4,0.322571,0.362627,13329.139767
学识(1948),学识,notion,0,1,1,0,1,1,0.008247,4,0.26379,0.27611,0
学费(1948),学费,notion,0,2,2,0,2,2,0.026491,4,0.291937,0.321853,1403.825067
学阀(1948),学阀,notion,0,1,1,0,1,1,0.016518,4,0.278724,0.3015,0
学院(1948),学院,notion,0,4,4,0,5,5,0.038812,4,0.311497,0.348851,9719.7908
学风(1948),学风,notion,0,2,2,0,3,3,0.024461,4,0.291756,0.321587,2304.72473
孩子(1948),孩子,notion,0,2,2,0,3,3,0.027839,4,0.295962,0.327676,1920.33989
孰细(1948),孰细,notion,0,1,1,0,1,1,0.009751,4,0.267186,0.282133,0
孰轻(1948),孰轻,notion,0,1,1,0,1,1,0.009751,4,0.267186,0.282133,0
孰轻孰重(1948),孰轻孰重,notion,0,1,1,0,1,1,0.009751,4,0.267186,0.282133,0
孰重(1948),孰重,notion,0,1,1,0,2,2,0.009751,4,0.267186,0.282133,0
宁次吗(1948),宁次吗,notion,0,1,1,0,1,1,0.016518,4,0.278724,0.3015,0
宁波(1948),宁波,notion,0,1,1,0,1,1,0.011322,4,0.269061,0.285394,0
宇宙(1948),宇宙,notion,0,2,2,0,2,2,0.021076,4,0.284616,0.310839,1735.877057
守卫(1948),守卫,notion,0,2,2,0,2,2,0.026507,4,0.294224,0.325181,2012.895914
守法(1948),守法,notion,0,3,3,0,3,3,0.029717,4,0.299645,0.332923,6283.037697
守活寡(1948),守活寡,notion,0,1,1,0,1,1,0.008247,4,0.26379,0.27611,0
安全(1948),安全,notion,0,5,5,0,7,7,0.056296,4,0.33954,0.382049,17020.97669
安分(1948),安分,notion,0,1,1,0,1,1,0.016752,4,0.279138,0.302165,0
安南(1948),安南,notion,0,2,2,0,2,2,0.025562,4,0.293259,0.323783,2167.4723
安在(1948),安在,notion,0,1,1,0,1,1,0.011322,4,0.269061,0.285394,0
安娜(1948),安娜,notion,0,1,1,0,1,1,0.004718,4,0.258401,0.266227,0
安定(1948),安定,notion,0,2,2,0,4,4,0.030992,4,0.303936,0.338757,2912.385696
安徽(1948),安徽,notion,0,2,2,0,2,2,0.030992,4,0.303936,0.338757,2912.385696
安排(1948),安排,notion,0,3,3,0,3,3,0.024224,4,0.290785,0.320212,6049.872842
安理会(1948),安理会,notion,0,1,1,0,2,2,0.009755,4,0.266617,0.281135,0
安福系(1948),安福系,notion,0,1,1,0,1,1,0.007515,4,0.262793,0.274313,0
安能(1948),安能,notion,0,1,1,0,1,1,0.011322,4,0.269061,0.285394,0
安那(1948),安那,notion,0,1,1,0,1,1,0.005389,4,0.25849,0.266394,0
安静(1948),安静,notion,0,1,1,0,2,2,0.01424,4,0.275514,0.296275,0
安顿(1948),安顿,notion,0,1,1,0,1,1,0.01424,4,0.275514,0.296275,0
宋先生(1948),宋先生,notion,0,1,1,0,1,1,0.016752,4,0.279138,0.302165,0
宋子文(1948),宋子文,notion,0,5,5,0,9,9,0.057551,4,0.341795,0.384478,17555.573958
宋灾下(1948),宋灾下,notion,0,1,1,0,1,1,0.009751,4,0.267186,0.282133,0
宋粤(1948),宋粤,notion,0,1,1,0,1,1,0.009751,4,0.267186,0.282133,0
宋粤内(1948),宋粤内,notion,0,1,1,0,1,1,0.009751,4,0.267186,0.282133,0
宋美龄(1948),宋美龄,notion,0,1,1,0,1,1,0.016518,4,0.278724,0.3015,0
宋起(1948),宋起,notion,0,1,1,0,1,1,0.008247,4,0.26379,0.27611,0
完全(1948),完全,notion,0,4,4,0,4,4,0.0523,4,0.337102,0.379331,12609.046337
完成(1948),完成,notion,0,4,4,0,4,4,0.048979,4,0.330547,0.371977,11698.460408
完整(1948),完整,notion,0,1,1,0,1,1,0.011322,4,0.269061,0.285394,0
完整性(1948),完整性,notion,0,1,1,0,1,1,0.016752,4,0.279138,0.302165,0
宗教(1948),宗教,notion,0,2,2,0,2,2,0.01885,4,0.28146,0.305914,1156.716461
宗教自由(1948),宗教自由,notion,0,1,1,0,1,1,0.009751,4,0.267186,0.282133,0
宗派主义(1948),宗派主义,notion,0,1,1,0,1,1,0.009751,4,0.267186,0.282133,0
官佐(1948),官佐,notion,0,1,1,0,1,1,0.016518,4,0.278724,0.3015,0
官僚(1948),官僚,notion,0,2,2,0,2,2,0.021769,4,0.284983,0.311405,1063.457371
官僚主义(1948),官僚主义,notion,0,3,3,0,3,3,0.031507,4,0.3047,0.339844,7510.788135
官僚资本(1948),官僚资本,notion,0,3,3,0,4,4,0.040978,4,0.319498,0.358845,7110.8147
官司(1948),官司,notion,0,1,1,0,1,1,0.01022,4,0.267243,0.282233,0
官吏(1948),官吏,notion,0,1,1,0,1,1,0.01022,4,0.267243,0.282233,0
官商(1948),官商,notion,0,1,1,0,1,1,0.008247,4,0.26379,0.27611,0
官场(1948),官场,notion,0,1,1,0,1,1,0.01022,4,0.267243,0.282233,0
官心(1948),官心,notion,0,1,1,0,1,1,0.016752,4,0.279138,0.302165,0
官方(1948),官方,notion,0,1,1,0,1,1,0.011322,4,0.269061,0.285394,0
官毒(1948),官毒,notion,0,1,1,0,1,1,0.016752,4,0.279138,0.302165,0
官皆匪(1948),官皆匪,notion,0,1,1,0,1,1,0.009751,4,0.267186,0.282133,0
官运(1948),官运,notion,0,1,1,0,1,1,0.007515,4,0.262793,0.274313,0
官逼(1948),官逼,notion,0,1,1,0,1,1,0.016752,4,0.279138,0.302165,0
定律(1948),定律,notion,0,1,1,0,1,1,0.002332,4,0.253398,0.256677,0
定心丸(1948),定心丸,notion,0,1,1,0,1,1,0.016752,4,0.279138,0.302165,0
定阅(1948),定阅,notion,0,1,1,0,1,1,0.011322,4,0.269061,0.285394,0
宛西(1948),宛西,notion,0,2,2,0,2,2,0.025562,4,0.293259,0.323783,2167.4723
宜生(1948),宜生,notion,0,1,1,0,1,1,0.01022,4,0.267243,0.282233,0
宜重(1948),宜重,notion,0,1,1,0,1,1,0.007515,4,0.262793,0.274313,0
宝宝(1948),宝宝,notion,0,1,1,0,1,1,0.016752,4,0.279138,0.302165,0
宝石花(1948),宝石花,notion,0,1,1,0,1,1,0.016752,4,0.279138,0.302165,0
宝藏(1948),宝藏,notion,0,1,1,0,1,1,0.009755,4,0.266617,0.281135,0
实业(1948),实业,notion,0,1,1,0,1,1,0.008247,4,0.26379,0.27611,0
实例(1948),实例,notion,0,1,1,0,1,1,0.009755,4,0.266617,0.281135,0
实写(1948),实写,notion,0,1,1,0,1,1,0.009739,4,0.265806,0.279704,0
实况(1948),实况,notion,0,3,3,0,3,3,0.025216,4,0.286155,0.313257,1882.815007
实在(1948),实在,notion,0,1,1,0,1,1,0.009751,4,0.267186,0.282133,0
实地(1948),实地,notion,0,1,1,0,1,1,0.011322,4,0.269061,0.285394,0
实录(1948),实录,notion,0,2,2,0,3,3,0.019975,4,0.283071,0.308443,1854.710834
实施(1948),实施,notion,0,4,4,0,5,5,0.039742,4,0.314549,0.352744,10184.489475
实施方案(1948),实施方案,notion,0,1,1,0,1,1,0.004718,4,0.258401,0.266227,0
实益(1948),实益,notion,0,1,1,0,1,1,0.009739,4,0.265806,0.279704,0
实行(1948),实行,notion,0,4,4,0,5,5,0.048013,4,0.330082,0.371445,12275.966591
实践(1948),实践,notion,0,4,4,0,5,5,0.028106,4,0.295264,0.326789,8884.225309
实际(1948),实际,notion,0,2,2,0,3,3,0.021061,4,0.283157,0.308576,1336.570675
实验(1948),实验,notion,0,1,1,0,1,1,0.011322,4,0.269061,0.285394,0
实验区(1948),实验区,notion,0,1,1,0,1,1,0.01022,4,0.267243,0.282233,0
审判(1948),审判,notion,0,1,1,0,1,1,0.009755,4,0.266617,0.281135,0
客家(1948),客家,notion,0,1,1,0,1,1,0.009751,4,0.267186,0.282133,0
客家话(1948),客家话,notion,0,1,1,0,1,1,0.009751,4,0.267186,0.282133,0
客自京(1948),客自京,notion,0,1,1,0,1,1,0.016752,4,0.279138,0.302165,0
客郭(1948),客郭,notion,0,1,1,0,1,1,0.01424,4,0.275514,0.296275,0
客里空(1948),客里空,notion,0,1,1,0,2,2,0.009751,4,0.267186,0.282133,0
宣传(1948),宣传,notion,0,2,2,0,4,4,0.023995,4,0.291507,0.321221,2493.732085
宣传者(1948),宣传者,notion,0,1,1,0,1,1,0.008247,4,0.26379,0.27611,0
宣佈(1948),宣佈,notion,0,1,1,0,1,1,0.011322,4,0.269061,0.285394,0
宣怖(1948),宣怖,notion,0,1,1,0,1,1,0.016518,4,0.278724,0.3015,0
宣战(1948),宣战,notion,0,1,1,0,1,1,0.002332,4,0.253398,0.256677,0
宣教(1948),宣教,notion,0,2,2,0,2,2,0.026269,4,0.293695,0.324415,1931.353166
宣言(1948),宣言,notion,0,8,8,0,10,10,0.090879,4,0.40399,0.440947,46532.352652
宦寺(1948),宦寺,notion,0,1,1,0,1,1,0.007515,4,0.262793,0.274313,0
宦途(1948),宦途,notion,0,1,1,0,1,1,0.011322,4,0.269061,0.285394,0
宪兵(1948),宪兵,notion,0,2,2,0,2,2,0.019975,4,0.283071,0.308443,1854.710834
宪政时期(1948),宪政时期,notion,0,1,1,0,1,1,0.01424,4,0.275514,0.296275,0
宫阙(1948),宫阙,notion,0,1,1,0,1,1,0.01424,4,0.275514,0.296275,0
宴游(1948),宴游,notion,0,1,1,0,1,1,0.01424,4,0.275514,0.296275,0
家中(1948),家中,notion,0,1,1,0,1,1,0.01424,4,0.275514,0.296275,0
家书(1948),家书,notion,0,1,1,0,1,1,0.005389,4,0.25849,0.266394,0
家产(1948),家产,notion,0,1,1,0,1,1,0.01022,4,0.267243,0.282233,0
家小(1948),家小,notion,0,1,1,0,1,1,0.016518,4,0.278724,0.3015,0
家庭(1948),家庭,notion,0,4,4,0,6,6,0.046075,4,0.323571,0.363825,10393.315595
家庭妇女(1948),家庭妇女,notion,0,1,1,0,1,1,0.009751,4,0.267186,0.282133,0
家拜(1948),家拜,notion,0,1,1,0,1,1,0.009755,4,0.266617,0.281135,0
家长(1948),家长,notion,0,1,1,0,1,1,0.01424,4,0.275514,0.296275,0
容忍(1948),容忍,notion,0,2,2,0,2,2,0.024765,4,0.291552,0.321288,2097.245087
容易(1948),容易,notion,0,1,1,0,1,1,0.009739,4,0.265806,0.279704,0
容许(1948),容许,notion,0,1,1,0,1,1,0.016518,4,0.278724,0.3015,0
宽容(1948),宽容,notion,0,1,1,0,1,1,0.016752,4,0.279138,0.302165,0
宽裕(1948),宽裕,notion,0,1,1,0,1,1,0.01022,4,0.267243,0.282233,0
宿将(1948),宿将,notion,0,1,1,0,1,1,0.005017,4,0.257497,0.26453,0
宿舍(1948),宿舍,notion,0,1,1,0,1,1,0.004718,4,0.258401,0.266227,0
宿迁(1948),宿迁,notion,0,1,1,0,1,1,0.016518,4,0.278724,0.3015,0
寂寞(1948),寂寞,notion,0,1,1,0,1,1,0.007515,4,0.262793,0.274313,0
寄来(1948),寄来,notion,0,1,1,0,1,1,0.009751,4,0.267186,0.282133,0
密云(1948),密云,notion,0,1,1,0,1,1,0.016752,4,0.279138,0.302165,0
密勒(1948),密勒,notion,0,3,3,0,3,3,0.037828,4,0.311575,0.348895,5613.568801
密尔(1948),密尔,notion,0,1,1,0,1,1,0.011322,4,0.269061,0.285394,0
富农经济(1948),富农经济,notion,0,1,1,0,1,1,0.004718,4,0.258401,0.266227,0
富国(1948),富国,notion,0,1,1,0,1,1,0.008247,4,0.26379,0.27611,0
富庶(1948),富庶,notion,0,1,1,0,1,1,0.008247,4,0.26379,0.27611,0
富豪(1948),富豪,notion,0,1,1,0,1,1,0.01424,4,0.275514,0.296275,0
寒假(1948),寒假,notion,0,1,1,0,1,1,0.009751,4,0.267186,0.282133,0
寒夜(1948),寒夜,notion,0,1,1,0,1,1,0.01022,4,0.267243,0.282233,0
寒衣(1948),寒衣,notion,0,1,1,0,1,1,0.009739,4,0.265806,0.279704,0
察哈尔(1948),察哈尔,notion,0,1,1,0,1,1,0.01022,4,0.267243,0.282233,0
寡人(1948),寡人,notion,0,1,1,0,1,1,0.016518,4,0.278724,0.3015,0
寡而患(1948),寡而患,notion,0,1,1,0,1,1,0.016752,4,0.279138,0.302165,0
对付(1948),对付,notion,0,1,1,0,1,1,0.01424,4,0.275514,0.296275,0
对伪(1948),对伪,notion,0,1,1,0,1,1,0.005017,4,0.257497,0.26453,0
对党(1948),对党,notion,0,1,1,0,1,1,0.009751,4,0.267186,0.282133,0
对待(1948),对待,notion,0,1,1,0,2,2,0.009751,4,0.267186,0.282133,0
对抗(1948),对抗,notion,0,1,1,0,1,1,0.01022,4,0.267243,0.282233,0
对於(1948),对於,notion,0,4,4,0,5,5,0.050327,4,0.333629,0.375471,12293.324806
对比(1948),对比,notion,0,2,2,0,2,2,0.023995,4,0.291507,0.321221,2493.732085
对照(1948),对照,notion,0,2,2,0,3,3,0.026507,4,0.294224,0.325181,2012.895914
对立(1948),对立,notion,0,4,4,0,4,4,0.043298,4,0.321055,0.360797,11027.062833
对策(1948),对策,notion,0,1,1,0,1,1,0.01424,4,0.275514,0.296275,0
对美(1948),对美,notion,0,1,1,0,1,1,0.016752,4,0.279138,0.302165,0
对象(1948),对象,notion,0,3,3,0,3,3,0.022938,4,0.283542,0.309231,2406.045322
寺僧(1948),寺僧,notion,0,1,1,0,1,1,0.01424,4,0.275514,0.296275,0
寻味(1948),寻味,notion,0,1,1,0,1,1,0.01424,4,0.275514,0.296275,0
寻觅(1948),寻觅,notion,0,1,1,0,1,1,0.011322,4,0.269061,0.285394,0
导演(1948),导演,notion,0,1,1,0,1,1,0.01424,4,0.275514,0.296275,0
寿序(1948),寿序,notion,0,1,1,0,1,1,0.007515,4,0.262793,0.274313,0
封存(1948),封存,notion,0,2,2,0,2,2,0.019569,4,0.280598,0.30455,1193.220239
封建(1948),封建,notion,0,2,2,0,3,3,0.017267,4,0.279595,0.302953,2297.821122
封建制度(1948),封建制度,notion,0,1,1,0,1,1,0.016518,4,0.278724,0.3015,0
封箱(1948),封箱,notion,0,1,1,0,1,1,0.007515,4,0.262793,0.274313,0
封锁(1948),封锁,notion,0,1,1,0,1,1,0.016752,4,0.279138,0.302165,0
将作(1948),将作,notion,0,1,1,0,1,1,0.009739,4,0.265806,0.279704,0
将军(1948),将军,notion,0,8,8,0,11,11,0.087796,4,0.404643,0.441446,52782.367432
将士(1948),将士,notion,0,1,1,0,1,1,0.01424,4,0.275514,0.296275,0
将帅(1948),将帅,notion,0,1,1,0,1,1,0.016752,4,0.279138,0.302165,0
将来(1948),将来,notion,0,5,5,0,6,6,0.046042,4,0.325901,0.366642,19064.892907
将级(1948),将级,notion,0,1,1,0,1,1,0.016518,4,0.278724,0.3015,0
将要(1948),将要,notion,0,1,1,0,1,1,0.009751,4,0.267186,0.282133,0
将访(1948),将访,notion,0,1,1,0,1,1,0.009739,4,0.265806,0.279704,0
将近(1948),将近,notion,0,1,1,0,1,1,0.01022,4,0.267243,0.282233,0
尊号(1948),尊号,notion,0,1,1,0,1,1,0.008247,4,0.26379,0.27611,0
小事(1948),小事,notion,0,3,3,0,3,3,0.016945,4,0.271061,0.288933,1161.334715
小品(1948),小品,notion,0,1,1,0,1,1,0.01022,4,0.267243,0.282233,0
小园(1948),小园,notion,0,1,1,0,1,1,0.01424,4,0.275514,0.296275,0
小圈子(1948),小圈子,notion,0,1,1,0,1,1,0.011322,4,0.269061,0.285394,0
小地主(1948),小地主,notion,0,1,1,0,1,1,0.007515,4,0.262793,0.274313,0
小姐(1948),小姐,notion,0,1,1,0,1,1,0.005017,4,0.257497,0.26453,0
小学(1948),小学,notion,0,2,2,0,2,2,0.021469,4,0.287095,0.314632,2527.522512
小学教师(1948),小学教师,notion,0,2,2,0,2,2,0.026972,4,0.293947,0.324781,1749.441854
小学生(1948),小学生,notion,0,3,3,0,3,3,0.037591,4,0.311575,0.348895,6094.140105
小官(1948),小官,notion,0,1,1,0,1,1,0.01022,4,0.267243,0.282233,0
小害(1948),小害,notion,0,1,1,0,1,1,0.004718,4,0.258401,0.266227,0
小小(1948),小小,notion,0,1,1,0,1,1,0.009755,4,0.266617,0.281135,0
小康(1948),小康,notion,0,2,2,0,2,2,0.021542,4,0.284314,0.310373,1410.419447
小心(1948),小心,notion,0,1,1,0,1,1,0.016518,4,0.278724,0.3015,0
小时(1948),小时,notion,0,1,1,0,1,1,0.01022,4,0.267243,0.282233,0
小景(1948),小景,notion,0,1,1,0,1,1,0.016518,4,0.278724,0.3015,0
小朋友(1948),小朋友,notion,0,1,1,0,1,1,0.01022,4,0.267243,0.282233,0
小民(1948),小民,notion,0,1,1,0,1,1,0.01022,4,0.267243,0.282233,0
小狗(1948),小狗,notion,0,1,1,0,1,1,0.004718,4,0.258401,0.266227,0
小组(1948),小组,notion,0,2,2,0,2,2,0.014769,4,0.273708,0.293336,1042.722106
小记(1948),小记,notion,0,2,2,0,2,2,0.014469,4,0.27493,0.295366,1965.542095
小诗(1948),小诗,notion,0,1,1,0,1,1,0.016518,4,0.278724,0.3015,0
小说家(1948),小说家,notion,0,1,1,0,1,1,0.016752,4,0.279138,0.302165,0
小谈(1948),小谈,notion,0,1,1,0,1,1,0.016518,4,0.278724,0.3015,0
少将(1948),少将,notion,0,1,1,0,1,1,0.009739,4,0.265806,0.279704,0
少时(1948),少时,notion,0,1,1,0,1,1,0.007515,4,0.262793,0.274313,0
尔格(1948),尔格,notion,0,1,1,0,1,1,0.016752,4,0.279138,0.302165,0
尔顿(1948),尔顿,notion,0,1,1,0,1,1,0.009755,4,0.266617,0.281135,0
尚且(1948),尚且,notion,0,1,1,0,1,1,0.01424,4,0.275514,0.296275,0
尚义(1948),尚义,notion,0,1,1,0,1,1,0.01424,4,0.275514,0.296275,0
尚待(1948),尚待,notion,0,1,1,0,1,1,0.016752,4,0.279138,0.302165,0
尤爱(1948),尤爱,notion,0,1,1,0,1,1,0.01022,4,0.267243,0.282233,0
尤非(1948),尤非,notion,0,1,1,0,1,1,0.008247,4,0.26379,0.27611,0
就业(1948),就业,notion,0,1,1,0,1,1,0.016752,4,0.279138,0.302165,0
就教于(1948),就教于,notion,0,1,1,0,1,1,0.005017,4,0.257497,0.26453,0
就是(1948),就是,notion,0,4,4,0,5,5,0.045575,4,0.32385,0.364158,10983.341221
就来(1948),就来,notion,0,1,1,0,1,1,0.016518,4,0.278724,0.3015,0
就算(1948),就算,notion,0,1,1,0,1,1,0.016518,4,0.278724,0.3015,0
就职(1948),就职,notion,0,1,1,0,1,1,0.011322,4,0.269061,0.285394,0
就职典礼(1948),就职典礼,notion,0,1,1,0,1,1,0.01424,4,0.275514,0.296275,0
尴尬(1948),尴尬,notion,0,2,2,0,2,2,0.030758,4,0.303347,0.337959,2812.221703
尺度(1948),尺度,notion,0,1,1,0,2,2,0.009751,4,0.267186,0.282133,0
尽力(1948),尽力,notion,0,1,1,0,1,1,0.009755,4,0.266617,0.281135,0
尽心(1948),尽心,notion,0,1,1,0,1,1,0.011322,4,0.269061,0.285394,0
尾数(1948),尾数,notion,0,1,1,0,1,1,0.016752,4,0.279138,0.302165,0
局部(1948),局部,notion,0,1,1,0,1,1,0.011322,4,0.269061,0.285394,0
层层(1948),层层,notion,0,1,1,0,1,1,0.01022,4,0.267243,0.282233,0
居士(1948),居士,notion,0,1,1,0,1,1,0.007515,4,0.262793,0.274313,0
居民(1948),居民,notion,0,1,1,0,1,1,0.016518,4,0.278724,0.3015,0
居然(1948),居然,notion,0,1,1,0,1,1,0.011322,4,0.269061,0.285394,0
屈原(1948),屈原,notion,0,1,1,0,1,1,0.005017,4,0.257497,0.26453,0
屋子(1948),屋子,notion,0,1,1,0,1,1,0.016518,4,0.278724,0.3015,0
屏东(1948),屏东,notion,0,1,1,0,1,1,0.01424,4,0.275514,0.296275,0
屏障(1948),屏障,notion,0,1,1,0,1,1,0.016752,4,0.279138,0.302165,0
展开(1948),展开,notion,0,7,7,0,10,10,0.076736,4,0.38027,0.421591,40328.566543
展览(1948),展览,notion,0,1,1,0,1,1,0.016752,4,0.279138,0.302165,0
展览会(1948),展览会,notion,0,1,1,0,2,2,0.016752,4,0.279138,0.302165,0
属于(1948),属于,notion,0,1,1,0,1,1,0.004718,4,0.258401,0.266227,0
屠杀(1948),屠杀,notion,0,3,3,0,3,3,0.022753,4,0.284853,0.31126,3341.746506
履践(1948),履践,notion,0,1,1,0,1,1,0.009751,4,0.267186,0.282133,0
山下(1948),山下,notion,0,1,1,0,1,1,0.016752,4,0.279138,0.302165,0
山东(1948),山东,notion,0,3,3,0,3,3,0.025216,4,0.286155,0.313257,1882.815007
山丹(1948),山丹,notion,0,1,1,0,1,1,0.008247,4,0.26379,0.27611,0
山之捷(1948),山之捷,notion,0,1,1,0,1,1,0.016518,4,0.278724,0.3015,0
山区(1948),山区,notion,0,1,1,0,3,3,0.01022,4,0.267243,0.282233,0
山城(1948),山城,notion,0,1,1,0,1,1,0.016752,4,0.279138,0.302165,0
山崩(1948),山崩,notion,0,1,1,0,1,1,0.016518,4,0.278724,0.3015,0
山歌(1948),山歌,notion,0,3,3,0,3,3,0.030987,4,0.301812,0.335918,6420.848362
山水(1948),山水,notion,0,1,1,0,1,1,0.01424,4,0.275514,0.296275,0
山海工(1948),山海工,notion,0,1,1,0,1,1,0.004718,4,0.258401,0.266227,0
山边(1948),山边,notion,0,1,1,0,1,1,0.004718,4,0.258401,0.266227,0
山雨(1948),山雨,notion,0,1,1,0,1,1,0.005389,4,0.25849,0.266394,0
山雨欲来(1948),山雨欲来,notion,0,4,4,0,4,4,0.048033,4,0.323822,0.364124,9070.326786
屹立(1948),屹立,notion,0,1,1,0,1,1,0.009751,4,0.267186,0.282133,0
岁寒(1948),岁寒,notion,0,1,1,0,1,1,0.016752,4,0.279138,0.302165,0
岁尾(1948),岁尾,notion,0,2,2,0,2,2,0.02398,4,0.290133,0.319191,1998.682918
岁暮(1948),岁暮,notion,0,1,1,0,1,1,0.016518,4,0.278724,0.3015,0
岁末(1948),岁末,notion,0,1,1,0,1,1,0.01022,4,0.267243,0.282233,0
岂有此理(1948),岂有此理,notion,0,1,1,0,1,1,0.01424,4,0.275514,0.296275,0
岂能(1948),岂能,notion,0,1,1,0,1,1,0.01424,4,0.275514,0.296275,0
岌岌(1948),岌岌,notion,0,1,1,0,1,1,0.016518,4,0.278724,0.3015,0
岗位(1948),岗位,notion,0,2,2,0,2,2,0.019491,4,0.281819,0.30648,1649.883746
岭之战(1948),岭之战,notion,0,1,1,0,1,1,0.009751,4,0.267186,0.282133,0
岭南(1948),岭南,notion,0,1,1,0,1,1,0.016752,4,0.279138,0.302165,0
崇信(1948),崇信,notion,0,1,1,0,1,1,0.007515,4,0.262793,0.274313,0
崇拜(1948),崇拜,notion,0,1,1,0,1,1,0.009755,4,0.266617,0.281135,0
崇明(1948),崇明,notion,0,1,1,0,1,1,0.004718,4,0.258401,0.266227,0
崛起(1948),崛起,notion,0,1,1,0,1,1,0.005017,4,0.257497,0.26453,0
崩斯着(1948),崩斯着,notion,0,1,1,0,1,1,0.009739,4,0.265806,0.279704,0
崩解(1948),崩解,notion,0,1,1,0,1,1,0.002332,4,0.253398,0.256677,0
川东(1948),川东,notion,0,2,2,0,3,3,0.027839,4,0.295962,0.327676,1920.33989
川北(1948),川北,notion,0,2,2,0,3,3,0.026972,4,0.293947,0.324781,1749.441854
川局(1948),川局,notion,0,1,1,0,1,1,0.016752,4,0.279138,0.302165,0
川西(1948),川西,notion,0,1,1,0,1,1,0.011322,4,0.269061,0.285394,0
川防(1948),川防,notion,0,1,1,0,1,1,0.01022,4,0.267243,0.282233,0
川陕(1948),川陕,notion,0,1,1,0,1,1,0.011322,4,0.269061,0.285394,0
巡映(1948),巡映,notion,0,1,1,0,1,1,0.004718,4,0.258401,0.266227,0
巡行(1948),巡行,notion,0,1,1,0,1,1,0.009739,4,0.265806,0.279704,0
巡视(1948),巡视,notion,0,2,2,0,2,2,0.012533,4,0.269467,0.286148,936.348082
巡访(1948),巡访,notion,0,1,1,0,1,1,0.01022,4,0.267243,0.282233,0
巢湖(1948),巢湖,notion,0,1,1,0,1,1,0.016752,4,0.279138,0.302165,0
工业(1948),工业,notion,0,9,9,0,16,16,0.099106,4,0.420402,0.453081,59956.893952
工业家(1948),工业家,notion,0,2,2,0,2,2,0.026491,4,0.291937,0.321853,1403.825067
工业生产(1948),工业生产,notion,0,1,1,0,1,1,0.008247,4,0.26379,0.27611,0
工人党(1948),工人党,notion,0,1,1,0,2,2,0.009755,4,0.266617,0.281135,0
工人运动(1948),工人运动,notion,0,1,1,0,2,2,0.009755,4,0.266617,0.281135,0
工人阶级(1948),工人阶级,notion,0,1,1,0,2,2,0.009755,4,0.266617,0.281135,0
工代会(1948),工代会,notion,0,1,1,0,1,1,0.016518,4,0.278724,0.3015,0
工会(1948),工会,notion,0,4,4,0,5,5,0.045763,4,0.322267,0.362261,10052.592216
工作人员(1948),工作人员,notion,0,2,2,0,2,2,0.008698,4,0.258507,0.266483,0.569098
工作岗位(1948),工作岗位,notion,0,1,1,0,1,1,0.004718,4,0.258401,0.266227,0
工作母机(1948),工作母机,notion,0,1,1,0,1,1,0.011322,4,0.269061,0.285394,0
工作站(1948),工作站,notion,0,1,1,0,1,1,0.004718,4,0.258401,0.266227,0
工作者(1948),工作者,notion,0,7,7,0,7,7,0.058522,4,0.341391,0.384156,28753.445643
工党(1948),工党,notion,0,1,1,0,1,1,0.009739,4,0.265806,0.279704,0
工协电(1948),工协电,notion,0,1,1,0,1,1,0.009739,4,0.265806,0.279704,0
工厂(1948),工厂,notion,0,4,4,0,5,5,0.050967,4,0.336077,0.3782,13327.891113
工友(1948),工友,notion,0,2,2,0,2,2,0.028074,4,0.296149,0.327943,1864.79583
工商业(1948),工商业,notion,0,4,4,0,10,10,0.047738,4,0.330402,0.371811,13915.318286
工潮(1948),工潮,notion,0,1,1,0,1,1,0.009739,4,0.265806,0.279704,0
工程(1948),工程,notion,0,1,1,0,2,2,0.016518,4,0.278724,0.3015,0
工程局(1948),工程局,notion,0,1,1,0,1,1,0.01022,4,0.267243,0.282233,0
工联(1948),工联,notion,0,1,1,0,1,1,0.016518,4,0.278724,0.3015,0
工资(1948),工资,notion,0,1,1,0,1,1,0.009739,4,0.265806,0.279704,0
左倾(1948),左倾,notion,0,2,2,0,2,2,0.012072,4,0.268484,0.284451,677.642529
左右(1948),左右,notion,0,2,2,0,2,2,0.027839,4,0.295962,0.327676,1920.33989
左派(1948),左派,notion,0,1,1,0,1,1,0.01424,4,0.275514,0.296275,0
左翼(1948),左翼,notion,0,1,1,0,1,1,0.009739,4,0.265806,0.279704,0
左行(1948),左行,notion,0,1,1,0,1,1,0.008247,4,0.26379,0.27611,0
左青科(1948),左青科,notion,0,1,1,0,1,1,0.009755,4,0.266617,0.281135,0
巨匠(1948),巨匠,notion,0,1,1,0,1,1,0.016518,4,0.278724,0.3015,0
巨响(1948),巨响,notion,0,1,1,0,1,1,0.016752,4,0.279138,0.302165,0
巨大(1948),巨大,notion,0,1,1,0,1,1,0.01424,4,0.275514,0.296275,0
巨浪(1948),巨浪,notion,0,1,1,0,1,1,0.002332,4,0.253398,0.256677,0
巩固(1948),巩固,notion,0,1,1,0,1,1,0.005017,4,0.257497,0.26453,0
己作(1948),己作,notion,0,1,1,0,1,1,0.01424,4,0.275514,0.296275,0
已到(1948),已到,notion,0,2,2,0,2,2,0.02398,4,0.290133,0.319191,1998.682918
已届(1948),已届,notion,0,2,2,0,2,2,0.025562,4,0.293259,0.323783,2167.4723
已成(1948),已成,notion,0,2,2,0,2,2,0.030992,4,0.303936,0.338757,2912.385696
已经(1948),已经,notion,0,6,6,0,7,7,0.066414,4,0.356793,0.399907,23754.255331
巴力斯坦(1948),巴力斯坦,notion,0,1,1,0,1,1,0.016752,4,0.279138,0.302165,0
巴勒斯坦(1948),巴勒斯坦,notion,0,1,1,0,4,4,0.009755,4,0.266617,0.281135,0
巴基斯坦(1948),巴基斯坦,notion,0,1,1,0,1,1,0.009755,4,0.266617,0.281135,0
巴尔(1948),巴尔,notion,0,1,1,0,2,2,0.01424,4,0.275514,0.296275,0
巴山蜀水(1948),巴山蜀水,notion,0,1,1,0,1,1,0.01424,4,0.275514,0.296275,0
巴索(1948),巴索,notion,0,1,1,0,1,1,0.005017,4,0.257497,0.26453,0
巴黎(1948),巴黎,notion,0,4,4,0,6,6,0.040334,4,0.315209,0.353576,9435.522158
币值(1948),币值,notion,0,1,1,0,2,2,0.008247,4,0.26379,0.27611,0
市中(1948),市中,notion,0,1,1,0,1,1,0.008247,4,0.26379,0.27611,0
市场(1948),市场,notion,0,2,2,0,2,2,0.023995,4,0.291507,0.321221,2493.732085
市廛(1948),市廛,notion,0,1,1,0,1,1,0.01424,4,0.275514,0.296275,0
市政(1948),市政,notion,0,1,1,0,1,1,0.016752,4,0.279138,0.302165,0
市郊(1948),市郊,notion,0,1,1,0,1,1,0.01022,4,0.267243,0.282233,0
市长(1948),市长,notion,0,2,2,0,2,2,0.026491,4,0.291937,0.321853,1403.825067
布列(1948),布列,notion,0,1,1,0,1,1,0.005017,4,0.257497,0.26453,0
布尔什维克(1948),布尔什维克,notion,0,2,2,0,3,3,0.026269,4,0.293695,0.324415,1931.353166
布尔塞维克(1948),布尔塞维克,notion,0,2,2,0,2,2,0.026269,4,0.293695,0.324415,1931.353166
布洛克(1948),布洛克,notion,0,1,1,0,1,1,0.009739,4,0.265806,0.279704,0
布置(1948),布置,notion,0,1,1,0,1,1,0.005017,4,0.257497,0.26453,0
布鲁塞(1948),布鲁塞,notion,0,1,1,0,1,1,0.007515,4,0.262793,0.274313,0
师格(1948),师格,notion,0,1,1,0,1,1,0.016752,4,0.279138,0.302165,0
师生(1948),师生,notion,0,2,2,0,2,2,0.026491,4,0.291937,0.321853,1403.825067
师範(1948),师範,notion,0,1,1,0,1,1,0.011322,4,0.269061,0.285394,0
师表(1948),师表,notion,0,1,1,0,1,1,0.01022,4,0.267243,0.282233,0
师道(1948),师道,notion,0,1,1,0,1,1,0.016752,4,0.279138,0.302165,0
师长(1948),师长,notion,0,1,1,0,1,1,0.016518,4,0.278724,0.3015,0
师院(1948),师院,notion,0,2,2,0,2,2,0.028074,4,0.296149,0.327943,1864.79583
希特勒(1948),希特勒,notion,0,3,3,0,3,3,0.044591,4,0.323126,0.363237,6083.12181
帝国(1948),帝国,notion,0,2,2,0,2,2,0.01727,4,0.278352,0.300956,1619.09855
帝国主义(1948),帝国主义,notion,0,3,3,0,3,3,0.036024,4,0.308631,0.345069,5629.029515
帝国主义者(1948),帝国主义者,notion,0,1,1,0,1,1,0.009739,4,0.265806,0.279704,0
帝陵(1948),帝陵,notion,0,1,1,0,1,1,0.01424,4,0.275514,0.296275,0
带到(1948),带到,notion,0,1,1,0,1,1,0.009751,4,0.267186,0.282133,0
带来(1948),带来,notion,0,4,4,0,4,4,0.041429,4,0.315368,0.353776,10887.04681
帮兇(1948),帮兇,notion,0,1,1,0,1,1,0.01424,4,0.275514,0.296275,0
帮助(1948),帮助,notion,0,2,2,0,2,2,0.030758,4,0.303347,0.337959,2812.221703
常州(1948),常州,notion,0,1,1,0,1,1,0.01022,4,0.267243,0.282233,0
常识(1948),常识,notion,0,1,1,0,1,1,0.004718,4,0.258401,0.266227,0
常谈(1948),常谈,notion,0,2,2,0,3,3,0.008698,4,0.258507,0.266483,0.569098
帽子(1948),帽子,notion,0,1,1,0,1,1,0.016518,4,0.278724,0.3015,0
幕衣(1948),幕衣,notion,0,1,1,0,1,1,0.01424,4,0.275514,0.296275,0
干些(1948),干些,notion,0,2,2,0,2,2,0.024267,4,0.290987,0.320456,2179.633602
干吗(1948),干吗,notion,0,1,1,0,1,1,0.002332,4,0.253398,0.256677,0
平准(1948),平准,notion,0,1,1,0,1,1,0.007515,4,0.262793,0.274313,0
平剧(1948),平剧,notion,0,1,1,0,1,1,0.01022,4,0.267243,0.282233,0
平原(1948),平原,notion,0,1,1,0,1,1,0.016518,4,0.278724,0.3015,0
平均分配(1948),平均分配,notion,0,1,1,0,1,1,0.016518,4,0.278724,0.3015,0
平情(1948),平情,notion,0,1,1,0,1,1,0.016752,4,0.279138,0.302165,0
平抑(1948),平抑,notion,0,1,1,0,1,1,0.011322,4,0.269061,0.285394,0
平民(1948),平民,notion,0,1,1,0,1,1,0.008247,4,0.26379,0.27611,0
平沪(1948),平沪,notion,0,1,1,0,1,1,0.009739,4,0.265806,0.279704,0
平等(1948),平等,notion,0,2,2,0,6,6,0.021076,4,0.284616,0.310839,1735.877057
平等互惠(1948),平等互惠,notion,0,1,1,0,1,1,0.009755,4,0.266617,0.281135,0
平行(1948),平行,notion,0,2,2,0,2,2,0.025562,4,0.293259,0.323783,2167.4723
平议(1948),平议,notion,0,2,2,0,2,2,0.021756,4,0.286964,0.314433,2044.761444
平难生(1948),平难生,notion,0,1,1,0,1,1,0.01022,4,0.267243,0.282233,0
年前(1948),年前,notion,0,1,1,0,1,1,0.016752,4,0.279138,0.302165,0
年头(1948),年头,notion,0,2,2,0,2,2,0.02398,4,0.290133,0.319191,1998.682918
年节(1948),年节,notion,0,1,1,0,1,1,0.01424,4,0.275514,0.296275,0
年间(1948),年间,notion,0,1,1,0,2,2,0.016518,4,0.278724,0.3015,0
并未(1948),并未,notion,0,1,1,0,1,1,0.011322,4,0.269061,0.285394,0
并评(1948),并评,notion,0,1,1,0,1,1,0.002332,4,0.253398,0.256677,0
幸运之神(1948),幸运之神,notion,0,1,1,0,1,1,0.009755,4,0.266617,0.281135,0
幹部(1948),幹部,notion,0,2,2,0,3,3,0.027839,4,0.295962,0.327676,1920.33989
幻想(1948),幻想,notion,0,1,1,0,1,1,0.016518,4,0.278724,0.3015,0
幻梦(1948),幻梦,notion,0,1,1,0,1,1,0.016518,4,0.278724,0.3015,0
幻灭(1948),幻灭,notion,0,2,2,0,2,2,0.030992,4,0.303936,0.338757,2912.385696
幼时(1948),幼时,notion,0,1,1,0,1,1,0.01424,4,0.275514,0.296275,0
幼章(1948),幼章,notion,0,1,1,0,1,1,0.009739,4,0.265806,0.279704,0
广东省(1948),广东省,notion,0,1,1,0,1,1,0.01424,4,0.275514,0.296275,0
广场(1948),广场,notion,0,1,1,0,1,1,0.009739,4,0.265806,0.279704,0
广大(1948),广大,notion,0,2,2,0,2,2,0.026503,4,0.295799,0.327444,2668.961321
广州市(1948),广州市,notion,0,1,1,0,1,1,0.009751,4,0.267186,0.282133,0
广州话(1948),广州话,notion,0,1,1,0,2,2,0.009751,4,0.267186,0.282133,0
广徵(1948),广徵,notion,0,1,1,0,1,1,0.008247,4,0.26379,0.27611,0
广泛(1948),广泛,notion,0,2,2,0,2,2,0.014469,4,0.27493,0.295366,1965.542095
广西(1948),广西,notion,0,2,2,0,3,3,0.021073,4,0.285785,0.312636,2242.44705
庄严(1948),庄严,notion,0,1,1,0,1,1,0.009751,4,0.267186,0.282133,0
庆祝(1948),庆祝,notion,0,2,2,0,3,3,0.026269,4,0.293695,0.324415,1931.353166
床下(1948),床下,notion,0,1,1,0,1,1,0.016518,4,0.278724,0.3015,0
序幕(1948),序幕,notion,0,2,2,0,2,2,0.033269,4,0.305692,0.34112,2297.98609
序战(1948),序战,notion,0,1,1,0,1,1,0.016752,4,0.279138,0.302165,0
序言(1948),序言,notion,0,2,2,0,2,2,0.019972,4,0.283949,0.309807,2243.008915
庐山(1948),庐山,notion,0,2,2,0,2,2,0.024461,4,0.291756,0.321587,2304.72473
庐谭(1948),庐谭,notion,0,1,1,0,1,1,0.01424,4,0.275514,0.296275,0
应予(1948),应予,notion,0,1,1,0,2,2,0.01424,4,0.275514,0.296275,0
应付(1948),应付,notion,0,2,2,0,2,2,0.021542,4,0.284314,0.310373,1410.419447
应作(1948),应作,notion,0,1,1,0,1,1,0.004718,4,0.258401,0.266227,0
应允(1948),应允,notion,0,1,1,0,1,1,0.01424,4,0.275514,0.296275,0
应变(1948),应变,notion,0,1,1,0,1,1,0.005017,4,0.257497,0.26453,0
应否(1948),应否,notion,0,2,2,0,2,2,0.017999,4,0.280116,0.303785,1897.286008
应多(1948),应多,notion,0,1,1,0,1,1,0.01424,4,0.275514,0.296275,0
应持(1948),应持,notion,0,2,2,0,2,2,0.008698,4,0.258507,0.266483,0.569098
应由(1948),应由,notion,0,2,2,0,2,2,0.030992,4,0.303936,0.338757,2912.385696
应立(1948),应立,notion,0,1,1,0,1,1,0.011322,4,0.269061,0.285394,0
应行(1948),应行,notion,0,1,1,0,1,1,0.008247,4,0.26379,0.27611,0
应该(1948),应该,notion,0,4,4,0,7,7,0.052065,4,0.340309,0.382825,15024.267767
应谋(1948),应谋,notion,0,1,1,0,1,1,0.016752,4,0.279138,0.302165,0
应速(1948),应速,notion,0,1,1,0,2,2,0.01424,4,0.275514,0.296275,0
应采(1948),应采,notion,0,1,1,0,1,1,0.01424,4,0.275514,0.296275,0
底大(1948),底大,notion,0,1,1,0,1,1,0.008247,4,0.26379,0.27611,0
庚子(1948),庚子,notion,0,1,1,0,1,1,0.007515,4,0.262793,0.274313,0
庚甲佚(1948),庚甲佚,notion,0,1,1,0,1,1,0.007515,4,0.262793,0.274313,0
府政(1948),府政,notion,0,1,1,0,1,1,0.016752,4,0.279138,0.302165,0
庞翔(1948),庞翔,notion,0,1,1,0,1,1,0.009739,4,0.265806,0.279704,0
废物(1948),废物,notion,0,1,1,0,1,1,0.016518,4,0.278724,0.3015,0
废除(1948),废除,notion,0,1,1,0,2,2,0.011322,4,0.269061,0.285394,0
度年会(1948),度年会,notion,0,1,1,0,1,1,0.016752,4,0.279138,0.302165,0
度量(1948),度量,notion,0,1,1,0,1,1,0.007515,4,0.262793,0.274313,0
座位(1948),座位,notion,0,1,1,0,1,1,0.009755,4,0.266617,0.281135,0
座右铭(1948),座右铭,notion,0,1,1,0,1,1,0.01424,4,0.275514,0.296275,0
康泽(1948),康泽,notion,0,2,2,0,2,2,0.021542,4,0.284314,0.310373,1410.419447
康藏(1948),康藏,notion,0,1,1,0,1,1,0.011322,4,0.269061,0.285394,0
康藏往(1948),康藏往,notion,0,1,1,0,1,1,0.016752,4,0.279138,0.302165,0
庸俗(1948),庸俗,notion,0,1,1,0,1,1,0.016518,4,0.278724,0.3015,0
廉洁(1948),廉洁,notion,0,1,1,0,1,1,0.008247,4,0.26379,0.27611,0
廖运周(1948),廖运周,notion,0,1,1,0,1,1,0.016518,4,0.278724,0.3015,0
延安(1948),延安,notion,0,2,2,0,3,3,0.026269,4,0.293695,0.324415,1931.353166
延续(1948),延续,notion,0,1,1,0,1,1,0.01022,4,0.267243,0.282233,0
建军(1948),建军,notion,0,3,3,0,3,3,0.036493,4,0.309342,0.346,5642.475469
建康(1948),建康,notion,0,1,1,0,1,1,0.01424,4,0.275514,0.296275,0
建成(1948),建成,notion,0,1,1,0,1,1,0.01424,4,0.275514,0.296275,0
建筑(1948),建筑,notion,0,3,3,0,3,3,0.031524,4,0.299573,0.332823,3847.926654
建築(1948),建築,notion,0,1,1,0,1,1,0.01424,4,0.275514,0.296275,0
建观(1948),建观,notion,0,1,1,0,1,1,0.007515,4,0.262793,0.274313,0
建设者(1948),建设者,notion,0,1,1,0,1,1,0.016518,4,0.278724,0.3015,0
廿一(1948),廿一,notion,0,1,1,0,1,1,0.016518,4,0.278724,0.3015,0
廿七(1948),廿七,notion,0,1,1,0,2,2,0.016518,4,0.278724,0.3015,0
廿万(1948),廿万,notion,0,1,1,0,1,1,0.009739,4,0.265806,0.279704,0
廿三(1948),廿三,notion,0,1,1,0,1,1,0.009755,4,0.266617,0.281135,0
廿九(1948),廿九,notion,0,2,2,0,2,2,0.026491,4,0.291937,0.321853,1403.825067
廿二(1948),廿二,notion,0,1,1,0,1,1,0.009751,4,0.267186,0.282133,0
廿四(1948),廿四,notion,0,1,1,0,1,1,0.009755,4,0.266617,0.281135,0
廿年(1948),廿年,notion,0,1,1,0,1,1,0.016518,4,0.278724,0.3015,0
开会(1948),开会,notion,0,1,1,0,1,1,0.009751,4,0.267186,0.282133,0
开入(1948),开入,notion,0,1,1,0,1,1,0.009755,4,0.266617,0.281135,0
开创(1948),开创,notion,0,1,1,0,1,1,0.007515,4,0.262793,0.274313,0
开发(1948),开发,notion,0,3,3,0,4,4,0.038294,4,0.310776,0.347864,5024.657132
开国(1948),开国,notion,0,1,1,0,1,1,0.016752,4,0.279138,0.302165,0
开始(1948),开始,notion,0,5,5,0,8,8,0.057478,4,0.343923,0.386741,20224.896335
开导(1948),开导,notion,0,1,1,0,1,1,0.016752,4,0.279138,0.302165,0
开展(1948),开展,notion,0,1,1,0,1,1,0.016752,4,0.279138,0.302165,0
开幕(1948),开幕,notion,0,3,3,0,3,3,0.033772,4,0.304503,0.339578,5420.300526
开幕词(1948),开幕词,notion,0,1,1,0,1,1,0.016518,4,0.278724,0.3015,0
开战(1948),开战,notion,0,1,1,0,1,1,0.009755,4,0.266617,0.281135,0
开放(1948),开放,notion,0,1,1,0,1,1,0.007515,4,0.262793,0.274313,0
开明(1948),开明,notion,0,3,3,0,4,4,0.031893,4,0.30298,0.337515,5016.736167
开火(1948),开火,notion,0,1,1,0,2,2,0.009751,4,0.267186,0.282133,0
开辟(1948),开辟,notion,0,1,1,0,1,1,0.01022,4,0.267243,0.282233,0
开遍(1948),开遍,notion,0,1,1,0,1,1,0.016752,4,0.279138,0.302165,0
开门(1948),开门,notion,0,1,1,0,1,1,0.016518,4,0.278724,0.3015,0
开门揖盗(1948),开门揖盗,notion,0,1,1,0,1,1,0.016518,4,0.278724,0.3015,0
开除(1948),开除,notion,0,2,2,0,3,3,0.026972,4,0.293947,0.324781,1749.441854
异同(1948),异同,notion,0,1,1,0,1,1,0.007515,4,0.262793,0.274313,0
异哉(1948),异哉,notion,0,1,1,0,1,1,0.007515,4,0.262793,0.274313,0
异国(1948),异国,notion,0,1,1,0,1,1,0.01424,4,0.275514,0.296275,0
弔唁(1948),弔唁,notion,0,1,1,0,1,1,0.016518,4,0.278724,0.3015,0
引力(1948),引力,notion,0,1,1,0,1,1,0.011322,4,0.269061,0.285394,0
引来(1948),引来,notion,0,1,1,0,1,1,0.01022,4,0.267243,0.282233,0
引起(1948),引起,notion,0,1,1,0,1,1,0.011322,4,0.269061,0.285394,0
张东荪(1948),张东荪,notion,0,3,3,0,3,3,0.023394,4,0.285546,0.312325,2762.077451
张嘉(1948),张嘉,notion,0,1,1,0,1,1,0.009739,4,0.265806,0.279704,0
张奚若(1948),张奚若,notion,0,1,1,0,1,1,0.01424,4,0.275514,0.296275,0
张宗昌(1948),张宗昌,notion,0,1,1,0,1,1,0.01022,4,0.267243,0.282233,0
张家口(1948),张家口,notion,0,1,1,0,1,1,0.016752,4,0.279138,0.302165,0
张开(1948),张开,notion,0,1,1,0,1,1,0.016752,4,0.279138,0.302165,0
张恨水(1948),张恨水,notion,0,1,1,0,1,1,0.01424,4,0.275514,0.296275,0
张晓崧(1948),张晓崧,notion,0,1,1,0,1,1,0.01424,4,0.275514,0.296275,0
张氏(1948),张氏,notion,0,1,1,0,1,1,0.016752,4,0.279138,0.302165,0
张申府(1948),张申府,notion,0,1,1,0,3,3,0.016752,4,0.279138,0.302165,0
张羣(1948),张羣,notion,0,2,2,0,2,2,0.016339,4,0.275312,0.295998,876.896283
张群(1948),张群,notion,0,1,1,0,2,2,0.01022,4,0.267243,0.282233,0
张菊生(1948),张菊生,notion,0,1,1,0,1,1,0.005389,4,0.25849,0.266394,0
张鼓峰(1948),张鼓峰,notion,0,1,1,0,1,1,0.01022,4,0.267243,0.282233,0
弦外之音(1948),弦外之音,notion,0,1,1,0,1,1,0.016752,4,0.279138,0.302165,0
弱点(1948),弱点,notion,0,1,1,0,3,3,0.01424,4,0.275514,0.296275,0
强国(1948),强国,notion,0,1,1,0,1,1,0.008247,4,0.26379,0.27611,0
强壮(1948),强壮,notion,0,2,2,0,2,2,0.019506,4,0.282731,0.307911,1903.779982
强大(1948),强大,notion,0,2,2,0,2,2,0.030758,4,0.303347,0.337959,2812.221703
强奸(1948),强奸,notion,0,1,1,0,3,3,0.01022,4,0.267243,0.282233,0
强奸案(1948),强奸案,notion,0,1,1,0,1,1,0.01022,4,0.267243,0.282233,0
强姦案(1948),强姦案,notion,0,1,1,0,1,1,0.016518,4,0.278724,0.3015,0
强斯顿(1948),强斯顿,notion,0,1,1,0,1,1,0.008247,4,0.26379,0.27611,0
强盗(1948),强盗,notion,0,1,1,0,1,1,0.005017,4,0.257497,0.26453,0
强硬(1948),强硬,notion,0,1,1,0,1,1,0.009755,4,0.266617,0.281135,0
强调(1948),强调,notion,0,2,2,0,2,2,0.023992,4,0.29271,0.322985,3168.205568
归于(1948),归于,notion,0,2,2,0,2,2,0.026503,4,0.295799,0.327444,2668.961321
归去(1948),归去,notion,0,1,1,0,1,1,0.005017,4,0.257497,0.26453,0
归客(1948),归客,notion,0,1,1,0,1,1,0.009739,4,0.265806,0.279704,0
归来(1948),归来,notion,0,1,1,0,2,2,0.01424,4,0.275514,0.296275,0
归者(1948),归者,notion,0,1,1,0,1,1,0.01424,4,0.275514,0.296275,0
当今(1948),当今,notion,0,2,2,0,2,2,0.012553,4,0.269796,0.286714,703.533419
当代(1948),当代,notion,0,1,1,0,1,1,0.008247,4,0.26379,0.27611,0
当前任务(1948),当前任务,notion,0,1,1,0,1,1,0.016518,4,0.278724,0.3015,0
当头棒喝(1948),当头棒喝,notion,0,1,1,0,1,1,0.01424,4,0.275514,0.296275,0
当局(1948),当局,notion,0,2,2,0,7,7,0.024461,4,0.291756,0.321587,2304.72473
当心(1948),当心,notion,0,1,1,0,1,1,0.009751,4,0.267186,0.282133,0
当选(1948),当选,notion,0,3,3,0,4,4,0.043009,4,0.318172,0.357214,5224.220047
形式(1948),形式,notion,0,1,1,0,1,1,0.009739,4,0.265806,0.279704,0
形形色色(1948),形形色色,notion,0,1,1,0,1,1,0.016518,4,0.278724,0.3015,0
形成(1948),形成,notion,0,1,1,0,1,1,0.008247,4,0.26379,0.27611,0
形成期(1948),形成期,notion,0,1,1,0,1,1,0.007515,4,0.262793,0.274313,0
形胜(1948),形胜,notion,0,1,1,0,1,1,0.01424,4,0.275514,0.296275,0
彩色片(1948),彩色片,notion,0,1,1,0,1,1,0.016752,4,0.279138,0.302165,0
影响(1948),影响,notion,0,6,6,0,8,8,0.069269,4,0.362194,0.405131,27879.618061
影子(1948),影子,notion,0,1,1,0,1,1,0.008247,4,0.26379,0.27611,0
影展(1948),影展,notion,0,1,1,0,1,1,0.016752,4,0.279138,0.302165,0
影片(1948),影片,notion,0,2,2,0,2,2,0.026272,4,0.29319,0.323683,1793.896368
彷徨(1948),彷徨,notion,0,2,2,0,2,2,0.014938,4,0.275333,0.296031,2167.523118
彻底(1948),彻底,notion,0,1,1,0,1,1,0.01022,4,0.267243,0.282233,0
彼得格勒(1948),彼得格勒,notion,0,1,1,0,1,1,0.009755,4,0.266617,0.281135,0
往往(1948),往往,notion,0,1,1,0,1,1,0.01424,4,0.275514,0.296275,0
征兵(1948),征兵,notion,0,2,2,0,4,4,0.026491,4,0.291937,0.321853,1403.825067
征助(1948),征助,notion,0,1,1,0,1,1,0.007515,4,0.262793,0.274313,0
征婚(1948),征婚,notion,0,1,1,0,1,1,0.01022,4,0.267243,0.282233,0
征实(1948),征实,notion,0,1,1,0,1,1,0.01022,4,0.267243,0.282233,0
征文(1948),征文,notion,0,1,1,0,1,1,0.009739,4,0.265806,0.279704,0
征服(1948),征服,notion,0,1,1,0,1,1,0.01424,4,0.275514,0.296275,0
征粮(1948),征粮,notion,0,1,1,0,1,1,0.01424,4,0.275514,0.296275,0
待续(1948),待续,notion,0,3,3,0,4,4,0.036012,4,0.306365,0.342074,4567.575323
待遇(1948),待遇,notion,0,4,4,0,4,4,0.045522,4,0.323237,0.363426,10523.143983
徐傅霖(1948),徐傅霖,notion,0,1,1,0,1,1,0.007515,4,0.262793,0.274313,0
徐毓(1948),徐毓,notion,0,1,1,0,2,2,0.008247,4,0.26379,0.27611,0
徐百齐(1948),徐百齐,notion,0,1,1,0,1,1,0.007515,4,0.262793,0.274313,0
徐茂红(1948),徐茂红,notion,0,1,1,0,1,1,0.009751,4,0.267186,0.282133,0
得到(1948),得到,notion,0,1,1,0,1,1,0.016518,4,0.278724,0.3015,0
得奖(1948),得奖,notion,0,1,1,0,1,1,0.009755,4,0.266617,0.281135,0
得益(1948),得益,notion,0,1,1,0,1,1,0.009755,4,0.266617,0.281135,0
御林军(1948),御林军,notion,0,1,1,0,1,1,0.016518,4,0.278724,0.3015,0
循环(1948),循环,notion,0,1,1,0,1,1,0.007515,4,0.262793,0.274313,0
徬徨(1948),徬徨,notion,0,2,2,0,2,2,0.028074,4,0.296149,0.327943,1864.79583
微妙(1948),微妙,notion,0,2,2,0,2,2,0.018837,4,0.280346,0.304151,1468.125238
微波(1948),微波,notion,0,1,1,0,1,1,0.008247,4,0.26379,0.27611,0
徵兵(1948),徵兵,notion,0,2,2,0,3,3,0.027839,4,0.295962,0.327676,1920.33989
徵收(1948),徵收,notion,0,1,1,0,1,1,0.01424,4,0.275514,0.296275,0
徵用(1948),徵用,notion,0,1,1,0,1,1,0.011322,4,0.269061,0.285394,0
德人(1948),德人,notion,0,1,1,0,1,1,0.009739,4,0.265806,0.279704,0
德华(1948),德华,notion,0,1,1,0,1,1,0.009739,4,0.265806,0.279704,0
德国(1948),德国,notion,0,7,7,0,12,12,0.084271,4,0.397156,0.435567,43860.694935
德政(1948),德政,notion,0,1,1,0,1,1,0.01424,4,0.275514,0.296275,0
德里(1948),德里,notion,0,1,1,0,1,1,0.011322,4,0.269061,0.285394,0
心声(1948),心声,notion,0,1,1,0,1,1,0.009751,4,0.267186,0.282133,0
心头(1948),心头,notion,0,1,1,0,1,1,0.009755,4,0.266617,0.281135,0
心得(1948),心得,notion,0,1,1,0,2,2,0.009751,4,0.267186,0.282133,0
心情(1948),心情,notion,0,2,2,0,2,2,0.026491,4,0.291937,0.321853,1403.825067
心曲(1948),心曲,notion,0,1,1,0,4,4,0.01424,4,0.275514,0.296275,0
心理(1948),心理,notion,0,4,4,0,4,4,0.043298,4,0.321055,0.360797,11027.062833
心理学(1948),心理学,notion,0,2,2,0,3,3,0.008698,4,0.258507,0.266483,0.569098
心目(1948),心目,notion,0,2,2,0,2,2,0.017736,4,0.278993,0.301988,1631.559673
心脏(1948),心脏,notion,0,1,1,0,1,1,0.009751,4,0.267186,0.282133,0
心里(1948),心里,notion,0,1,1,0,1,1,0.009751,4,0.267186,0.282133,0
心黑的(1948),心黑的,notion,0,1,1,0,1,1,0.01424,4,0.275514,0.296275,0
必死(1948),必死,notion,0,1,1,0,1,1,0.016518,4,0.278724,0.3015,0
必胜(1948),必胜,notion,0,1,1,0,1,1,0.01424,4,0.275514,0.296275,0
必要(1948),必要,notion,0,4,4,0,4,4,0.033463,4,0.298811,0.331814,5140.82571
必须(1948),必须,notion,0,5,5,0,7,7,0.058977,4,0.350862,0.393928,22163.827989
忆佩弦(1948),忆佩弦,notion,0,1,1,0,1,1,0.01022,4,0.267243,0.282233,0
忆念(1948),忆念,notion,0,1,1,0,1,1,0.016518,4,0.278724,0.3015,0
忌辰(1948),忌辰,notion,0,1,1,0,1,1,0.009755,4,0.266617,0.281135,0
忍耐(1948),忍耐,notion,0,1,1,0,1,1,0.004718,4,0.258401,0.266227,0
忘情(1948),忘情,notion,0,1,1,0,1,1,0.011322,4,0.269061,0.285394,0
忘本(1948),忘本,notion,0,1,1,0,1,1,0.009751,4,0.267186,0.282133,0
忘祖(1948),忘祖,notion,0,1,1,0,1,1,0.016752,4,0.279138,0.302165,0
忘记(1948),忘记,notion,0,1,1,0,1,1,0.009751,4,0.267186,0.282133,0
忠仆(1948),忠仆,notion,0,1,1,0,1,1,0.004718,4,0.258401,0.266227,0
忠君(1948),忠君,notion,0,1,1,0,1,1,0.005389,4,0.25849,0.266394,0
忠实(1948),忠实,notion,0,1,1,0,1,1,0.008247,4,0.26379,0.27611,0
忧思(1948),忧思,notion,0,1,1,0,1,1,0.01424,4,0.275514,0.296275,0
忧郁(1948),忧郁,notion,0,1,1,0,2,2,0.016752,4,0.279138,0.302165,0
忧闷(1948),忧闷,notion,0,1,1,0,1,1,0.01022,4,0.267243,0.282233,0
快乐(1948),快乐,notion,0,1,1,0,1,1,0.016752,4,0.279138,0.302165,0
快事(1948),快事,notion,0,1,1,0,1,1,0.01424,4,0.275514,0.296275,0
快刀斩乱(1948),快刀斩乱,notion,0,1,1,0,1,1,0.01424,4,0.275514,0.296275,0
快要(1948),快要,notion,0,1,1,0,1,1,0.016518,4,0.278724,0.3015,0
快谋(1948),快谋,notion,0,1,1,0,1,1,0.01424,4,0.275514,0.296275,0
忽略(1948),忽略,notion,0,1,1,0,1,1,0.004718,4,0.258401,0.266227,0
忽视(1948),忽视,notion,0,1,1,0,1,1,0.01424,4,0.275514,0.296275,0
忿忿(1948),忿忿,notion,0,1,1,0,1,1,0.008247,4,0.26379,0.27611,0
怀勋(1948),怀勋,notion,0,1,1,0,1,1,0.009751,4,0.267186,0.282133,0
怀南(1948),怀南,notion,0,1,1,0,1,1,0.009751,4,0.267186,0.282133,0
怀念(1948),怀念,notion,0,5,5,0,5,5,0.049207,4,0.327864,0.368938,13973.154206
怀柔(1948),怀柔,notion,0,1,1,0,1,1,0.01424,4,0.275514,0.296275,0
怀疑(1948),怀疑,notion,0,2,2,0,2,2,0.019491,4,0.281819,0.30648,1649.883746
态势(1948),态势,notion,0,1,1,0,1,1,0.011322,4,0.269061,0.285394,0
态度(1948),态度,notion,0,11,11,0,15,15,0.10827,4,0.430964,0.46048,72606.540465
怎么(1948),怎么,notion,0,1,1,0,1,1,0.009751,4,0.267186,0.282133,0
怎办(1948),怎办,notion,0,1,1,0,1,1,0.007515,4,0.262793,0.274313,0
怎样才能(1948),怎样才能,notion,0,1,1,0,1,1,0.01424,4,0.275514,0.296275,0
怒吼(1948),怒吼,notion,0,2,2,0,2,2,0.033269,4,0.305692,0.34112,2297.98609
怒潮(1948),怒潮,notion,0,1,1,0,1,1,0.009751,4,0.267186,0.282133,0
思想家(1948),思想家,notion,0,2,2,0,2,2,0.008698,4,0.258507,0.266483,0.569098
思想界(1948),思想界,notion,0,1,1,0,1,1,0.007515,4,0.262793,0.274313,0
思潮(1948),思潮,notion,0,1,1,0,1,1,0.002332,4,0.253398,0.256677,0
怠工(1948),怠工,notion,0,1,1,0,1,1,0.016752,4,0.279138,0.302165,0
急切(1948),急切,notion,0,1,1,0,1,1,0.01424,4,0.275514,0.296275,0
急惊风(1948),急惊风,notion,0,1,1,0,1,1,0.016752,4,0.279138,0.302165,0
急景(1948),急景,notion,0,1,1,0,1,1,0.016752,4,0.279138,0.302165,0
急智(1948),急智,notion,0,1,1,0,1,1,0.01424,4,0.275514,0.296275,0
急迫(1948),急迫,notion,0,1,1,0,1,1,0.01022,4,0.267243,0.282233,0
急遽(1948),急遽,notion,0,1,1,0,1,1,0.01022,4,0.267243,0.282233,0
急骤(1948),急骤,notion,0,1,1,0,1,1,0.016752,4,0.279138,0.302165,0
性及(1948),性及,notion,0,1,1,0,1,1,0.016518,4,0.278724,0.3015,0
性格(1948),性格,notion,0,1,1,0,1,1,0.008247,4,0.26379,0.27611,0
性质(1948),性质,notion,0,3,3,0,3,3,0.033747,4,0.308758,0.345235,7565.717635
怪哉(1948),怪哉,notion,0,1,1,0,1,1,0.016752,4,0.279138,0.302165,0
怪物(1948),怪物,notion,0,1,1,0,1,1,0.009755,4,0.266617,0.281135,0
怪现象(1948),怪现象,notion,0,1,1,0,1,1,0.008247,4,0.26379,0.27611,0
总体战(1948),总体战,notion,0,4,4,0,7,7,0.048728,4,0.332243,0.373907,12822.507001
总傅(1948),总傅,notion,0,1,1,0,1,1,0.01022,4,0.267243,0.282233,0
总动员(1948),总动员,notion,0,1,1,0,1,1,0.016752,4,0.279138,0.302165,0
总司令(1948),总司令,notion,0,1,1,0,1,1,0.01022,4,0.267243,0.282233,0
总工会(1948),总工会,notion,0,1,1,0,1,1,0.009755,4,0.266617,0.281135,0
总有(1948),总有,notion,0,1,1,0,1,1,0.004718,4,0.258401,0.266227,0
总有一天(1948),总有一天,notion,0,1,1,0,1,1,0.011322,4,0.269061,0.285394,0
总理(1948),总理,notion,0,3,3,0,3,3,0.043009,4,0.318172,0.357214,5224.220047
总裁(1948),总裁,notion,0,1,1,0,1,1,0.008247,4,0.26379,0.27611,0
总评(1948),总评,notion,0,1,1,0,1,1,0.009755,4,0.266617,0.281135,0
总选(1948),总选,notion,0,1,1,0,1,1,0.016752,4,0.279138,0.302165,0
总部(1948),总部,notion,0,4,4,0,4,4,0.042611,4,0.315739,0.354242,7987.812847
总预算(1948),总预算,notion,0,1,1,0,1,1,0.01022,4,0.267243,0.282233,0
总额(1948),总额,notion,0,1,1,0,1,1,0.008247,4,0.26379,0.27611,0
恐吓(1948),恐吓,notion,0,1,1,0,1,1,0.009755,4,0.266617,0.281135,0
恐怖(1948),恐怖,notion,0,6,6,0,7,7,0.061225,4,0.345505,0.38846,18124.559106
恐怖集团(1948),恐怖集团,notion,0,1,1,0,1,1,0.01424,4,0.275514,0.296275,0
恐惧(1948),恐惧,notion,0,3,3,0,3,3,0.03151,4,0.302956,0.337482,6157.59208
恐慌(1948),恐慌,notion,0,2,2,0,2,2,0.026972,4,0.293947,0.324781,1749.441854
恢复(1948),恢复,notion,0,3,3,0,4,4,0.031274,4,0.297062,0.329296,3066.900218
恩惠(1948),恩惠,notion,0,1,1,0,1,1,0.016752,4,0.279138,0.302165,0
恫吓(1948),恫吓,notion,0,3,3,0,3,3,0.027738,4,0.294477,0.325602,4898.216713
恭喜(1948),恭喜,notion,0,1,1,0,1,1,0.009751,4,0.267186,0.282133,0
恭维(1948),恭维,notion,0,1,1,0,1,1,0.016518,4,0.278724,0.3015,0
恳谈会(1948),恳谈会,notion,0,1,1,0,1,1,0.007515,4,0.262793,0.274313,0
恶作剧(1948),恶作剧,notion,0,1,1,0,1,1,0.01022,4,0.267243,0.282233,0
恶劣(1948),恶劣,notion,0,1,1,0,1,1,0.01424,4,0.275514,0.296275,0
恶果(1948),恶果,notion,0,1,1,0,1,1,0.009755,4,0.266617,0.281135,0
悔改(1948),悔改,notion,0,1,1,0,1,1,0.009751,4,0.267186,0.282133,0
悠诗(1948),悠诗,notion,0,1,1,0,1,1,0.005389,4,0.25849,0.266394,0
患下(1948),患下,notion,0,1,1,0,1,1,0.016518,4,0.278724,0.3015,0
悲剧(1948),悲剧,notion,0,7,7,0,10,10,0.070721,4,0.362789,0.405752,31761.905524
悲哀(1948),悲哀,notion,0,6,6,0,8,8,0.064925,4,0.354437,0.397578,23156.249815
悲喜剧(1948),悲喜剧,notion,0,1,1,0,1,1,0.016518,4,0.278724,0.3015,0
悲惨(1948),悲惨,notion,0,3,3,0,3,3,0.038287,4,0.310827,0.34793,4250.67334
悲惨世界(1948),悲惨世界,notion,0,1,1,0,1,1,0.01022,4,0.267243,0.282233,0
悲愤(1948),悲愤,notion,0,1,1,0,1,1,0.009751,4,0.267186,0.282133,0
悲观(1948),悲观,notion,0,1,1,0,1,1,0.01424,4,0.275514,0.296275,0
悲鸣(1948),悲鸣,notion,0,1,1,0,1,1,0.016518,4,0.278724,0.3015,0
悼佩弦(1948),悼佩弦,notion,0,2,2,0,2,2,0.008698,4,0.258507,0.266483,0.569098
悼念(1948),悼念,notion,0,3,3,0,4,4,0.013716,4,0.265336,0.278983,842.273604
悼柏蒂(1948),悼柏蒂,notion,0,1,1,0,1,1,0.011322,4,0.269061,0.285394,0
悼王(1948),悼王,notion,0,1,1,0,1,1,0.009751,4,0.267186,0.282133,0
悼褚慧僧(1948),悼褚慧僧,notion,0,1,1,0,1,1,0.009739,4,0.265806,0.279704,0
悼许(1948),悼许,notion,0,1,1,0,1,1,0.005017,4,0.257497,0.26453,0
悼贝纳斯(1948),悼贝纳斯,notion,0,1,1,0,1,1,0.011322,4,0.269061,0.285394,0
情况(1948),情况,notion,0,1,1,0,1,1,0.011322,4,0.269061,0.285394,0
情势(1948),情势,notion,0,5,5,0,5,5,0.059829,4,0.344018,0.386841,14840.273664
情形(1948),情形,notion,0,2,2,0,8,8,0.025562,4,0.293259,0.323783,2167.4723
情怀(1948),情怀,notion,0,1,1,0,1,1,0.01424,4,0.275514,0.296275,0
情报(1948),情报,notion,0,1,1,0,1,1,0.016752,4,0.279138,0.302165,0
情报局(1948),情报局,notion,0,1,1,0,1,1,0.016518,4,0.278724,0.3015,0
惊人(1948),惊人,notion,0,2,2,0,2,2,0.026257,4,0.292073,0.322053,1522.40889
惊险(1948),惊险,notion,0,1,1,0,1,1,0.008247,4,0.26379,0.27611,0
惠及(1948),惠及,notion,0,1,1,0,1,1,0.011322,4,0.269061,0.285394,0
惠鉴(1948),惠鉴,notion,0,1,1,0,1,1,0.01424,4,0.275514,0.296275,0
惠阳(1948),惠阳,notion,0,1,1,0,1,1,0.009751,4,0.267186,0.282133,0
惨剧(1948),惨剧,notion,0,1,1,0,1,1,0.016752,4,0.279138,0.302165,0
惨死(1948),惨死,notion,0,1,1,0,1,1,0.016752,4,0.279138,0.302165,0
惨状(1948),惨状,notion,0,2,2,0,2,2,0.026738,4,0.294408,0.325447,1993.868267
惨痛(1948),惨痛,notion,0,1,1,0,1,1,0.016518,4,0.278724,0.3015,0
惨败(1948),惨败,notion,0,3,3,0,3,3,0.038287,4,0.310827,0.34793,4250.67334
惨遭(1948),惨遭,notion,0,1,1,0,1,1,0.01022,4,0.267243,0.282233,0
惩办(1948),惩办,notion,0,1,1,0,1,1,0.016518,4,0.278724,0.3015,0
想像(1948),想像,notion,0,1,1,0,1,1,0.016752,4,0.279138,0.302165,0
想到(1948),想到,notion,0,2,2,0,2,2,0.028074,4,0.296149,0.327943,1864.79583
想起(1948),想起,notion,0,4,4,0,5,5,0.039937,4,0.315368,0.353776,11813.091629
惹起(1948),惹起,notion,0,1,1,0,1,1,0.007515,4,0.262793,0.274313,0
愁闷(1948),愁闷,notion,0,1,1,0,1,1,0.01022,4,0.267243,0.282233,0
愈强(1948),愈强,notion,0,1,1,0,1,1,0.009751,4,0.267186,0.282133,0
愈战(1948),愈战,notion,0,1,1,0,1,1,0.009751,4,0.267186,0.282133,0
愈站(1948),愈站,notion,0,1,1,0,1,1,0.011322,4,0.269061,0.285394,0
愈远(1948),愈远,notion,0,1,1,0,1,1,0.011322,4,0.269061,0.285394,0
愈长(1948),愈长,notion,0,1,1,0,1,1,0.016518,4,0.278724,0.3015,0
愉快(1948),愉快,notion,0,2,2,0,2,2,0.026269,4,0.293695,0.324415,1931.353166
意义(1948),意义,notion,0,9,9,0,14,14,0.094921,4,0.418575,0.451784,66400.815888
意共(1948),意共,notion,0,1,1,0,1,1,0.016518,4,0.278724,0.3015,0
意味(1948),意味,notion,0,1,1,0,1,1,0.011322,4,0.269061,0.285394,0
意外(1948),意外,notion,0,1,1,0,1,1,0.016752,4,0.279138,0.302165,0
意政(1948),意政,notion,0,1,1,0,1,1,0.01424,4,0.275514,0.296275,0
愚昧(1948),愚昧,notion,0,1,1,0,1,1,0.01022,4,0.267243,0.282233,0
感情(1948),感情,notion,0,1,1,0,1,1,0.008247,4,0.26379,0.27611,0
感想(1948),感想,notion,0,6,6,0,9,9,0.062716,4,0.358633,0.401704,32681.676768
感慨(1948),感慨,notion,0,1,1,0,1,1,0.016752,4,0.279138,0.302165,0
感觉(1948),感觉,notion,0,1,1,0,1,1,0.007515,4,0.262793,0.274313,0
愤怒(1948),愤怒,notion,0,1,1,0,1,1,0.016518,4,0.278724,0.3015,0
愿为(1948),愿为,notion,0,1,1,0,1,1,0.01424,4,0.275514,0.296275,0
慈善家(1948),慈善家,notion,0,1,1,0,1,1,0.009755,4,0.266617,0.281135,0
慌乱(1948),慌乱,notion,0,1,1,0,1,1,0.005017,4,0.257497,0.26453,0
慎重(1948),慎重,notion,0,1,1,0,1,1,0.01424,4,0.275514,0.296275,0
慢性病(1948),慢性病,notion,0,1,1,0,1,1,0.009751,4,0.267186,0.282133,0
慢而(1948),慢而,notion,0,1,1,0,1,1,0.01022,4,0.267243,0.282233,0
慰问(1948),慰问,notion,0,3,3,0,3,3,0.04751,4,0.331714,0.373253,8022.59349
慷慨(1948),慷慨,notion,0,1,1,0,1,1,0.005017,4,0.257497,0.26453,0
憧憬(1948),憧憬,notion,0,1,1,0,1,1,0.016752,4,0.279138,0.302165,0
戊戌(1948),戊戌,notion,0,1,1,0,1,1,0.01022,4,0.267243,0.282233,0
戊戌维新(1948),戊戌维新,notion,0,2,2,0,2,2,0.026972,4,0.293947,0.324781,1749.441854
戊戌维新运动(1948),戊戌维新运动,notion,0,1,1,0,1,1,0.007515,4,0.262793,0.274313,0
戏剧家(1948),戏剧家,notion,0,1,1,0,1,1,0.01424,4,0.275514,0.296275,0
戏院(1948),戏院,notion,0,2,2,0,2,2,0.023995,4,0.291507,0.321221,2493.732085
成事不足(1948),成事不足,notion,0,1,1,0,1,1,0.011322,4,0.269061,0.285394,0
成仁(1948),成仁,notion,0,1,1,0,1,1,0.016518,4,0.278724,0.3015,0
成功(1948),成功,notion,0,5,5,0,5,5,0.050248,4,0.333245,0.375094,19026.660786
成就(1948),成就,notion,0,3,3,0,3,3,0.03129,4,0.298028,0.33066,3454.699616
成果(1948),成果,notion,0,1,1,0,1,1,0.009755,4,0.266617,0.281135,0
成熟(1948),成熟,notion,0,1,1,0,1,1,0.016752,4,0.279138,0.302165,0
成爲(1948),成爲,notion,0,1,1,0,1,1,0.016518,4,0.278724,0.3015,0
成绩(1948),成绩,notion,0,2,2,0,2,2,0.021061,4,0.283157,0.308576,1336.570675
成败(1948),成败,notion,0,3,3,0,3,3,0.033077,4,0.30475,0.339911,5680.358983
成都市(1948),成都市,notion,0,1,1,0,1,1,0.007515,4,0.262793,0.274313,0
成长(1948),成长,notion,0,4,4,0,5,5,0.03881,4,0.310185,0.347154,7359.443478
成风(1948),成风,notion,0,1,1,0,1,1,0.01022,4,0.267243,0.282233,0
我以(1948),我以,notion,0,1,1,0,1,1,0.009739,4,0.265806,0.279704,0
我俩(1948),我俩,notion,0,1,1,0,1,1,0.011322,4,0.269061,0.285394,0
我在(1948),我在,notion,0,1,1,0,1,1,0.009739,4,0.265806,0.279704,0
我愿(1948),我愿,notion,0,2,2,0,2,2,0.026491,4,0.291937,0.321853,1403.825067
我生(1948),我生,notion,0,2,2,0,2,2,0.008698,4,0.258507,0.266483,0.569098
我的(1948),我的,notion,0,1,1,0,1,1,0.009755,4,0.266617,0.281135,0
我的诗(1948),我的诗,notion,0,1,1,0,1,1,0.009755,4,0.266617,0.281135,0
我见(1948),我见,notion,0,1,1,0,1,1,0.016752,4,0.279138,0.302165,0
戒严(1948),戒严,notion,0,1,1,0,1,1,0.01022,4,0.267243,0.282233,0
戒严令(1948),戒严令,notion,0,1,1,0,1,1,0.008247,4,0.26379,0.27611,0
戒指(1948),戒指,notion,0,1,1,0,1,1,0.011322,4,0.269061,0.285394,0
戒烟(1948),戒烟,notion,0,1,1,0,1,1,0.009755,4,0.266617,0.281135,0
或者(1948),或者,notion,0,1,1,0,1,1,0.009751,4,0.267186,0.282133,0
战争(1948),战争,notion,0,9,9,0,26,26,0.104309,4,0.434805,0.462931,66276.13276
战争狂(1948),战争狂,notion,0,1,1,0,1,1,0.009739,4,0.265806,0.279704,0
战争罪犯(1948),战争罪犯,notion,0,1,1,0,1,1,0.016518,4,0.278724,0.3015,0
战争贩子(1948),战争贩子,notion,0,1,1,0,2,2,0.009755,4,0.266617,0.281135,0
战云(1948),战云,notion,0,1,1,0,1,1,0.011322,4,0.269061,0.285394,0
战例(1948),战例,notion,0,1,1,0,1,1,0.016518,4,0.278724,0.3015,0
战前(1948),战前,notion,0,4,4,0,4,4,0.036824,4,0.305991,0.34163,8036.135678
战危(1948),战危,notion,0,1,1,0,1,1,0.01022,4,0.267243,0.282233,0
战友(1948),战友,notion,0,1,1,0,1,1,0.016518,4,0.278724,0.3015,0
战后(1948),战后,notion,0,5,5,0,9,9,0.044775,4,0.322156,0.362183,15324.563563
战地(1948),战地,notion,0,1,1,0,1,1,0.01424,4,0.275514,0.296275,0
战场(1948),战场,notion,0,9,9,0,14,14,0.100241,4,0.426463,0.457307,63467.701607
战斗(1948),战斗,notion,0,6,6,0,13,13,0.051382,4,0.332949,0.374817,22484.399263
战斗员(1948),战斗员,notion,0,1,1,0,1,1,0.009751,4,0.267186,0.282133,0
战斗英雄(1948),战斗英雄,notion,0,1,1,0,1,1,0.009751,4,0.267186,0.282133,0
战时(1948),战时,notion,0,1,1,0,1,1,0.016752,4,0.279138,0.302165,0
战术(1948),战术,notion,0,2,2,0,2,2,0.028074,4,0.296149,0.327943,1864.79583
战棋(1948),战棋,notion,0,1,1,0,1,1,0.016752,4,0.279138,0.302165,0
战氛(1948),战氛,notion,0,1,1,0,1,1,0.01022,4,0.267243,0.282233,0
战犯(1948),战犯,notion,0,1,1,0,1,1,0.016752,4,0.279138,0.302165,0
战略地位(1948),战略地位,notion,0,2,2,0,2,2,0.008698,4,0.258507,0.266483,0.569098
战略意义(1948),战略意义,notion,0,1,1,0,1,1,0.005017,4,0.257497,0.26453,0
战线(1948),战线,notion,0,5,5,0,7,7,0.056218,4,0.340556,0.383147,18043.051611
战绩(1948),战绩,notion,0,3,3,0,3,3,0.036009,4,0.307318,0.343338,5103.645801
战胜(1948),战胜,notion,0,1,1,0,1,1,0.016518,4,0.278724,0.3015,0
战讯(1948),战讯,notion,0,1,1,0,1,1,0.009739,4,0.265806,0.279704,0
战贩(1948),战贩,notion,0,1,1,0,1,1,0.009739,4,0.265806,0.279704,0
战车(1948),战车,notion,0,1,1,0,1,1,0.009755,4,0.266617,0.281135,0
战难(1948),战难,notion,0,1,1,0,1,1,0.011322,4,0.269061,0.285394,0
战雨(1948),战雨,notion,0,1,1,0,1,1,0.01022,4,0.267243,0.282233,0
战雾(1948),战雾,notion,0,1,1,0,1,1,0.009739,4,0.265806,0.279704,0
战鬥(1948),战鬥,notion,0,1,1,0,2,2,0.016518,4,0.278724,0.3015,0
战鬥中(1948),战鬥中,notion,0,1,1,0,1,1,0.016518,4,0.278724,0.3015,0
战鼓(1948),战鼓,notion,0,2,2,0,2,2,0.026491,4,0.291937,0.321853,1403.825067
戡乱(1948),戡乱,notion,0,4,4,0,7,7,0.051819,4,0.335267,0.377302,11757.696376
戡乱时期(1948),戡乱时期,notion,0,2,2,0,2,2,0.018837,4,0.280346,0.304151,1468.125238
截止(1948),截止,notion,0,1,1,0,1,1,0.011322,4,0.269061,0.285394,0
戳穿(1948),戳穿,notion,0,2,2,0,3,3,0.030758,4,0.303347,0.337959,2812.221703
戴世光(1948),戴世光,notion,0,1,1,0,1,1,0.01022,4,0.267243,0.282233,0
戴过(1948),戴过,notion,0,1,1,0,1,1,0.016518,4,0.278724,0.3015,0
戴高乐(1948),戴高乐,notion,0,1,1,0,2,2,0.009755,4,0.266617,0.281135,0
户口普查(1948),户口普查,notion,0,1,1,0,1,1,0.01424,4,0.275514,0.296275,0
房东(1948),房东,notion,0,1,1,0,1,1,0.01424,4,0.275514,0.296275,0
房客(1948),房客,notion,0,1,1,0,1,1,0.01424,4,0.275514,0.296275,0
所以(1948),所以,notion,0,1,1,0,1,1,0.01424,4,0.275514,0.296275,0
所写(1948),所写,notion,0,2,2,0,2,2,0.026269,4,0.293695,0.324415,1931.353166
所到之处(1948),所到之处,notion,0,1,1,0,2,2,0.009755,4,0.266617,0.281135,0
所感(1948),所感,notion,0,1,1,0,1,1,0.004718,4,0.258401,0.266227,0
所有(1948),所有,notion,0,1,1,0,1,1,0.016752,4,0.279138,0.302165,0
所系的(1948),所系的,notion,0,1,1,0,1,1,0.007515,4,0.262793,0.274313,0
所能(1948),所能,notion,0,1,1,0,2,2,0.008247,4,0.26379,0.27611,0
所见所闻(1948),所见所闻,notion,0,1,1,0,1,1,0.01424,4,0.275514,0.296275,0
所谓(1948),所谓,notion,0,9,9,0,19,19,0.101091,4,0.43047,0.460036,67026.589309
扁担(1948),扁担,notion,0,1,1,0,1,1,0.004718,4,0.258401,0.266227,0
手忙脚乱(1948),手忙脚乱,notion,0,1,1,0,1,1,0.016518,4,0.278724,0.3015,0
手快(1948),手快,notion,0,1,1,0,1,1,0.009751,4,0.267186,0.282133,0
手段(1948),手段,notion,0,3,3,0,3,3,0.018453,4,0.274528,0.294756,1725.62382
手腕(1948),手腕,notion,0,1,1,0,1,1,0.016752,4,0.279138,0.302165,0
手裏(1948),手裏,notion,0,1,1,0,1,1,0.016518,4,0.278724,0.3015,0
手记(1948),手记,notion,0,2,2,0,2,2,0.017999,4,0.280116,0.303785,1897.286008
才士(1948),才士,notion,0,1,1,0,1,1,0.01424,4,0.275514,0.296275,0
才能(1948),才能,notion,0,2,2,0,3,3,0.023992,4,0.29271,0.322985,3168.205568
扑灭(1948),扑灭,notion,0,1,1,0,1,1,0.016752,4,0.279138,0.302165,0
扒手(1948),扒手,notion,0,2,2,0,2,2,0.019569,4,0.280598,0.30455,1193.220239
打与(1948),打与,notion,0,1,1,0,1,1,0.01022,4,0.267243,0.282233,0
打人(1948),打人,notion,0,1,1,0,1,1,0.009739,4,0.265806,0.279704,0
打入(1948),打入,notion,0,1,1,0,1,1,0.009751,4,0.267186,0.282133,0
打击(1948),打击,notion,0,1,1,0,1,1,0.009751,4,0.267186,0.282133,0
打垮(1948),打垮,notion,0,1,1,0,1,1,0.016518,4,0.278724,0.3015,0
打扮(1948),打扮,notion,0,1,1,0,1,1,0.016518,4,0.278724,0.3015,0
打破(1948),打破,notion,0,1,1,0,1,1,0.016752,4,0.279138,0.302165,0
打碎(1948),打碎,notion,0,1,1,0,1,1,0.016518,4,0.278724,0.3015,0
打翻(1948),打翻,notion,0,1,1,0,1,1,0.016518,4,0.278724,0.3015,0
打胜仗(1948),打胜仗,notion,0,1,1,0,2,2,0.009751,4,0.267186,0.282133,0
打虎(1948),打虎,notion,0,3,3,0,4,4,0.039239,4,0.316724,0.355417,6944.905464
打虎队(1948),打虎队,notion,0,1,1,0,1,1,0.005389,4,0.25849,0.266394,0
打赏(1948),打赏,notion,0,1,1,0,1,1,0.016518,4,0.278724,0.3015,0
打通(1948),打通,notion,0,1,1,0,1,1,0.01022,4,0.267243,0.282233,0
托儿所(1948),托儿所,notion,0,2,2,0,2,2,0.021469,4,0.287095,0.314632,2527.522512
托庇(1948),托庇,notion,0,1,1,0,1,1,0.01424,4,0.275514,0.296275,0
托格(1948),托格,notion,0,1,1,0,1,1,0.016518,4,0.278724,0.3015,0
执委会(1948),执委会,notion,0,1,1,0,1,1,0.016518,4,0.278724,0.3015,0
执政(1948),执政,notion,0,1,1,0,1,1,0.01022,4,0.267243,0.282233,0
执法(1948),执法,notion,0,2,2,0,2,2,0.012965,4,0.271708,0.289975,1825.821004
执行(1948),执行,notion,0,4,4,0,4,4,0.035269,4,0.30762,0.343793,10723.127673
扩军(1948),扩军,notion,0,1,1,0,1,1,0.007515,4,0.262793,0.274313,0
扩及(1948),扩及,notion,0,2,2,0,2,2,0.008698,4,0.258507,0.266483,0.569098
扩大(1948),扩大,notion,0,5,5,0,6,6,0.062267,4,0.350927,0.393995,16945.430125
扩展(1948),扩展,notion,0,2,2,0,2,2,0.021756,4,0.286964,0.314433,2044.761444
扩张(1948),扩张,notion,0,3,3,0,5,5,0.036493,4,0.309342,0.346,5642.475469
扩张主义(1948),扩张主义,notion,0,1,1,0,1,1,0.009755,4,0.266617,0.281135,0
扩张政策(1948),扩张政策,notion,0,3,3,0,3,3,0.036246,4,0.306866,0.342739,4667.991046
扫射(1948),扫射,notion,0,1,1,0,1,1,0.009751,4,0.267186,0.282133,0
扬眉吐气(1948),扬眉吐气,notion,0,1,1,0,1,1,0.009751,4,0.267186,0.282133,0
扬阳(1948),扬阳,notion,0,1,1,0,1,1,0.009751,4,0.267186,0.282133,0
扬马(1948),扬马,notion,0,1,1,0,1,1,0.016752,4,0.279138,0.302165,0
扶助(1948),扶助,notion,0,2,2,0,2,2,0.026491,4,0.291937,0.321853,1403.825067
扶德(1948),扶德,notion,0,1,1,0,1,1,0.009755,4,0.266617,0.281135,0
扶持(1948),扶持,notion,0,1,1,0,1,1,0.008247,4,0.26379,0.27611,0
扶日(1948),扶日,notion,0,5,5,0,6,6,0.051484,4,0.327721,0.368772,12841.548588
扶日声(1948),扶日声,notion,0,2,2,0,2,2,0.024999,4,0.291484,0.321188,1929.694181
批判(1948),批判,notion,0,5,5,0,7,7,0.051484,4,0.327721,0.368772,12841.548588
批评家(1948),批评家,notion,0,1,1,0,2,2,0.009755,4,0.266617,0.281135,0
批驳(1948),批驳,notion,0,1,1,0,1,1,0.009755,4,0.266617,0.281135,0
扼杀(1948),扼杀,notion,0,1,1,0,1,1,0.005017,4,0.257497,0.26453,0
找事(1948),找事,notion,0,1,1,0,1,1,0.004718,4,0.258401,0.266227,0
找到(1948),找到,notion,0,1,1,0,1,1,0.009751,4,0.267186,0.282133,0
承当(1948),承当,notion,0,1,1,0,1,1,0.008247,4,0.26379,0.27611,0
承认(1948),承认,notion,0,1,1,0,1,1,0.008247,4,0.26379,0.27611,0
技工(1948),技工,notion,0,1,1,0,1,1,0.004718,4,0.258401,0.266227,0
技术(1948),技术,notion,0,5,5,0,9,9,0.041255,4,0.311601,0.349039,11360.48755
技能(1948),技能,notion,0,1,1,0,1,1,0.004718,4,0.258401,0.266227,0
抉择(1948),抉择,notion,0,4,4,0,5,5,0.041716,4,0.317903,0.356937,10623.865608
把戏(1948),把戏,notion,0,2,2,0,3,3,0.023995,4,0.291507,0.321221,2493.732085
把握(1948),把握,notion,0,2,2,0,2,2,0.014457,4,0.273688,0.293303,1733.460346
把握住(1948),把握住,notion,0,1,1,0,1,1,0.01424,4,0.275514,0.296275,0
抒写(1948),抒写,notion,0,1,1,0,1,1,0.01424,4,0.275514,0.296275,0
抓壮丁(1948),抓壮丁,notion,0,2,2,0,5,5,0.021542,4,0.284314,0.310373,1410.419447
投稿(1948),投稿,notion,0,1,1,0,1,1,0.01424,4,0.275514,0.296275,0
投考(1948),投考,notion,0,1,1,0,1,1,0.011322,4,0.269061,0.285394,0
投资(1948),投资,notion,0,1,1,0,1,1,0.016752,4,0.279138,0.302165,0
抗争(1948),抗争,notion,0,1,1,0,1,1,0.009751,4,0.267186,0.282133,0
抗事(1948),抗事,notion,0,1,1,0,1,1,0.005017,4,0.257497,0.26453,0
抗击(1948),抗击,notion,0,1,1,0,1,1,0.009751,4,0.267186,0.282133,0
抗征(1948),抗征,notion,0,1,1,0,1,1,0.009751,4,0.267186,0.282133,0
抗征队(1948),抗征队,notion,0,1,1,0,1,1,0.009751,4,0.267186,0.282133,0
抗暴(1948),抗暴,notion,0,1,1,0,2,2,0.009739,4,0.265806,0.279704,0
折减(1948),折减,notion,0,1,1,0,1,1,0.01022,4,0.267243,0.282233,0
抢渡(1948),抢渡,notion,0,1,1,0,1,1,0.016518,4,0.278724,0.3015,0
抢米(1948),抢米,notion,0,1,1,0,1,1,0.01022,4,0.267243,0.282233,0
抢米记(1948),抢米记,notion,0,1,1,0,3,3,0.011322,4,0.269061,0.285394,0
抢购(1948),抢购,notion,0,2,2,0,3,3,0.033269,4,0.305692,0.34112,2297.98609
抢购潮(1948),抢购潮,notion,0,4,4,0,4,4,0.043676,4,0.318199,0.357303,7262.298095
抢险(1948),抢险,notion,0,1,1,0,2,2,0.016518,4,0.278724,0.3015,0
护工(1948),护工,notion,0,1,1,0,1,1,0.016518,4,0.278724,0.3015,0
护救(1948),护救,notion,0,1,1,0,1,1,0.005389,4,0.25849,0.266394,0
报业(1948),报业,notion,0,1,1,0,1,1,0.007515,4,0.262793,0.274313,0
报人(1948),报人,notion,0,1,1,0,1,1,0.005389,4,0.25849,0.266394,0
报停(1948),报停,notion,0,1,1,0,1,1,0.01424,4,0.275514,0.296275,0
报告书(1948),报告书,notion,0,1,1,0,2,2,0.011322,4,0.269061,0.285394,0
报告文学(1948),报告文学,notion,0,1,1,0,1,1,0.009739,4,0.265806,0.279704,0
报界(1948),报界,notion,0,1,1,0,2,2,0.016752,4,0.279138,0.302165,0
报社(1948),报社,notion,0,1,1,0,1,1,0.009755,4,0.266617,0.281135,0
报纸(1948),报纸,notion,0,5,5,0,6,6,0.046838,4,0.327065,0.368007,15969.988759
报聘(1948),报聘,notion,0,1,1,0,1,1,0.01022,4,0.267243,0.282233,0
披宗外(1948),披宗外,notion,0,1,1,0,1,1,0.016518,4,0.278724,0.3015,0
披汶(1948),披汶,notion,0,3,3,0,3,3,0.038287,4,0.310827,0.34793,4250.67334
披汶大捕(1948),披汶大捕,notion,0,1,1,0,1,1,0.016518,4,0.278724,0.3015,0
抬举(1948),抬举,notion,0,1,1,0,1,1,0.01022,4,0.267243,0.282233,0
抵制(1948),抵制,notion,0,1,1,0,1,1,0.009739,4,0.265806,0.279704,0
抵抗运动(1948),抵抗运动,notion,0,1,1,0,1,1,0.009755,4,0.266617,0.281135,0
抽愈紧(1948),抽愈紧,notion,0,1,1,0,1,1,0.016752,4,0.279138,0.302165,0
担任(1948),担任,notion,0,1,1,0,1,1,0.007515,4,0.262793,0.274313,0
担保(1948),担保,notion,0,1,1,0,1,1,0.008247,4,0.26379,0.27611,0
拆关(1948),拆关,notion,0,1,1,0,1,1,0.009751,4,0.267186,0.282133,0
拆屋(1948),拆屋,notion,0,2,2,0,2,2,0.019491,4,0.281819,0.30648,1649.883746
拆除(1948),拆除,notion,0,1,1,0,1,1,0.016752,4,0.279138,0.302165,0
拉丁(1948),拉丁,notion,0,1,1,0,1,1,0.01022,4,0.267243,0.282233,0
拉科西(1948),拉科西,notion,0,1,1,0,1,1,0.009755,4,0.266617,0.281135,0
拉铁(1948),拉铁,notion,0,1,1,0,1,1,0.009739,4,0.265806,0.279704,0
拍卖(1948),拍卖,notion,0,1,1,0,1,1,0.016518,4,0.278724,0.3015,0
拒绝(1948),拒绝,notion,0,2,2,0,2,2,0.021076,4,0.284616,0.310839,1735.877057
拒运(1948),拒运,notion,0,1,1,0,1,1,0.009739,4,0.265806,0.279704,0
拓展(1948),拓展,notion,0,1,1,0,1,1,0.004718,4,0.258401,0.266227,0
拖入(1948),拖入,notion,0,1,1,0,1,1,0.008247,4,0.26379,0.27611,0
拖出来(1948),拖出来,notion,0,1,1,0,1,1,0.016518,4,0.278724,0.3015,0
拖车(1948),拖车,notion,0,1,1,0,1,1,0.009751,4,0.267186,0.282133,0
拘捕(1948),拘捕,notion,0,3,3,0,3,3,0.035782,4,0.309037,0.345601,5882.616477
拘泥形式(1948),拘泥形式,notion,0,1,1,0,1,1,0.008247,4,0.26379,0.27611,0
招亲(1948),招亲,notion,0,1,1,0,1,1,0.009751,4,0.267186,0.282133,0
招供(1948),招供,notion,0,1,1,0,1,1,0.009755,4,0.266617,0.281135,0
招待会(1948),招待会,notion,0,1,1,0,1,1,0.007515,4,0.262793,0.274313,0
招生(1948),招生,notion,0,1,1,0,1,1,0.011322,4,0.269061,0.285394,0
招考(1948),招考,notion,0,1,1,0,1,1,0.011322,4,0.269061,0.285394,0
招致(1948),招致,notion,0,1,1,0,1,1,0.011322,4,0.269061,0.285394,0
拜金主义(1948),拜金主义,notion,0,1,1,0,1,1,0.01022,4,0.267243,0.282233,0
拟上(1948),拟上,notion,0,1,1,0,1,1,0.01022,4,0.267243,0.282233,0
拦阻(1948),拦阻,notion,0,1,1,0,1,1,0.009755,4,0.266617,0.281135,0
择友(1948),择友,notion,0,1,1,0,1,1,0.004718,4,0.258401,0.266227,0
拯救(1948),拯救,notion,0,3,3,0,3,3,0.04751,4,0.331714,0.373253,8022.59349
拳技(1948),拳技,notion,0,1,1,0,1,1,0.01424,4,0.275514,0.296275,0
拿出(1948),拿出,notion,0,2,2,0,2,2,0.030992,4,0.303936,0.338757,2912.385696
拿起(1948),拿起,notion,0,1,1,0,1,1,0.009751,4,0.267186,0.282133,0
持久(1948),持久,notion,0,1,1,0,1,1,0.005017,4,0.257497,0.26453,0
持久和平(1948),持久和平,notion,0,2,2,0,2,2,0.026269,4,0.293695,0.324415,1931.353166
挂起(1948),挂起,notion,0,1,1,0,1,1,0.016752,4,0.279138,0.302165,0
指人(1948),指人,notion,0,1,1,0,1,1,0.01424,4,0.275514,0.296275,0
指使(1948),指使,notion,0,1,1,0,1,1,0.01424,4,0.275514,0.296275,0
指向(1948),指向,notion,0,1,1,0,1,1,0.011322,4,0.269061,0.285394,0
指导(1948),指导,notion,0,1,1,0,1,1,0.004718,4,0.258401,0.266227,0
指摘(1948),指摘,notion,0,1,1,0,1,1,0.01424,4,0.275514,0.296275,0
指数(1948),指数,notion,0,2,2,0,2,2,0.01996,4,0.281333,0.305715,1305.273912
指甲(1948),指甲,notion,0,1,1,0,1,1,0.011322,4,0.269061,0.285394,0
指针(1948),指针,notion,0,1,1,0,1,1,0.016518,4,0.278724,0.3015,0
指鹿(1948),指鹿,notion,0,1,1,0,1,1,0.01424,4,0.275514,0.296275,0
按籍(1948),按籍,notion,0,1,1,0,1,1,0.007515,4,0.262793,0.274313,0
挑战(1948),挑战,notion,0,2,2,0,2,2,0.021235,4,0.286701,0.314033,2523.953101
挑泥(1948),挑泥,notion,0,1,1,0,1,1,0.004718,4,0.258401,0.266227,0
挖出(1948),挖出,notion,0,1,1,0,1,1,0.009751,4,0.267186,0.282133,0
挖掘(1948),挖掘,notion,0,1,1,0,1,1,0.009751,4,0.267186,0.282133,0
挖肉补疮(1948),挖肉补疮,notion,0,1,1,0,1,1,0.016752,4,0.279138,0.302165,0
挡口(1948),挡口,notion,0,1,1,0,1,1,0.005017,4,0.257497,0.26453,0
挣扎(1948),挣扎,notion,0,2,2,0,2,2,0.033269,4,0.305692,0.34112,2297.98609
挤兑(1948),挤兑,notion,0,1,1,0,1,1,0.01022,4,0.267243,0.282233,0
挤出来(1948),挤出来,notion,0,1,1,0,1,1,0.016518,4,0.278724,0.3015,0
挨打(1948),挨打,notion,0,1,1,0,1,1,0.016752,4,0.279138,0.302165,0
挺立(1948),挺立,notion,0,1,1,0,1,1,0.009751,4,0.267186,0.282133,0
挺身(1948),挺身,notion,0,1,1,0,1,1,0.008247,4,0.26379,0.27611,0
挺进(1948),挺进,notion,0,2,2,0,4,4,0.026272,4,0.29319,0.323683,1793.896368
挽救(1948),挽救,notion,0,6,6,0,6,6,0.058293,4,0.341764,0.3845,19949.877217
捐出(1948),捐出,notion,0,1,1,0,1,1,0.01424,4,0.275514,0.296275,0
捐纳(1948),捐纳,notion,0,1,1,0,1,1,0.007515,4,0.262793,0.274313,0
捕人(1948),捕人,notion,0,1,1,0,1,1,0.01022,4,0.267243,0.282233,0
换文(1948),换文,notion,0,5,5,0,6,6,0.054492,4,0.339693,0.382215,18985.069958
换新骨(1948),换新骨,notion,0,1,1,0,1,1,0.016518,4,0.278724,0.3015,0
捣乱份子(1948),捣乱份子,notion,0,1,1,0,1,1,0.01424,4,0.275514,0.296275,0
捧场(1948),捧场,notion,0,1,1,0,1,1,0.008247,4,0.26379,0.27611,0
捷克斯洛伐克(1948),捷克斯洛伐克,notion,0,1,1,0,1,1,0.009755,4,0.266617,0.281135,0
捷径(1948),捷径,notion,0,1,1,0,1,1,0.016518,4,0.278724,0.3015,0
捷报(1948),捷报,notion,0,1,1,0,2,2,0.009751,4,0.267186,0.282133,0
捷报频传(1948),捷报频传,notion,0,1,1,0,1,1,0.009739,4,0.265806,0.279704,0
授人(1948),授人,notion,0,1,1,0,1,1,0.008247,4,0.26379,0.27611,0
授关(1948),授关,notion,0,1,1,0,1,1,0.011322,4,0.269061,0.285394,0
授田(1948),授田,notion,0,1,1,0,1,1,0.01424,4,0.275514,0.296275,0
授的(1948),授的,notion,0,1,1,0,1,1,0.01424,4,0.275514,0.296275,0
掌握(1948),掌握,notion,0,1,1,0,2,2,0.009751,4,0.267186,0.282133,0
掌故(1948),掌故,notion,0,1,1,0,1,1,0.008247,4,0.26379,0.27611,0
排华(1948),排华,notion,0,2,2,0,2,2,0.024765,4,0.291552,0.321288,2097.245087
排印(1948),排印,notion,0,1,1,0,1,1,0.009739,4,0.265806,0.279704,0
掠夺(1948),掠夺,notion,0,2,2,0,3,3,0.021535,4,0.28397,0.309841,889.229879
掠夺者(1948),掠夺者,notion,0,1,1,0,1,1,0.01424,4,0.275514,0.296275,0
探寻(1948),探寻,notion,0,1,1,0,1,1,0.01424,4,0.275514,0.296275,0
接着(1948),接着,notion,0,1,1,0,1,1,0.016752,4,0.279138,0.302165,0
接近(1948),接近,notion,0,2,2,0,3,3,0.026503,4,0.295799,0.327444,2668.961321
接连(1948),接连,notion,0,2,2,0,2,2,0.026503,4,0.295799,0.327444,2668.961321
控制(1948),控制,notion,0,6,6,0,6,6,0.056726,4,0.341236,0.383935,26037.393493
控诉(1948),控诉,notion,0,4,4,0,5,5,0.04283,4,0.314575,0.352777,7200.806677
推举(1948),推举,notion,0,1,1,0,1,1,0.007515,4,0.262793,0.274313,0
推广(1948),推广,notion,0,1,1,0,1,1,0.004718,4,0.258401,0.266227,0
推移(1948),推移,notion,0,1,1,0,1,1,0.01022,4,0.267243,0.282233,0
推翻(1948),推翻,notion,0,1,1,0,1,1,0.016518,4,0.278724,0.3015,0
推荐(1948),推荐,notion,0,3,3,0,3,3,0.031221,4,0.303789,0.338613,7162.025929
推论(1948),推论,notion,0,1,1,0,1,1,0.007515,4,0.262793,0.274313,0
掩蔽(1948),掩蔽,notion,0,2,2,0,2,2,0.026491,4,0.291937,0.321853,1403.825067
措拖(1948),措拖,notion,0,1,1,0,1,1,0.008247,4,0.26379,0.27611,0
描写(1948),描写,notion,0,1,1,0,1,1,0.008247,4,0.26379,0.27611,0
提出(1948),提出,notion,0,2,2,0,2,2,0.02398,4,0.290133,0.319191,1998.682918
提反(1948),提反,notion,0,1,1,0,1,1,0.009739,4,0.265806,0.279704,0
提岸(1948),提岸,notion,0,1,1,0,1,1,0.009739,4,0.265806,0.279704,0
提心吊胆(1948),提心吊胆,notion,0,1,1,0,1,1,0.016518,4,0.278724,0.3015,0
提携(1948),提携,notion,0,1,1,0,1,1,0.005017,4,0.257497,0.26453,0
提要(1948),提要,notion,0,1,1,0,1,1,0.009751,4,0.267186,0.282133,0
插到(1948),插到,notion,0,1,1,0,1,1,0.016518,4,0.278724,0.3015,0
插图(1948),插图,notion,0,1,1,0,5,5,0.002332,4,0.253398,0.256677,0
插曲(1948),插曲,notion,0,2,2,0,3,3,0.026491,4,0.291937,0.321853,1403.825067
握手(1948),握手,notion,0,1,1,0,1,1,0.002332,4,0.253398,0.256677,0
揣克(1948),揣克,notion,0,1,1,0,1,1,0.008247,4,0.26379,0.27611,0
揩油(1948),揩油,notion,0,1,1,0,1,1,0.01022,4,0.267243,0.282233,0
揭幕(1948),揭幕,notion,0,2,2,0,3,3,0.019975,4,0.283071,0.308443,1854.710834
揭晓(1948),揭晓,notion,0,1,1,0,1,1,0.016752,4,0.279138,0.302165,0
揭穿(1948),揭穿,notion,0,3,3,0,6,6,0.035775,4,0.308859,0.345368,5091.422643
揭阳(1948),揭阳,notion,0,1,1,0,1,1,0.009751,4,0.267186,0.282133,0
揭露(1948),揭露,notion,0,2,2,0,3,3,0.026257,4,0.292073,0.322053,1522.40889
援助(1948),援助,notion,0,4,4,0,5,5,0.052764,4,0.333274,0.375072,10282.282394
援华是(1948),援华是,notion,0,1,1,0,1,1,0.01424,4,0.275514,0.296275,0
援外(1948),援外,notion,0,1,1,0,1,1,0.01424,4,0.275514,0.296275,0
援手(1948),援手,notion,0,1,1,0,1,1,0.009739,4,0.265806,0.279704,0
援救(1948),援救,notion,0,2,2,0,2,2,0.015238,4,0.27323,0.292537,773.838752
援欧(1948),援欧,notion,0,1,1,0,1,1,0.009739,4,0.265806,0.279704,0
援蒋(1948),援蒋,notion,0,3,3,0,5,5,0.031287,4,0.299001,0.332024,3863.30515
搁浅(1948),搁浅,notion,0,1,1,0,1,1,0.01424,4,0.275514,0.296275,0
搜刮(1948),搜刮,notion,0,1,1,0,1,1,0.016518,4,0.278724,0.3015,0
搜捕(1948),搜捕,notion,0,1,1,0,1,1,0.01022,4,0.267243,0.282233,0
搞清(1948),搞清,notion,0,1,1,0,4,4,0.009751,4,0.267186,0.282133,0
搞通(1948),搞通,notion,0,1,1,0,1,1,0.016752,4,0.279138,0.302165,0
搢绅(1948),搢绅,notion,0,1,1,0,1,1,0.01022,4,0.267243,0.282233,0
摆夷(1948),摆夷,notion,0,1,1,0,1,1,0.01424,4,0.275514,0.296275,0
摆战(1948),摆战,notion,0,1,1,0,1,1,0.016518,4,0.278724,0.3015,0
摊出来(1948),摊出来,notion,0,1,1,0,1,1,0.016752,4,0.279138,0.302165,0
摊牌(1948),摊牌,notion,0,1,1,0,1,1,0.016752,4,0.279138,0.302165,0
摘录(1948),摘录,notion,0,1,1,0,1,1,0.009755,4,0.266617,0.281135,0
摘要(1948),摘要,notion,0,1,1,0,1,1,0.009755,4,0.266617,0.281135,0
摧残(1948),摧残,notion,0,3,3,0,3,3,0.04208,4,0.32089,0.360542,6900.033893
摩尔(1948),摩尔,notion,0,2,2,0,2,2,0.019494,4,0.280535,0.30445,1251.270065
摸索(1948),摸索,notion,0,1,1,0,1,1,0.004718,4,0.258401,0.266227,0
撑住(1948),撑住,notion,0,1,1,0,1,1,0.011322,4,0.269061,0.285394,0
撑腰(1948),撑腰,notion,0,1,1,0,1,1,0.009751,4,0.267186,0.282133,0
撒谎(1948),撒谎,notion,0,1,1,0,1,1,0.016518,4,0.278724,0.3015,0
撞骗(1948),撞骗,notion,0,1,1,0,1,1,0.016518,4,0.278724,0.3015,0
撤侨(1948),撤侨,notion,0,1,1,0,1,1,0.008247,4,0.26379,0.27611,0
撤兵(1948),撤兵,notion,0,1,1,0,1,1,0.016752,4,0.279138,0.302165,0
撤守(1948),撤守,notion,0,1,1,0,1,1,0.016752,4,0.279138,0.302165,0
播种(1948),播种,notion,0,1,1,0,2,2,0.004718,4,0.258401,0.266227,0
播种者(1948),播种者,notion,0,1,1,0,1,1,0.009755,4,0.266617,0.281135,0
撰文(1948),撰文,notion,0,2,2,0,2,2,0.030992,4,0.303936,0.338757,2912.385696
撲朔(1948),撲朔,notion,0,1,1,0,1,1,0.011322,4,0.269061,0.285394,0
撲灭(1948),撲灭,notion,0,3,3,0,3,3,0.035775,4,0.308859,0.345368,5091.422643
攫取(1948),攫取,notion,0,1,1,0,1,1,0.016518,4,0.278724,0.3015,0
支加哥(1948),支加哥,notion,0,1,1,0,1,1,0.016752,4,0.279138,0.302165,0
支持(1948),支持,notion,0,5,5,0,6,6,0.062515,4,0.350763,0.393828,18436.260609
支票(1948),支票,notion,0,1,1,0,1,1,0.016518,4,0.278724,0.3015,0
支部(1948),支部,notion,0,1,1,0,1,1,0.009739,4,0.265806,0.279704,0
收入(1948),收入,notion,0,1,1,0,2,2,0.009755,4,0.266617,0.281135,0
收回(1948),收回,notion,0,2,2,0,3,3,0.017736,4,0.278993,0.301988,1631.559673
收归国有(1948),收归国有,notion,0,1,1,0,1,1,0.008247,4,0.26379,0.27611,0
收益(1948),收益,notion,0,1,1,0,1,1,0.011322,4,0.269061,0.285394,0
收获(1948),收获,notion,0,1,1,0,1,1,0.009755,4,0.266617,0.281135,0
收获量(1948),收获量,notion,0,1,1,0,1,1,0.004718,4,0.258401,0.266227,0
收购(1948),收购,notion,0,2,2,0,2,2,0.030758,4,0.303347,0.337959,2812.221703
收音机(1948),收音机,notion,0,1,1,0,1,1,0.016518,4,0.278724,0.3015,0
改修(1948),改修,notion,0,1,1,0,1,1,0.008247,4,0.26379,0.27611,0
改名(1948),改名,notion,0,1,1,0,1,1,0.01424,4,0.275514,0.296275,0
改善(1948),改善,notion,0,3,3,0,4,4,0.025517,4,0.290717,0.320112,4624.240561
改善生活(1948),改善生活,notion,0,2,2,0,2,2,0.023995,4,0.291507,0.321221,2493.732085
改币(1948),改币,notion,0,3,3,0,4,4,0.041213,4,0.319634,0.359011,6966.552281
改币案(1948),改币案,notion,0,2,2,0,2,2,0.008698,4,0.258507,0.266483,0.569098
改组(1948),改组,notion,0,1,1,0,1,1,0.005389,4,0.25849,0.266394,0
改良主义(1948),改良主义,notion,0,1,1,0,1,1,0.016752,4,0.279138,0.302165,0
改进(1948),改进,notion,0,4,4,0,5,5,0.033294,4,0.302687,0.337171,9677.817837
改选(1948),改选,notion,0,1,1,0,2,2,0.009739,4,0.265806,0.279704,0
攻击(1948),攻击,notion,0,2,2,0,2,2,0.028074,4,0.296149,0.327943,1864.79583
攻打(1948),攻打,notion,0,1,1,0,1,1,0.009751,4,0.267186,0.282133,0
放弃(1948),放弃,notion,0,3,3,0,4,4,0.036381,4,0.311316,0.348562,5697.0583
放心(1948),放心,notion,0,1,1,0,1,1,0.016518,4,0.278724,0.3015,0
放款(1948),放款,notion,0,1,1,0,1,1,0.008247,4,0.26379,0.27611,0
放眼(1948),放眼,notion,0,1,1,0,1,1,0.009755,4,0.266617,0.281135,0
放结(1948),放结,notion,0,1,1,0,1,1,0.004718,4,0.258401,0.266227,0
政党(1948),政党,notion,0,6,6,0,7,7,0.060581,4,0.351551,0.394683,25579.661639
政党政治(1948),政党政治,notion,0,1,1,0,1,1,0.01424,4,0.275514,0.296275,0
政函(1948),政函,notion,0,1,1,0,1,1,0.016752,4,0.279138,0.302165,0
政务官(1948),政务官,notion,0,1,1,0,1,1,0.01424,4,0.275514,0.296275,0
政协(1948),政协,notion,0,1,1,0,1,1,0.016518,4,0.278724,0.3015,0
政变(1948),政变,notion,0,3,3,0,3,3,0.041517,4,0.318712,0.35788,6324.925358
政团(1948),政团,notion,0,2,2,0,2,2,0.026491,4,0.291937,0.321853,1403.825067
政情(1948),政情,notion,0,1,1,0,1,1,0.009739,4,0.265806,0.279704,0
政治势力(1948),政治势力,notion,0,1,1,0,1,1,0.002332,4,0.253398,0.256677,0
政治协商会议(1948),政治协商会议,notion,0,1,1,0,1,1,0.01424,4,0.275514,0.296275,0
政治局(1948),政治局,notion,0,2,2,0,2,2,0.01727,4,0.278352,0.300956,1619.09855
政治形势(1948),政治形势,notion,0,1,1,0,1,1,0.016752,4,0.279138,0.302165,0
政治思潮(1948),政治思潮,notion,0,2,2,0,2,2,0.012072,4,0.268484,0.284451,677.642529
政治权利(1948),政治权利,notion,0,1,1,0,1,1,0.008247,4,0.26379,0.27611,0
政治犯(1948),政治犯,notion,0,1,1,0,1,1,0.016752,4,0.279138,0.302165,0
政治经济(1948),政治经济,notion,0,2,2,0,2,2,0.017736,4,0.278993,0.301988,1631.559673
政治路线(1948),政治路线,notion,0,3,3,0,3,3,0.0266,4,0.293672,0.324438,4051.261531
政海(1948),政海,notion,0,1,1,0,1,1,0.008247,4,0.26379,0.27611,0
政潮(1948),政潮,notion,0,2,2,0,3,3,0.015238,4,0.27323,0.292537,773.838752
政见(1948),政见,notion,0,1,1,0,1,1,0.01424,4,0.275514,0.296275,0
政论家(1948),政论家,notion,0,1,1,0,1,1,0.01424,4,0.275514,0.296275,0
故国风光(1948),故国风光,notion,0,1,1,0,1,1,0.011322,4,0.269061,0.285394,0
效忠(1948),效忠,notion,0,1,1,0,1,1,0.008247,4,0.26379,0.27611,0
效率(1948),效率,notion,0,1,1,0,2,2,0.008247,4,0.26379,0.27611,0
效缪(1948),效缪,notion,0,1,1,0,1,1,0.005389,4,0.25849,0.266394,0
敌情(1948),敌情,notion,0,1,1,0,1,1,0.016518,4,0.278724,0.3015,0
敌视(1948),敌视,notion,0,1,1,0,1,1,0.01424,4,0.275514,0.296275,0
敎育部(1948),敎育部,notion,0,1,1,0,1,1,0.011322,4,0.269061,0.285394,0
救助(1948),救助,notion,0,1,1,0,1,1,0.01424,4,0.275514,0.296275,0
救国(1948),救国,notion,0,3,3,0,3,3,0.038287,4,0.310827,0.34793,4250.67334
救堤(1948),救堤,notion,0,1,1,0,1,1,0.009751,4,0.267186,0.282133,0
救护(1948),救护,notion,0,1,1,0,1,1,0.005017,4,0.257497,0.26453,0
救放区(1948),救放区,notion,0,1,1,0,1,1,0.009751,4,0.267186,0.282133,0
救星(1948),救星,notion,0,1,1,0,1,1,0.009751,4,0.267186,0.282133,0
救荒(1948),救荒,notion,0,1,1,0,1,1,0.009751,4,0.267186,0.282133,0
教会(1948),教会,notion,0,1,1,0,1,1,0.009739,4,0.265806,0.279704,0
教会学校(1948),教会学校,notion,0,1,1,0,1,1,0.01424,4,0.275514,0.296275,0
教子(1948),教子,notion,0,1,1,0,1,1,0.01022,4,0.267243,0.282233,0
教师(1948),教师,notion,0,7,7,0,16,16,0.071679,4,0.359904,0.40299,26644.117418
教师节(1948),教师节,notion,0,2,2,0,4,4,0.026972,4,0.293947,0.324781,1749.441854
教授(1948),教授,notion,0,10,10,0,15,15,0.102262,4,0.416764,0.450541,58852.934975
教程(1948),教程,notion,0,2,2,0,2,2,0.026272,4,0.29319,0.323683,1793.896368
教育工作者(1948),教育工作者,notion,0,1,1,0,1,1,0.016752,4,0.279138,0.302165,0
教育界(1948),教育界,notion,0,1,1,0,1,1,0.016752,4,0.279138,0.302165,0
教育社(1948),教育社,notion,0,1,1,0,1,1,0.016518,4,0.278724,0.3015,0
教衣(1948),教衣,notion,0,1,1,0,1,1,0.016518,4,0.278724,0.3015,0
教训(1948),教训,notion,0,2,2,0,3,3,0.024999,4,0.291484,0.321188,1929.694181
教部(1948),教部,notion,0,1,1,0,1,1,0.01022,4,0.267243,0.282233,0
散文(1948),散文,notion,0,2,2,0,2,2,0.008698,4,0.258507,0.266483,0.569098
敦煌(1948),敦煌,notion,0,1,1,0,1,1,0.011322,4,0.269061,0.285394,0
敬佩(1948),敬佩,notion,0,1,1,0,1,1,0.016518,4,0.278724,0.3015,0
敬告(1948),敬告,notion,0,1,1,0,1,1,0.016752,4,0.279138,0.302165,0
敬啓者(1948),敬啓者,notion,0,2,2,0,2,2,0.025562,4,0.293259,0.323783,2167.4723
敬悉(1948),敬悉,notion,0,1,1,0,1,1,0.011322,4,0.269061,0.285394,0
敬悼(1948),敬悼,notion,0,3,3,0,3,3,0.038294,4,0.310776,0.347864,5024.657132
数字(1948),数字,notion,0,3,3,0,3,3,0.029324,4,0.296125,0.327965,4585.929671
敲榨(1948),敲榨,notion,0,1,1,0,1,1,0.016518,4,0.278724,0.3015,0
敲起(1948),敲起,notion,0,1,1,0,1,1,0.009755,4,0.266617,0.281135,0
整个(1948),整个,notion,0,2,2,0,2,2,0.023992,4,0.29271,0.322985,3168.205568
整党(1948),整党,notion,0,1,1,0,1,1,0.016518,4,0.278724,0.3015,0
整党工作(1948),整党工作,notion,0,2,2,0,3,3,0.026269,4,0.293695,0.324415,1931.353166
整军(1948),整军,notion,0,2,2,0,4,4,0.021073,4,0.285785,0.312636,2242.44705
整套(1948),整套,notion,0,1,1,0,1,1,0.01022,4,0.267243,0.282233,0
整肃(1948),整肃,notion,0,3,3,0,3,3,0.032242,4,0.304158,0.339112,6253.390047
整补(1948),整补,notion,0,1,1,0,1,1,0.016752,4,0.279138,0.302165,0
整顿(1948),整顿,notion,0,4,4,0,4,4,0.05073,4,0.336529,0.378699,14453.382349
整风运动(1948),整风运动,notion,0,1,1,0,1,1,0.009751,4,0.267186,0.282133,0
整饬(1948),整饬,notion,0,1,1,0,1,1,0.01424,4,0.275514,0.296275,0
文书(1948),文书,notion,0,1,1,0,1,1,0.01424,4,0.275514,0.296275,0
文人(1948),文人,notion,0,1,1,0,1,1,0.008247,4,0.26379,0.27611,0
文其人(1948),文其人,notion,0,1,1,0,1,1,0.016752,4,0.279138,0.302165,0
文史(1948),文史,notion,0,1,1,0,1,1,0.011322,4,0.269061,0.285394,0
文告(1948),文告,notion,0,3,3,0,5,5,0.034751,4,0.30858,0.345002,6495.94151
文坛(1948),文坛,notion,0,2,2,0,2,2,0.019494,4,0.280535,0.30445,1251.270065
文字(1948),文字,notion,0,2,2,0,3,3,0.025562,4,0.293259,0.323783,2167.4723
文字改革(1948),文字改革,notion,0,1,1,0,2,2,0.011322,4,0.269061,0.285394,0
文学艺术(1948),文学艺术,notion,0,1,1,0,1,1,0.002332,4,0.253398,0.256677,0
文成(1948),文成,notion,0,1,1,0,1,1,0.008247,4,0.26379,0.27611,0
文才(1948),文才,notion,0,1,1,0,1,1,0.009755,4,0.266617,0.281135,0
文明(1948),文明,notion,0,4,4,0,5,5,0.052534,4,0.337133,0.379365,12409.239858
文汇(1948),文汇,notion,0,1,1,0,1,1,0.016752,4,0.279138,0.302165,0
文汇报(1948),文汇报,notion,0,3,3,0,3,3,0.041213,4,0.319634,0.359011,6966.552281
文物(1948),文物,notion,0,3,3,0,3,3,0.02545,4,0.285981,0.312991,1629.880666
文理(1948),文理,notion,0,1,1,0,1,1,0.01424,4,0.275514,0.296275,0
文盲(1948),文盲,notion,0,1,1,0,1,1,0.004718,4,0.258401,0.266227,0
文章(1948),文章,notion,0,3,3,0,3,3,0.032242,4,0.304158,0.339112,6253.390047
文箱(1948),文箱,notion,0,1,1,0,1,1,0.004718,4,0.258401,0.266227,0
文艺创作(1948),文艺创作,notion,0,1,1,0,1,1,0.009751,4,0.267186,0.282133,0
文艺复兴(1948),文艺复兴,notion,0,1,1,0,1,1,0.01424,4,0.275514,0.296275,0
文艺工作者(1948),文艺工作者,notion,0,1,1,0,1,1,0.009751,4,0.267186,0.282133,0
文艺批评(1948),文艺批评,notion,0,3,3,0,3,3,0.031896,4,0.301255,0.335152,4325.738724
文艺界(1948),文艺界,notion,0,1,1,0,1,1,0.009739,4,0.265806,0.279704,0
文言(1948),文言,notion,0,1,1,0,1,1,0.01424,4,0.275514,0.296275,0
文言文(1948),文言文,notion,0,1,1,0,1,1,0.011322,4,0.269061,0.285394,0
文过饰非(1948),文过饰非,notion,0,1,1,0,1,1,0.008247,4,0.26379,0.27611,0
文院(1948),文院,notion,0,1,1,0,1,1,0.011322,4,0.269061,0.285394,0
斑鸠(1948),斑鸠,notion,0,1,1,0,1,1,0.008247,4,0.26379,0.27611,0
斗转星移(1948),斗转星移,notion,0,1,1,0,1,1,0.016752,4,0.279138,0.302165,0
斥美(1948),斥美,notion,0,1,1,0,1,1,0.016752,4,0.279138,0.302165,0
斥责(1948),斥责,notion,0,1,1,0,1,1,0.009739,4,0.265806,0.279704,0
斥非(1948),斥非,notion,0,1,1,0,1,1,0.016752,4,0.279138,0.302165,0
断想(1948),断想,notion,0,2,2,0,2,2,0.021073,4,0.285785,0.312636,2242.44705
斯大林(1948),斯大林,notion,0,1,1,0,1,1,0.002332,4,0.253398,0.256677,0
斯特(1948),斯特,notion,0,1,1,0,1,1,0.016752,4,0.279138,0.302165,0
斯达哈(1948),斯达哈,notion,0,1,1,0,1,1,0.009755,4,0.266617,0.281135,0
新事象(1948),新事象,notion,0,1,1,0,1,1,0.016518,4,0.278724,0.3015,0
新任(1948),新任,notion,0,1,1,0,1,1,0.009739,4,0.265806,0.279704,0
新党(1948),新党,notion,0,1,1,0,1,1,0.016752,4,0.279138,0.302165,0
新兵(1948),新兵,notion,0,1,1,0,1,1,0.016752,4,0.279138,0.302165,0
新刀(1948),新刀,notion,0,1,1,0,1,1,0.016518,4,0.278724,0.3015,0
新加坡(1948),新加坡,notion,0,1,1,0,1,1,0.009739,4,0.265806,0.279704,0
新动向(1948),新动向,notion,0,3,3,0,4,4,0.038287,4,0.310827,0.34793,4250.67334
新化(1948),新化,notion,0,1,1,0,1,1,0.01424,4,0.275514,0.296275,0
新区(1948),新区,notion,0,1,1,0,1,1,0.009751,4,0.267186,0.282133,0
新型(1948),新型,notion,0,1,1,0,1,1,0.004718,4,0.258401,0.266227,0
新天地(1948),新天地,notion,0,1,1,0,1,1,0.002332,4,0.253398,0.256677,0
新居(1948),新居,notion,0,1,1,0,1,1,0.005389,4,0.25849,0.266394,0
新展(1948),新展,notion,0,1,1,0,1,1,0.004718,4,0.258401,0.266227,0
新岁(1948),新岁,notion,0,1,1,0,1,1,0.01022,4,0.267243,0.282233,0
新币(1948),新币,notion,0,2,2,0,2,2,0.033269,4,0.305692,0.34112,2297.98609
新年(1948),新年,notion,0,5,5,0,11,11,0.054966,4,0.343357,0.386142,22419.270344
新店(1948),新店,notion,0,1,1,0,1,1,0.004718,4,0.258401,0.266227,0
新式(1948),新式,notion,0,1,1,0,1,1,0.016518,4,0.278724,0.3015,0
新形势下(1948),新形势下,notion,0,1,1,0,1,1,0.016518,4,0.278724,0.3015,0
新报(1948),新报,notion,0,1,1,0,2,2,0.011322,4,0.269061,0.285394,0
新攻势(1948),新攻势,notion,0,2,2,0,2,2,0.026257,4,0.292073,0.322053,1522.40889
新政府(1948),新政府,notion,0,1,1,0,1,1,0.002332,4,0.253398,0.256677,0
新文化运动(1948),新文化运动,notion,0,1,1,0,1,1,0.005389,4,0.25849,0.266394,0
新旧(1948),新旧,notion,0,1,1,0,1,1,0.01022,4,0.267243,0.282233,0
新春(1948),新春,notion,0,2,2,0,3,3,0.019491,4,0.281819,0.30648,1649.883746
新民(1948),新民,notion,0,3,3,0,7,7,0.04751,4,0.331714,0.373253,8022.59349
新气象(1948),新气象,notion,0,1,1,0,1,1,0.016752,4,0.279138,0.302165,0
新法(1948),新法,notion,0,1,1,0,1,1,0.009755,4,0.266617,0.281135,0
新浪潮(1948),新浪潮,notion,0,1,1,0,1,1,0.005017,4,0.257497,0.26453,0
新点(1948),新点,notion,0,1,1,0,1,1,0.009751,4,0.267186,0.282133,0
新生(1948),新生,notion,0,4,4,0,6,6,0.048042,4,0.325478,0.366088,8829.038991
新疆(1948),新疆,notion,0,1,1,0,1,1,0.016752,4,0.279138,0.302165,0
新着(1948),新着,notion,0,1,1,0,1,1,0.011322,4,0.269061,0.285394,0
新腔(1948),新腔,notion,0,1,1,0,1,1,0.009755,4,0.266617,0.281135,0
新舞(1948),新舞,notion,0,1,1,0,1,1,0.009751,4,0.267186,0.282133,0
新花样(1948),新花样,notion,0,2,2,0,2,2,0.033269,4,0.305692,0.34112,2297.98609
新苗(1948),新苗,notion,0,1,1,0,1,1,0.004718,4,0.258401,0.266227,0
新诡术(1948),新诡术,notion,0,1,1,0,1,1,0.009755,4,0.266617,0.281135,0
新谈序(1948),新谈序,notion,0,2,2,0,2,2,0.008698,4,0.258507,0.266483,0.569098
新路(1948),新路,notion,0,5,5,0,5,5,0.052474,4,0.33236,0.374096,15850.736775
新近(1948),新近,notion,0,1,1,0,1,1,0.01022,4,0.267243,0.282233,0
新钞(1948),新钞,notion,0,1,1,0,1,1,0.008247,4,0.26379,0.27611,0
新闻(1948),新闻,notion,0,4,4,0,5,5,0.05773,4,0.348389,0.391344,14070.628341
新闻片(1948),新闻片,notion,0,1,1,0,1,1,0.016518,4,0.278724,0.3015,0
新闻界(1948),新闻界,notion,0,1,1,0,1,1,0.01424,4,0.275514,0.296275,0
新闻社(1948),新闻社,notion,0,1,1,0,1,1,0.016752,4,0.279138,0.302165,0
新闻纸(1948),新闻纸,notion,0,1,1,0,1,1,0.01022,4,0.267243,0.282233,0
新闻自由(1948),新闻自由,notion,0,3,3,0,3,3,0.032242,4,0.304158,0.339112,6253.390047
新阁(1948),新阁,notion,0,2,2,0,2,2,0.024765,4,0.291552,0.321288,2097.245087
新面貌(1948),新面貌,notion,0,1,1,0,1,1,0.009755,4,0.266617,0.281135,0
新页(1948),新页,notion,0,1,1,0,1,1,0.01424,4,0.275514,0.296275,0
新风暴(1948),新风暴,notion,0,2,2,0,2,2,0.026491,4,0.291937,0.321853,1403.825067
新高潮(1948),新高潮,notion,0,1,1,0,1,1,0.009751,4,0.267186,0.282133,0
方向(1948),方向,notion,0,7,7,0,7,7,0.078706,4,0.386451,0.426849,41471.556676
方式(1948),方式,notion,0,4,4,0,5,5,0.04593,4,0.328753,0.369914,14775.156722
方案(1948),方案,notion,0,5,5,0,5,5,0.052572,4,0.335387,0.37749,17454.453265
方生(1948),方生,notion,0,1,1,0,1,1,0.008247,4,0.26379,0.27611,0
方由(1948),方由,notion,0,1,1,0,1,1,0.007515,4,0.262793,0.274313,0
方策(1948),方策,notion,0,1,1,0,1,1,0.01424,4,0.275514,0.296275,0
方针(1948),方针,notion,0,5,5,0,6,6,0.061477,4,0.348583,0.391599,17263.879266
方面(1948),方面,notion,0,1,1,0,1,1,0.016752,4,0.279138,0.302165,0
於和林(1948),於和林,notion,0,1,1,0,1,1,0.01424,4,0.275514,0.296275,0
施与(1948),施与,notion,0,1,1,0,1,1,0.008247,4,0.26379,0.27611,0
施复亮(1948),施复亮,notion,0,3,3,0,3,3,0.02656,4,0.289932,0.318947,3061.154482
施家(1948),施家,notion,0,1,1,0,1,1,0.004718,4,0.258401,0.266227,0
施惠(1948),施惠,notion,0,1,1,0,1,1,0.008247,4,0.26379,0.27611,0
施政(1948),施政,notion,0,1,1,0,1,1,0.008247,4,0.26379,0.27611,0
施政纲领(1948),施政纲领,notion,0,1,1,0,1,1,0.005017,4,0.257497,0.26453,0
施诊(1948),施诊,notion,0,1,1,0,1,1,0.004718,4,0.258401,0.266227,0
旁听(1948),旁听,notion,0,1,1,0,2,2,0.011322,4,0.269061,0.285394,0
旅客(1948),旅客,notion,0,1,1,0,1,1,0.01424,4,0.275514,0.296275,0
旅杭(1948),旅杭,notion,0,1,1,0,1,1,0.009739,4,0.265806,0.279704,0
旅法(1948),旅法,notion,0,1,1,0,1,1,0.009739,4,0.265806,0.279704,0
旅港(1948),旅港,notion,0,2,2,0,2,2,0.030992,4,0.303936,0.338757,2912.385696
旅美(1948),旅美,notion,0,2,2,0,2,2,0.021769,4,0.284983,0.311405,1063.457371
旅苏(1948),旅苏,notion,0,1,1,0,1,1,0.01424,4,0.275514,0.296275,0
旅英(1948),旅英,notion,0,1,1,0,1,1,0.005017,4,0.257497,0.26453,0
旅行(1948),旅行,notion,0,4,4,0,5,5,0.048262,4,0.332154,0.373808,13262.507292
旅行家(1948),旅行家,notion,0,1,1,0,1,1,0.011322,4,0.269061,0.285394,0
旅行者(1948),旅行者,notion,0,1,1,0,1,1,0.011322,4,0.269061,0.285394,0
旋风(1948),旋风,notion,0,1,1,0,1,1,0.01022,4,0.267243,0.282233,0
旗帜(1948),旗帜,notion,0,2,2,0,3,3,0.021235,4,0.286701,0.314033,2523.953101
旗开得胜(1948),旗开得胜,notion,0,1,1,0,1,1,0.016518,4,0.278724,0.3015,0
无不(1948),无不,notion,0,1,1,0,1,1,0.016752,4,0.279138,0.302165,0
无为(1948),无为,notion,0,1,1,0,1,1,0.016752,4,0.279138,0.302165,0
无产阶级(1948),无产阶级,notion,0,3,3,0,3,3,0.036024,4,0.308631,0.345069,5629.029515
无以(1948),无以,notion,0,1,1,0,1,1,0.011322,4,0.269061,0.285394,0
无名英雄(1948),无名英雄,notion,0,1,1,0,1,1,0.016752,4,0.279138,0.302165,0
无尽(1948),无尽,notion,0,1,1,0,1,1,0.009739,4,0.265806,0.279704,0
无恶不作(1948),无恶不作,notion,0,1,1,0,1,1,0.01424,4,0.275514,0.296275,0
无效(1948),无效,notion,0,1,1,0,1,1,0.01424,4,0.275514,0.296275,0
无独有偶(1948),无独有偶,notion,0,1,1,0,1,1,0.011322,4,0.269061,0.285394,0
无用(1948),无用,notion,0,1,1,0,1,1,0.016518,4,0.278724,0.3015,0
无病(1948),无病,notion,0,1,1,0,1,1,0.011322,4,0.269061,0.285394,0
无耻(1948),无耻,notion,0,4,4,0,5,5,0.057264,4,0.347744,0.390678,14323.117856
无能(1948),无能,notion,0,1,1,0,1,1,0.01424,4,0.275514,0.296275,0
无话可说(1948),无话可说,notion,0,1,1,0,1,1,0.016752,4,0.279138,0.302165,0
无锡(1948),无锡,notion,0,4,4,0,4,4,0.048207,4,0.330053,0.371412,13260.294943
无门(1948),无门,notion,0,1,1,0,1,1,0.009751,4,0.267186,0.282133,0
无限(1948),无限,notion,0,1,1,0,1,1,0.016518,4,0.278724,0.3015,0
既得(1948),既得,notion,0,1,1,0,1,1,0.01424,4,0.275514,0.296275,0
既得利益(1948),既得利益,notion,0,1,1,0,1,1,0.008247,4,0.26379,0.27611,0
日丹诺(1948),日丹诺,notion,0,1,1,0,1,1,0.016518,4,0.278724,0.3015,0
日共(1948),日共,notion,0,1,1,0,1,1,0.016518,4,0.278724,0.3015,0
日关(1948),日关,notion,0,1,1,0,1,1,0.008247,4,0.26379,0.27611,0
日兴(1948),日兴,notion,0,1,1,0,1,1,0.016752,4,0.279138,0.302165,0
日内瓦湖(1948),日内瓦湖,notion,0,1,1,0,1,1,0.008247,4,0.26379,0.27611,0
日前(1948),日前,notion,0,2,2,0,2,2,0.030758,4,0.303347,0.337959,2812.221703
日急(1948),日急,notion,0,1,1,0,1,1,0.01022,4,0.267243,0.282233,0
日报(1948),日报,notion,0,3,3,0,3,3,0.035589,4,0.307897,0.344104,5512.554671
日新月异(1948),日新月异,notion,0,1,1,0,1,1,0.01022,4,0.267243,0.282233,0
日月(1948),日月,notion,0,1,1,0,1,1,0.004718,4,0.258401,0.266227,0
日月食(1948),日月食,notion,0,1,1,0,1,1,0.011322,4,0.269061,0.285394,0
日本共产党(1948),日本共产党,notion,0,1,1,0,1,1,0.016518,4,0.278724,0.3015,0
日益(1948),日益,notion,0,1,1,0,1,1,0.01022,4,0.267243,0.282233,0
日睹(1948),日睹,notion,0,1,1,0,1,1,0.01022,4,0.267243,0.282233,0
日繁(1948),日繁,notion,0,1,1,0,1,1,0.011322,4,0.269061,0.285394,0
日衣(1948),日衣,notion,0,1,1,0,1,1,0.01424,4,0.275514,0.296275,0
日记(1948),日记,notion,0,2,2,0,2,2,0.010407,4,0.265318,0.278894,584.590627
日货(1948),日货,notion,0,4,4,0,4,4,0.048507,4,0.326411,0.367186,8767.822213
日趋严重(1948),日趋严重,notion,0,1,1,0,1,1,0.016752,4,0.279138,0.302165,0
日边(1948),日边,notion,0,2,2,0,2,2,0.008698,4,0.258507,0.266483,0.569098
旧事(1948),旧事,notion,0,1,1,0,1,1,0.016752,4,0.279138,0.302165,0
旧寨(1948),旧寨,notion,0,1,1,0,1,1,0.009751,4,0.267186,0.282133,0
旧年(1948),旧年,notion,0,1,1,0,1,1,0.009751,4,0.267186,0.282133,0
旧式(1948),旧式,notion,0,1,1,0,1,1,0.004718,4,0.258401,0.266227,0
旧戏(1948),旧戏,notion,0,2,2,0,2,2,0.008698,4,0.258507,0.266483,0.569098
旧话重提(1948),旧话重提,notion,0,1,1,0,1,1,0.008247,4,0.26379,0.27611,0
旧调(1948),旧调,notion,0,1,1,0,1,1,0.008247,4,0.26379,0.27611,0
旧路(1948),旧路,notion,0,1,1,0,1,1,0.009755,4,0.266617,0.281135,0
旧都(1948),旧都,notion,0,1,1,0,1,1,0.01424,4,0.275514,0.296275,0
旧金山(1948),旧金山,notion,0,1,1,0,1,1,0.005017,4,0.257497,0.26453,0
早已(1948),早已,notion,0,1,1,0,1,1,0.016518,4,0.278724,0.3015,0
早操(1948),早操,notion,0,1,1,0,1,1,0.009751,4,0.267186,0.282133,0
早期(1948),早期,notion,0,1,1,0,1,1,0.016752,4,0.279138,0.302165,0
时代背景(1948),时代背景,notion,0,1,1,0,1,1,0.011322,4,0.269061,0.285394,0
时候(1948),时候,notion,0,4,4,0,5,5,0.05276,4,0.3347,0.376669,11474.418281
时地(1948),时地,notion,0,1,1,0,1,1,0.016518,4,0.278724,0.3015,0
时期(1948),时期,notion,0,2,2,0,2,2,0.028074,4,0.296149,0.327943,1864.79583
时机(1948),时机,notion,0,1,1,0,1,1,0.016752,4,0.279138,0.302165,0
时节(1948),时节,notion,0,2,2,0,2,2,0.026972,4,0.293947,0.324781,1749.441854
时间(1948),时间,notion,0,2,2,0,2,2,0.014938,4,0.275333,0.296031,2167.523118
昂扬(1948),昂扬,notion,0,1,1,0,1,1,0.009755,4,0.266617,0.281135,0
昆明(1948),昆明,notion,0,5,5,0,7,7,0.056755,4,0.340371,0.382947,15368.961812
明亡(1948),明亡,notion,0,1,1,0,1,1,0.007515,4,0.262793,0.274313,0
明亮(1948),明亮,notion,0,1,1,0,1,1,0.016518,4,0.278724,0.3015,0
明代(1948),明代,notion,0,2,2,0,2,2,0.021756,4,0.286964,0.314433,2044.761444
明初(1948),明初,notion,0,1,1,0,1,1,0.005389,4,0.25849,0.266394,0
明季(1948),明季,notion,0,1,1,0,1,1,0.007515,4,0.262793,0.274313,0
明尼苏(1948),明尼苏,notion,0,1,1,0,1,1,0.016752,4,0.279138,0.302165,0
明星(1948),明星,notion,0,1,1,0,2,2,0.01424,4,0.275514,0.296275,0
明暗(1948),明暗,notion,0,1,1,0,1,1,0.016518,4,0.278724,0.3015,0
明理(1948),明理,notion,0,1,1,0,1,1,0.016752,4,0.279138,0.302165,0
明白(1948),明白,notion,0,1,1,0,1,1,0.011322,4,0.269061,0.285394,0
易手(1948),易手,notion,0,1,1,0,1,1,0.011322,4,0.269061,0.285394,0
易货(1948),易货,notion,0,1,1,0,1,1,0.004718,4,0.258401,0.266227,0
易长(1948),易长,notion,0,1,1,0,1,1,0.005017,4,0.257497,0.26453,0
星加坡(1948),星加坡,notion,0,1,1,0,1,1,0.008247,4,0.26379,0.27611,0
星夜(1948),星夜,notion,0,1,1,0,1,1,0.004718,4,0.258401,0.266227,0
星期(1948),星期,notion,0,1,1,0,1,1,0.007515,4,0.262793,0.274313,0
星洲(1948),星洲,notion,0,2,2,0,2,2,0.017987,4,0.278331,0.300923,1351.046959
星相(1948),星相,notion,0,1,1,0,1,1,0.01424,4,0.275514,0.296275,0
春云乍展(1948),春云乍展,notion,0,1,1,0,1,1,0.009739,4,0.265806,0.279704,0
春天(1948),春天,notion,0,3,3,0,6,6,0.036258,4,0.311059,0.34823,6585.637217
春季(1948),春季,notion,0,3,3,0,3,3,0.036478,4,0.30767,0.343804,4821.551069
春战(1948),春战,notion,0,1,1,0,1,1,0.016518,4,0.278724,0.3015,0
春暖花开(1948),春暖花开,notion,0,1,1,0,1,1,0.009739,4,0.265806,0.279704,0
春游(1948),春游,notion,0,1,1,0,1,1,0.01424,4,0.275514,0.296275,0
春秋(1948),春秋,notion,0,1,1,0,1,1,0.009739,4,0.265806,0.279704,0
春耕(1948),春耕,notion,0,2,2,0,2,2,0.026269,4,0.293695,0.324415,1931.353166
春节(1948),春节,notion,0,2,2,0,3,3,0.023992,4,0.29271,0.322985,3168.205568
春雷(1948),春雷,notion,0,1,1,0,2,2,0.009739,4,0.265806,0.279704,0
春风(1948),春风,notion,0,1,1,0,1,1,0.009751,4,0.267186,0.282133,0
昨天(1948),昨天,notion,0,2,2,0,2,2,0.008698,4,0.258507,0.266483,0.569098
昭雪(1948),昭雪,notion,0,1,1,0,1,1,0.01424,4,0.275514,0.296275,0
是什(1948),是什,notion,0,2,2,0,2,2,0.030758,4,0.303347,0.337959,2812.221703
是化(1948),是化,notion,0,1,1,0,1,1,0.01424,4,0.275514,0.296275,0
是是非非(1948),是是非非,notion,0,1,1,0,1,1,0.009739,4,0.265806,0.279704,0
显威(1948),显威,notion,0,1,1,0,1,1,0.009751,4,0.267186,0.282133,0
显明(1948),显明,notion,0,1,1,0,1,1,0.016752,4,0.279138,0.302165,0
显然(1948),显然,notion,0,1,1,0,1,1,0.01424,4,0.275514,0.296275,0
晋京(1948),晋京,notion,0,1,1,0,1,1,0.009739,4,0.265806,0.279704,0
晋冀鲁豫(1948),晋冀鲁豫,notion,0,1,1,0,1,1,0.016518,4,0.278724,0.3015,0
晋南(1948),晋南,notion,0,2,2,0,2,2,0.027839,4,0.295962,0.327676,1920.33989
晋察冀边区(1948),晋察冀边区,notion,0,1,1,0,1,1,0.016518,4,0.278724,0.3015,0
晋阎治下(1948),晋阎治下,notion,0,1,1,0,1,1,0.01022,4,0.267243,0.282233,0
晏阳初(1948),晏阳初,notion,0,4,4,0,4,4,0.054812,4,0.338622,0.380995,11236.851379
晓光(1948),晓光,notion,0,1,1,0,1,1,0.009739,4,0.265806,0.279704,0
晓林村(1948),晓林村,notion,0,1,1,0,1,1,0.009751,4,0.267186,0.282133,0
晚报(1948),晚报,notion,0,1,1,0,1,1,0.01022,4,0.267243,0.282233,0
晤见(1948),晤见,notion,0,1,1,0,1,1,0.011322,4,0.269061,0.285394,0
晦螟(1948),晦螟,notion,0,1,1,0,1,1,0.009739,4,0.265806,0.279704,0
晨光(1948),晨光,notion,0,1,1,0,1,1,0.009751,4,0.267186,0.282133,0
普建(1948),普建,notion,0,1,1,0,1,1,0.004718,4,0.258401,0.266227,0
普选(1948),普选,notion,0,2,2,0,2,2,0.014457,4,0.273688,0.293303,1733.460346
普通(1948),普通,notion,0,1,1,0,1,1,0.009755,4,0.266617,0.281135,0
景物(1948),景物,notion,0,1,1,0,1,1,0.01424,4,0.275514,0.296275,0
景象(1948),景象,notion,0,1,1,0,1,1,0.005017,4,0.257497,0.26453,0
智慧(1948),智慧,notion,0,1,1,0,1,1,0.009751,4,0.267186,0.282133,0
暑假(1948),暑假,notion,0,2,2,0,3,3,0.019972,4,0.283949,0.309807,2243.008915
暑期(1948),暑期,notion,0,2,2,0,2,2,0.027839,4,0.295962,0.327676,1920.33989
暗云(1948),暗云,notion,0,1,1,0,1,1,0.016518,4,0.278724,0.3015,0
暗杀(1948),暗杀,notion,0,3,3,0,3,3,0.025216,4,0.286155,0.313257,1882.815007
暗潮(1948),暗潮,notion,0,3,3,0,3,3,0.025216,4,0.286155,0.313257,1882.815007
暗算(1948),暗算,notion,0,1,1,0,1,1,0.009751,4,0.267186,0.282133,0
暮秋(1948),暮秋,notion,0,1,1,0,1,1,0.01424,4,0.275514,0.296275,0
暴动(1948),暴动,notion,0,3,3,0,4,4,0.022292,4,0.283691,0.309464,2686.44986
暴压(1948),暴压,notion,0,1,1,0,1,1,0.016752,4,0.279138,0.302165,0
暴行(1948),暴行,notion,0,3,3,0,3,3,0.041213,4,0.319634,0.359011,6966.552281
暴露(1948),暴露,notion,0,3,3,0,4,4,0.040497,4,0.317232,0.35605,6333.313511
暴风雨(1948),暴风雨,notion,0,4,4,0,4,4,0.035833,4,0.303543,0.338336,6627.448901
暹华(1948),暹华,notion,0,1,1,0,1,1,0.016518,4,0.278724,0.3015,0
暹局(1948),暹局,notion,0,1,1,0,1,1,0.016518,4,0.278724,0.3015,0
暹罗(1948),暹罗,notion,0,6,6,0,8,8,0.066194,4,0.358359,0.401438,28042.159348
曆法(1948),曆法,notion,0,1,1,0,1,1,0.011322,4,0.269061,0.285394,0
曙光(1948),曙光,notion,0,1,1,0,1,1,0.016752,4,0.279138,0.302165,0
曲解(1948),曲解,notion,0,2,2,0,3,3,0.024461,4,0.291756,0.321587,2304.72473
曲阳(1948),曲阳,notion,0,1,1,0,1,1,0.009751,4,0.267186,0.282133,0
更大(1948),更大,notion,0,1,1,0,1,1,0.016518,4,0.278724,0.3015,0
更广(1948),更广,notion,0,1,1,0,1,1,0.016752,4,0.279138,0.302165,0
更张(1948),更张,notion,0,1,1,0,1,1,0.005389,4,0.25849,0.266394,0
更斯(1948),更斯,notion,0,1,1,0,1,1,0.01022,4,0.267243,0.282233,0
更新(1948),更新,notion,0,1,1,0,1,1,0.01424,4,0.275514,0.296275,0
更正(1948),更正,notion,0,2,2,0,2,2,0.025562,4,0.293259,0.323783,2167.4723
曹伯(1948),曹伯,notion,0,1,1,0,1,1,0.009739,4,0.265806,0.279704,0
曹操(1948),曹操,notion,0,1,1,0,1,1,0.016518,4,0.278724,0.3015,0
曹汝霖(1948),曹汝霖,notion,0,1,1,0,1,1,0.01424,4,0.275514,0.296275,0
曾几何时(1948),曾几何时,notion,0,1,1,0,1,1,0.016518,4,0.278724,0.3015,0
曾否(1948),曾否,notion,0,1,1,0,1,1,0.004718,4,0.258401,0.266227,0
曾国藩(1948),曾国藩,notion,0,1,1,0,1,1,0.01424,4,0.275514,0.296275,0
曾琦(1948),曾琦,notion,0,1,1,0,1,1,0.01022,4,0.267243,0.282233,0
替代(1948),替代,notion,0,1,1,0,1,1,0.016752,4,0.279138,0.302165,0
最佳(1948),最佳,notion,0,1,1,0,1,1,0.01424,4,0.275514,0.296275,0
最大(1948),最大,notion,0,1,1,0,1,1,0.009739,4,0.265806,0.279704,0
最近(1948),最近,notion,0,7,7,0,16,16,0.069852,4,0.362125,0.40512,32320.106814
最高潮(1948),最高潮,notion,0,1,1,0,1,1,0.016518,4,0.278724,0.3015,0
有人(1948),有人,notion,0,1,1,0,1,1,0.011322,4,0.269061,0.285394,0
有什(1948),有什,notion,0,1,1,0,1,1,0.008247,4,0.26379,0.27611,0
有关(1948),有关,notion,0,5,5,0,5,5,0.057617,4,0.349426,0.392464,21443.546545
有力(1948),有力,notion,0,3,3,0,3,3,0.040978,4,0.319498,0.358845,7110.8147
有名(1948),有名,notion,0,1,1,0,1,1,0.016752,4,0.279138,0.302165,0
有命(1948),有命,notion,0,1,1,0,1,1,0.008247,4,0.26379,0.27611,0
有女(1948),有女,notion,0,1,1,0,1,1,0.01424,4,0.275514,0.296275,0
有心人(1948),有心人,notion,0,1,1,0,1,1,0.011322,4,0.269061,0.285394,0
有志(1948),有志,notion,0,1,1,0,1,1,0.01424,4,0.275514,0.296275,0
有意(1948),有意,notion,0,1,1,0,1,1,0.016752,4,0.279138,0.302165,0
有感(1948),有感,notion,0,5,5,0,5,5,0.044623,4,0.322959,0.363148,16741.736262
有感于(1948),有感于,notion,0,1,1,0,1,1,0.01022,4,0.267243,0.282233,0
有所作为(1948),有所作为,notion,0,1,1,0,1,1,0.01424,4,0.275514,0.296275,0
有所作爲(1948),有所作爲,notion,0,1,1,0,1,1,0.01424,4,0.275514,0.296275,0
有无(1948),有无,notion,0,1,1,0,1,1,0.008247,4,0.26379,0.27611,0
有没有(1948),有没有,notion,0,1,1,0,1,1,0.01424,4,0.275514,0.296275,0
有罪(1948),有罪,notion,0,1,1,0,1,1,0.008247,4,0.26379,0.27611,0
有色(1948),有色,notion,0,1,1,0,1,1,0.009755,4,0.266617,0.281135,0
有趣(1948),有趣,notion,0,1,1,0,1,1,0.009739,4,0.265806,0.279704,0
有道(1948),有道,notion,0,1,1,0,1,1,0.016752,4,0.279138,0.302165,0
有钱(1948),有钱,notion,0,1,1,0,1,1,0.011322,4,0.269061,0.285394,0
有钱人(1948),有钱人,notion,0,1,1,0,1,1,0.011322,4,0.269061,0.285394,0
朋友(1948),朋友,notion,0,3,3,0,6,6,0.036258,4,0.311059,0.34823,6585.637217
服务(1948),服务,notion,0,6,6,0,8,8,0.064799,4,0.360388,0.403401,31739.775431
朔风(1948),朔风,notion,0,1,1,0,1,1,0.016752,4,0.279138,0.302165,0
朗咏(1948),朗咏,notion,0,1,1,0,1,1,0.016752,4,0.279138,0.302165,0
朗文(1948),朗文,notion,0,1,1,0,1,1,0.009739,4,0.265806,0.279704,0
朗诵诗(1948),朗诵诗,notion,0,1,1,0,1,1,0.009751,4,0.267186,0.282133,0
望尘莫及(1948),望尘莫及,notion,0,1,1,0,1,1,0.01424,4,0.275514,0.296275,0
望江楼(1948),望江楼,notion,0,1,1,0,1,1,0.005389,4,0.25849,0.266394,0
朝廷(1948),朝廷,notion,0,1,1,0,1,1,0.016518,4,0.278724,0.3015,0
朝气(1948),朝气,notion,0,1,1,0,1,1,0.011322,4,0.269061,0.285394,0
朝阳(1948),朝阳,notion,0,1,1,0,1,1,0.01022,4,0.267243,0.282233,0
朝鲜(1948),朝鲜,notion,0,7,7,0,16,16,0.063412,4,0.34342,0.386319,23236.6782
期关(1948),期关,notion,0,1,1,0,1,1,0.011322,4,0.269061,0.285394,0
期望(1948),期望,notion,0,1,1,0,1,1,0.016752,4,0.279138,0.302165,0
期间(1948),期间,notion,0,1,1,0,1,1,0.011322,4,0.269061,0.285394,0
木匠(1948),木匠,notion,0,1,1,0,1,1,0.009751,4,0.267186,0.282133,0
木材(1948),木材,notion,0,1,1,0,1,1,0.004718,4,0.258401,0.266227,0
未动(1948),未动,notion,0,1,1,0,1,1,0.016752,4,0.279138,0.302165,0
未完待续(1948),未完待续,notion,0,1,1,0,1,1,0.007515,4,0.262793,0.274313,0
未开(1948),未开,notion,0,1,1,0,1,1,0.005389,4,0.25849,0.266394,0
未来(1948),未来,notion,0,3,3,0,4,4,0.021962,4,0.286242,0.31339,3299.937087
未死(1948),未死,notion,0,2,2,0,2,2,0.024765,4,0.291552,0.321288,2097.245087
未经(1948),未经,notion,0,1,1,0,1,1,0.016752,4,0.279138,0.302165,0
未能(1948),未能,notion,0,1,1,0,1,1,0.008247,4,0.26379,0.27611,0
末年(1948),末年,notion,0,1,1,0,1,1,0.011322,4,0.269061,0.285394,0
末日(1948),末日,notion,0,2,2,0,3,3,0.021076,4,0.284616,0.310839,1735.877057
末次(1948),末次,notion,0,1,1,0,1,1,0.009755,4,0.266617,0.281135,0
末路(1948),末路,notion,0,1,1,0,2,2,0.004718,4,0.258401,0.266227,0
本义(1948),本义,notion,0,1,1,0,1,1,0.007515,4,0.262793,0.274313,0
本京(1948),本京,notion,0,1,1,0,1,1,0.016752,4,0.279138,0.302165,0
本位(1948),本位,notion,0,1,1,0,1,1,0.011322,4,0.269061,0.285394,0
本届(1948),本届,notion,0,2,2,0,2,2,0.023995,4,0.291507,0.321221,2493.732085
本年(1948),本年,notion,0,1,1,0,3,3,0.009755,4,0.266617,0.281135,0
本文(1948),本文,notion,0,7,7,0,8,8,0.062286,4,0.34611,0.389148,26343.659755
本是(1948),本是,notion,0,1,1,0,1,1,0.005389,4,0.25849,0.266394,0
本月(1948),本月,notion,0,2,2,0,2,2,0.026507,4,0.294224,0.325181,2012.895914
本港(1948),本港,notion,0,1,1,0,1,1,0.005017,4,0.257497,0.26453,0
本色(1948),本色,notion,0,1,1,0,1,1,0.007515,4,0.262793,0.274313,0
本节(1948),本节,notion,0,1,1,0,1,1,0.01424,4,0.275514,0.296275,0
本质(1948),本质,notion,0,3,3,0,3,3,0.0208,4,0.282454,0.307534,3131.590818
本身(1948),本身,notion,0,1,1,0,1,1,0.009751,4,0.267186,0.282133,0
朱佩弦(1948),朱佩弦,notion,0,3,3,0,3,3,0.02002,4,0.276102,0.297351,1213.217211
朱佩弦兄(1948),朱佩弦兄,notion,0,2,2,0,2,2,0.008698,4,0.258507,0.266483,0.569098
朱佩弦师(1948),朱佩弦师,notion,0,2,2,0,2,2,0.008698,4,0.258507,0.266483,0.569098
朱先生(1948),朱先生,notion,0,1,1,0,1,1,0.005389,4,0.25849,0.266394,0
朱光潜(1948),朱光潜,notion,0,1,1,0,1,1,0.016752,4,0.279138,0.302165,0
朱武(1948),朱武,notion,0,1,1,0,1,1,0.009751,4,0.267186,0.282133,0
朱自清(1948),朱自清,notion,0,6,6,0,16,16,0.052728,4,0.328782,0.370059,16866.384399
机关(1948),机关,notion,0,5,5,0,7,7,0.065508,4,0.364161,0.406939,23818.164407
机关报(1948),机关报,notion,0,1,1,0,1,1,0.009755,4,0.266617,0.281135,0
机关枪(1948),机关枪,notion,0,1,1,0,1,1,0.009751,4,0.267186,0.282133,0
机务(1948),机务,notion,0,1,1,0,1,1,0.004718,4,0.258401,0.266227,0
机动车(1948),机动车,notion,0,1,1,0,1,1,0.004718,4,0.258401,0.266227,0
机器(1948),机器,notion,0,2,2,0,2,2,0.021073,4,0.285785,0.312636,2242.44705
机密(1948),机密,notion,0,1,1,0,1,1,0.008247,4,0.26379,0.27611,0
机构(1948),机构,notion,0,4,4,0,5,5,0.043723,4,0.325393,0.365988,14475.625293
机械化(1948),机械化,notion,0,1,1,0,1,1,0.009755,4,0.266617,0.281135,0
杀人(1948),杀人,notion,0,1,1,0,1,1,0.008247,4,0.26379,0.27611,0
杀人放火(1948),杀人放火,notion,0,1,1,0,1,1,0.01424,4,0.275514,0.296275,0
杀死(1948),杀死,notion,0,2,2,0,2,2,0.008698,4,0.258507,0.266483,0.569098
杂写(1948),杂写,notion,0,2,2,0,2,2,0.023992,4,0.29271,0.322985,3168.205568
杂忆(1948),杂忆,notion,0,1,1,0,1,1,0.005017,4,0.257497,0.26453,0
杂志(1948),杂志,notion,0,2,2,0,2,2,0.019506,4,0.282731,0.307911,1903.779982
杂粮(1948),杂粮,notion,0,1,1,0,1,1,0.01424,4,0.275514,0.296275,0
杂言(1948),杂言,notion,0,1,1,0,1,1,0.011322,4,0.269061,0.285394,0
杂誌(1948),杂誌,notion,0,1,1,0,1,1,0.011322,4,0.269061,0.285394,0
杂谈(1948),杂谈,notion,0,4,4,0,5,5,0.038505,4,0.314128,0.352212,12355.097075
权利(1948),权利,notion,0,3,3,0,4,4,0.041213,4,0.319634,0.359011,6966.552281
权力(1948),权力,notion,0,1,1,0,1,1,0.007515,4,0.262793,0.274313,0
权威(1948),权威,notion,0,2,2,0,3,3,0.030992,4,0.303936,0.338757,2912.385696
权臣(1948),权臣,notion,0,1,1,0,1,1,0.007515,4,0.262793,0.274313,0
李公樸(1948),李公樸,notion,0,1,1,0,2,2,0.005017,4,0.257497,0.26453,0
李埃决(1948),李埃决,notion,0,1,1,0,1,1,0.016752,4,0.279138,0.302165,0
李宗仁(1948),李宗仁,notion,0,4,4,0,7,7,0.05773,4,0.348389,0.391344,14070.628341
李广田(1948),李广田,notion,0,4,4,0,4,4,0.029759,4,0.290313,0.319568,3847.510878
李承晚(1948),李承晚,notion,0,3,3,0,3,3,0.033788,4,0.305692,0.341175,5972.023623
李振亚(1948),李振亚,notion,0,1,1,0,1,1,0.016518,4,0.278724,0.3015,0
李济琛(1948),李济琛,notion,0,1,1,0,1,1,0.01424,4,0.275514,0.296275,0
李良荣(1948),李良荣,notion,0,1,1,0,1,1,0.01022,4,0.267243,0.282233,0
李鸿章(1948),李鸿章,notion,0,1,1,0,1,1,0.01022,4,0.267243,0.282233,0
杜塞(1948),杜塞,notion,0,1,1,0,1,1,0.016518,4,0.278724,0.3015,0
杜威(1948),杜威,notion,0,4,4,0,5,5,0.054346,4,0.33853,0.380895,11625.791149
杜斌(1948),杜斌,notion,0,1,1,0,1,1,0.005017,4,0.257497,0.26453,0
杜甫(1948),杜甫,notion,0,1,1,0,1,1,0.008247,4,0.26379,0.27611,0
杜马(1948),杜马,notion,0,1,1,0,1,1,0.009755,4,0.266617,0.281135,0
束缚(1948),束缚,notion,0,1,1,0,1,1,0.009751,4,0.267186,0.282133,0
条件(1948),条件,notion,0,4,4,0,7,7,0.04623,4,0.325478,0.366088,10193.819465
条例(1948),条例,notion,0,4,4,0,4,4,0.029759,4,0.290313,0.319568,3847.510878
来书(1948),来书,notion,0,1,1,0,2,2,0.008247,4,0.26379,0.27611,0
来信(1948),来信,notion,0,3,3,0,3,3,0.04208,4,0.32089,0.360542,6900.033893
来到(1948),来到,notion,0,1,1,0,1,1,0.009739,4,0.265806,0.279704,0
来客(1948),来客,notion,0,2,2,0,2,2,0.024765,4,0.291552,0.321288,2097.245087
来德(1948),来德,notion,0,1,1,0,1,1,0.016752,4,0.279138,0.302165,0
来稿(1948),来稿,notion,0,1,1,0,1,1,0.009751,4,0.267186,0.282133,0
来谈(1948),来谈,notion,0,1,1,0,1,1,0.016752,4,0.279138,0.302165,0
杨士德(1948),杨士德,notion,0,1,1,0,1,1,0.009751,4,0.267186,0.282133,0
杨沧白(1948),杨沧白,notion,0,1,1,0,1,1,0.005389,4,0.25849,0.266394,0
杭县(1948),杭县,notion,0,1,1,0,1,1,0.016752,4,0.279138,0.302165,0
杭州(1948),杭州,notion,0,6,6,0,8,8,0.070263,4,0.368483,0.411021,27538.456911
杯弓蛇影(1948),杯弓蛇影,notion,0,1,1,0,1,1,0.016752,4,0.279138,0.302165,0
松江(1948),松江,notion,0,1,1,0,1,1,0.004718,4,0.258401,0.266227,0
极了(1948),极了,notion,0,1,1,0,1,1,0.007515,4,0.262793,0.274313,0
极耐(1948),极耐,notion,0,1,1,0,1,1,0.01424,4,0.275514,0.296275,0
极表(1948),极表,notion,0,1,1,0,1,1,0.01424,4,0.275514,0.296275,0
构型(1948),构型,notion,0,1,1,0,1,1,0.002332,4,0.253398,0.256677,0
林卡(1948),林卡,notion,0,1,1,0,1,1,0.009755,4,0.266617,0.281135,0
林子(1948),林子,notion,0,1,1,0,1,1,0.009751,4,0.267186,0.282133,0
林彪(1948),林彪,notion,0,1,1,0,1,1,0.01022,4,0.267243,0.282233,0
林斯基(1948),林斯基,notion,0,1,1,0,2,2,0.009755,4,0.266617,0.281135,0
林蔚民(1948),林蔚民,notion,0,1,1,0,1,1,0.01424,4,0.275514,0.296275,0
林裏(1948),林裏,notion,0,1,1,0,1,1,0.008247,4,0.26379,0.27611,0
林西(1948),林西,notion,0,1,1,0,1,1,0.008247,4,0.26379,0.27611,0
果实(1948),果实,notion,0,2,2,0,2,2,0.023995,4,0.291507,0.321221,2493.732085
枢纽(1948),枢纽,notion,0,1,1,0,1,1,0.01424,4,0.275514,0.296275,0
枪击(1948),枪击,notion,0,1,1,0,1,1,0.01022,4,0.267243,0.282233,0
枪杆(1948),枪杆,notion,0,2,2,0,3,3,0.026503,4,0.295799,0.327444,2668.961321
枯竭(1948),枯竭,notion,0,1,1,0,1,1,0.01022,4,0.267243,0.282233,0
柏林(1948),柏林,notion,0,9,9,0,13,13,0.106545,4,0.441292,0.467157,69791.678735
柏苍(1948),柏苍,notion,0,1,1,0,1,1,0.016752,4,0.279138,0.302165,0
某些(1948),某些,notion,0,1,1,0,1,1,0.009755,4,0.266617,0.281135,0
染上(1948),染上,notion,0,1,1,0,1,1,0.008247,4,0.26379,0.27611,0
查出(1948),查出,notion,0,1,1,0,1,1,0.009751,4,0.267186,0.282133,0
查整(1948),查整,notion,0,1,1,0,2,2,0.009751,4,0.267186,0.282133,0
查比(1948),查比,notion,0,1,1,0,1,1,0.009751,4,0.267186,0.282133,0
查理(1948),查理,notion,0,1,1,0,1,1,0.009755,4,0.266617,0.281135,0
查究(1948),查究,notion,0,1,1,0,1,1,0.01424,4,0.275514,0.296275,0
柯斯(1948),柯斯,notion,0,1,1,0,1,1,0.016752,4,0.279138,0.302165,0
标准(1948),标准,notion,0,1,1,0,1,1,0.009751,4,0.267186,0.282133,0
标售(1948),标售,notion,0,1,1,0,1,1,0.01424,4,0.275514,0.296275,0
标志(1948),标志,notion,0,1,1,0,1,1,0.009755,4,0.266617,0.281135,0
标準(1948),标準,notion,0,2,2,0,2,2,0.019569,4,0.280598,0.30455,1193.220239
标题(1948),标题,notion,0,1,1,0,1,1,0.01424,4,0.275514,0.296275,0
栖息(1948),栖息,notion,0,1,1,0,1,1,0.01424,4,0.275514,0.296275,0
栖霞山(1948),栖霞山,notion,0,1,1,0,1,1,0.011322,4,0.269061,0.285394,0
校内(1948),校内,notion,0,4,4,0,4,4,0.03024,4,0.291213,0.320899,3918.810743
校方(1948),校方,notion,0,1,1,0,1,1,0.009739,4,0.265806,0.279704,0
校章(1948),校章,notion,0,1,1,0,1,1,0.011322,4,0.269061,0.285394,0
校足本(1948),校足本,notion,0,1,1,0,1,1,0.011322,4,0.269061,0.285394,0
校风(1948),校风,notion,0,1,1,0,1,1,0.005017,4,0.257497,0.26453,0
核心(1948),核心,notion,0,2,2,0,2,2,0.033269,4,0.305692,0.34112,2297.98609
根据(1948),根据,notion,0,2,2,0,3,3,0.024267,4,0.290987,0.320456,2179.633602
根本(1948),根本,notion,0,3,3,0,3,3,0.022938,4,0.283542,0.309231,2406.045322
根本变化(1948),根本变化,notion,0,1,1,0,1,1,0.016518,4,0.278724,0.3015,0
根源(1948),根源,notion,0,1,1,0,1,1,0.01424,4,0.275514,0.296275,0
根苗(1948),根苗,notion,0,1,1,0,1,1,0.009751,4,0.267186,0.282133,0
格味事(1948),格味事,notion,0,1,1,0,1,1,0.004718,4,0.258401,0.266227,0
格林(1948),格林,notion,0,1,1,0,1,1,0.009755,4,0.266617,0.281135,0
栽培(1948),栽培,notion,0,1,1,0,1,1,0.004718,4,0.258401,0.266227,0
桂东(1948),桂东,notion,0,1,1,0,1,1,0.009751,4,0.267186,0.282133,0
桂北(1948),桂北,notion,0,1,1,0,1,1,0.009751,4,0.267186,0.282133,0
桂林(1948),桂林,notion,0,1,1,0,1,1,0.01022,4,0.267243,0.282233,0
桂系(1948),桂系,notion,0,1,1,0,1,1,0.009751,4,0.267186,0.282133,0
桂花(1948),桂花,notion,0,1,1,0,1,1,0.008247,4,0.26379,0.27611,0
桃源(1948),桃源,notion,0,1,1,0,1,1,0.016752,4,0.279138,0.302165,0
案件(1948),案件,notion,0,2,2,0,2,2,0.008698,4,0.258507,0.266483,0.569098
桎梏(1948),桎梏,notion,0,1,1,0,1,1,0.007515,4,0.262793,0.274313,0
桥梁(1948),桥梁,notion,0,1,1,0,1,1,0.008247,4,0.26379,0.27611,0
梁山(1948),梁山,notion,0,1,1,0,2,2,0.016752,4,0.279138,0.302165,0
梅林(1948),梅林,notion,0,1,1,0,1,1,0.009751,4,0.267186,0.282133,0
梅花(1948),梅花,notion,0,1,1,0,1,1,0.009739,4,0.265806,0.279704,0
梓州(1948),梓州,notion,0,1,1,0,1,1,0.008247,4,0.26379,0.27611,0
梦幻(1948),梦幻,notion,0,1,1,0,1,1,0.016518,4,0.278724,0.3015,0
梦魇(1948),梦魇,notion,0,1,1,0,1,1,0.011322,4,0.269061,0.285394,0
检举(1948),检举,notion,0,1,1,0,1,1,0.01424,4,0.275514,0.296275,0
检查(1948),检查,notion,0,2,2,0,4,4,0.023992,4,0.29271,0.322985,3168.205568
检讨(1948),检讨,notion,0,7,7,0,14,14,0.072546,4,0.377975,0.419595,44719.187894
检阅(1948),检阅,notion,0,2,2,0,2,2,0.033269,4,0.305692,0.34112,2297.98609
棉农(1948),棉农,notion,0,1,1,0,1,1,0.01424,4,0.275514,0.296275,0
棉贷(1948),棉贷,notion,0,1,1,0,1,1,0.01424,4,0.275514,0.296275,0
森斯坦(1948),森斯坦,notion,0,1,1,0,1,1,0.009755,4,0.266617,0.281135,0
森铁华(1948),森铁华,notion,0,1,1,0,1,1,0.016752,4,0.279138,0.302165,0
棺材(1948),棺材,notion,0,1,1,0,1,1,0.016518,4,0.278724,0.3015,0
楚溪春(1948),楚溪春,notion,0,1,1,0,1,1,0.01022,4,0.267243,0.282233,0
楼名(1948),楼名,notion,0,1,1,0,1,1,0.01424,4,0.275514,0.296275,0
楼桐(1948),楼桐,notion,0,1,1,0,1,1,0.01424,4,0.275514,0.296275,0
楼适夷(1948),楼适夷,notion,0,1,1,0,1,1,0.016752,4,0.279138,0.302165,0
概况(1948),概况,notion,0,1,1,0,1,1,0.016518,4,0.278724,0.3015,0
概观(1948),概观,notion,0,1,1,0,1,1,0.009751,4,0.267186,0.282133,0
榆林(1948),榆林,notion,0,1,1,0,1,1,0.01022,4,0.267243,0.282233,0
榕树(1948),榕树,notion,0,1,1,0,1,1,0.009751,4,0.267186,0.282133,0
榴花(1948),榴花,notion,0,1,1,0,1,1,0.016752,4,0.279138,0.302165,0
模范(1948),模范,notion,0,1,1,0,2,2,0.009751,4,0.267186,0.282133,0
横岗(1948),横岗,notion,0,1,1,0,1,1,0.009751,4,0.267186,0.282133,0
樸素(1948),樸素,notion,0,1,1,0,1,1,0.016518,4,0.278724,0.3015,0
檄文(1948),檄文,notion,0,1,1,0,1,1,0.01424,4,0.275514,0.296275,0
欢迎(1948),欢迎,notion,0,4,4,0,4,4,0.042991,4,0.324578,0.365023,14732.093351
欣欣向荣(1948),欣欣向荣,notion,0,1,1,0,2,2,0.009755,4,0.266617,0.281135,0
欣赏(1948),欣赏,notion,0,2,2,0,2,2,0.024999,4,0.291484,0.321188,1929.694181
欣闻(1948),欣闻,notion,0,1,1,0,1,1,0.01424,4,0.275514,0.296275,0
欧局(1948),欧局,notion,0,1,1,0,1,1,0.01424,4,0.275514,0.296275,0
欧行(1948),欧行,notion,0,1,1,0,1,1,0.016752,4,0.279138,0.302165,0
欧阳予倩(1948),欧阳予倩,notion,0,1,1,0,1,1,0.016752,4,0.279138,0.302165,0
欲盖弥彰(1948),欲盖弥彰,notion,0,1,1,0,1,1,0.016518,4,0.278724,0.3015,0
欺蒙(1948),欺蒙,notion,0,1,1,0,1,1,0.008247,4,0.26379,0.27611,0
欺骗(1948),欺骗,notion,0,2,2,0,2,2,0.023995,4,0.291507,0.321221,2493.732085
歉意(1948),歉意,notion,0,2,2,0,2,2,0.008698,4,0.258507,0.266483,0.569098
歌州(1948),歌州,notion,0,1,1,0,1,1,0.016752,4,0.279138,0.302165,0
歌谣(1948),歌谣,notion,0,1,1,0,1,1,0.011322,4,0.269061,0.285394,0
歌颂(1948),歌颂,notion,0,1,1,0,1,1,0.016518,4,0.278724,0.3015,0
正义(1948),正义,notion,0,1,1,0,1,1,0.01424,4,0.275514,0.296275,0
正传(1948),正传,notion,0,1,1,0,1,1,0.016752,4,0.279138,0.302165,0
正大(1948),正大,notion,0,1,1,0,1,1,0.016518,4,0.278724,0.3015,0
正常(1948),正常,notion,0,1,1,0,1,1,0.01022,4,0.267243,0.282233,0
正式(1948),正式,notion,0,1,1,0,1,1,0.009739,4,0.265806,0.279704,0
正确路线(1948),正确路线,notion,0,1,1,0,1,1,0.009751,4,0.267186,0.282133,0
正统(1948),正统,notion,0,1,1,0,1,1,0.007515,4,0.262793,0.274313,0
此中(1948),此中,notion,0,1,1,0,1,1,0.008247,4,0.26379,0.27611,0
此日(1948),此日,notion,0,1,1,0,1,1,0.016752,4,0.279138,0.302165,0
此时(1948),此时,notion,0,1,1,0,1,1,0.016752,4,0.279138,0.302165,0
此次(1948),此次,notion,0,1,1,0,1,1,0.011322,4,0.269061,0.285394,0
此言差矣(1948),此言差矣,notion,0,1,1,0,1,1,0.016752,4,0.279138,0.302165,0
步惠廉(1948),步惠廉,notion,0,1,1,0,1,1,0.009739,4,0.265806,0.279704,0
步调(1948),步调,notion,0,1,1,0,1,1,0.016752,4,0.279138,0.302165,0
武侯(1948),武侯,notion,0,1,1,0,1,1,0.01424,4,0.275514,0.296275,0
武力(1948),武力,notion,0,2,2,0,2,2,0.024461,4,0.291756,0.321587,2304.72473
武器(1948),武器,notion,0,4,4,0,5,5,0.032039,4,0.300797,0.334576,8571.343212
武大(1948),武大,notion,0,4,4,0,4,4,0.045328,4,0.320945,0.360664,9591.813345
武断(1948),武断,notion,0,1,1,0,1,1,0.01424,4,0.275514,0.296275,0
武昌(1948),武昌,notion,0,1,1,0,1,1,0.007515,4,0.262793,0.274313,0
武汉大学(1948),武汉大学,notion,0,2,2,0,2,2,0.018837,4,0.280346,0.304151,1468.125238
武装(1948),武装,notion,0,4,4,0,5,5,0.04841,4,0.329301,0.370547,10551.035023
武装人员(1948),武装人员,notion,0,1,1,0,1,1,0.009751,4,0.267186,0.282133,0
歧视(1948),歧视,notion,0,1,1,0,1,1,0.009739,4,0.265806,0.279704,0
歧途(1948),歧途,notion,0,1,1,0,1,1,0.007515,4,0.262793,0.274313,0
死亡线(1948),死亡线,notion,0,1,1,0,1,1,0.016752,4,0.279138,0.302165,0
死去(1948),死去,notion,0,2,2,0,2,2,0.014757,4,0.271708,0.289975,655.261449
死守(1948),死守,notion,0,1,1,0,1,1,0.016518,4,0.278724,0.3015,0
死敌(1948),死敌,notion,0,1,1,0,1,1,0.016518,4,0.278724,0.3015,0
死结(1948),死结,notion,0,2,2,0,2,2,0.009848,4,0.265524,0.27926,689.820462
死路(1948),死路,notion,0,1,1,0,1,1,0.009751,4,0.267186,0.282133,0
死难(1948),死难,notion,0,3,3,0,3,3,0.02545,4,0.285981,0.312991,1629.880666
歼灭(1948),歼灭,notion,0,1,1,0,1,1,0.009755,4,0.266617,0.281135,0
歼灭战(1948),歼灭战,notion,0,1,1,0,1,1,0.016518,4,0.278724,0.3015,0
殉国(1948),殉国,notion,0,1,1,0,1,1,0.005017,4,0.257497,0.26453,0
殉职(1948),殉职,notion,0,1,1,0,1,1,0.011322,4,0.269061,0.285394,0
殉葬(1948),殉葬,notion,0,2,2,0,2,2,0.017999,4,0.280116,0.303785,1897.286008
残局(1948),残局,notion,0,3,3,0,3,3,0.018453,4,0.274528,0.294756,1725.62382
残废(1948),残废,notion,0,1,1,0,1,1,0.009755,4,0.266617,0.281135,0
残忍(1948),残忍,notion,0,1,1,0,1,1,0.008247,4,0.26379,0.27611,0
残杀(1948),残杀,notion,0,1,1,0,1,1,0.016518,4,0.278724,0.3015,0
残棋(1948),残棋,notion,0,1,1,0,1,1,0.016518,4,0.278724,0.3015,0
残民以逞(1948),残民以逞,notion,0,1,1,0,1,1,0.008247,4,0.26379,0.27611,0
殒落(1948),殒落,notion,0,2,2,0,2,2,0.008698,4,0.258507,0.266483,0.569098
殖民主义(1948),殖民主义,notion,0,1,1,0,1,1,0.009755,4,0.266617,0.281135,0
殖民地(1948),殖民地,notion,0,1,1,0,2,2,0.009755,4,0.266617,0.281135,0
毁弃(1948),毁弃,notion,0,1,1,0,1,1,0.008247,4,0.26379,0.27611,0
毁灭(1948),毁灭,notion,0,4,4,0,4,4,0.031656,4,0.298621,0.331548,6900.872528
毁记(1948),毁记,notion,0,1,1,0,1,1,0.016518,4,0.278724,0.3015,0
母与子(1948),母与子,notion,0,1,1,0,1,1,0.016752,4,0.279138,0.302165,0
母亲(1948),母亲,notion,0,1,1,0,1,1,0.009755,4,0.266617,0.281135,0
母亲节(1948),母亲节,notion,0,1,1,0,1,1,0.011322,4,0.269061,0.285394,0
母体(1948),母体,notion,0,1,1,0,1,1,0.004718,4,0.258401,0.266227,0
母哭子(1948),母哭子,notion,0,1,1,0,1,1,0.009739,4,0.265806,0.279704,0
母爱(1948),母爱,notion,0,1,1,0,1,1,0.016752,4,0.279138,0.302165,0
每以(1948),每以,notion,0,1,1,0,1,1,0.01424,4,0.275514,0.296275,0
毒害(1948),毒害,notion,0,1,1,0,1,1,0.009755,4,0.266617,0.281135,0
毒打(1948),毒打,notion,0,1,1,0,1,1,0.016518,4,0.278724,0.3015,0
毒技(1948),毒技,notion,0,1,1,0,1,1,0.016752,4,0.279138,0.302165,0
毒气(1948),毒气,notion,0,1,1,0,1,1,0.016752,4,0.279138,0.302165,0
毒流(1948),毒流,notion,0,1,1,0,1,1,0.01424,4,0.275514,0.296275,0
毒牙(1948),毒牙,notion,0,1,1,0,1,1,0.009755,4,0.266617,0.281135,0
比亦一(1948),比亦一,notion,0,1,1,0,1,1,0.01424,4,0.275514,0.296275,0
比例(1948),比例,notion,0,1,1,0,1,1,0.007515,4,0.262793,0.274313,0
比利时(1948),比利时,notion,0,1,1,0,1,1,0.009755,4,0.266617,0.281135,0
比喻(1948),比喻,notion,0,1,1,0,1,1,0.016752,4,0.279138,0.302165,0
比较(1948),比较,notion,0,5,5,0,5,5,0.051771,4,0.334045,0.375993,17993.246249
毕业生(1948),毕业生,notion,0,2,2,0,2,2,0.019569,4,0.280598,0.30455,1193.220239
毕竟(1948),毕竟,notion,0,1,1,0,1,1,0.009739,4,0.265806,0.279704,0
毛泽东思想(1948),毛泽东思想,notion,0,1,1,0,1,1,0.009751,4,0.267186,0.282133,0
毫无(1948),毫无,notion,0,1,1,0,1,1,0.01424,4,0.275514,0.296275,0
民主人士(1948),民主人士,notion,0,3,3,0,3,3,0.040497,4,0.317232,0.35605,6333.313511
民主党(1948),民主党,notion,0,2,2,0,2,2,0.028074,4,0.296149,0.327943,1864.79583
民主党派(1948),民主党派,notion,0,1,1,0,1,1,0.009751,4,0.267186,0.282133,0
民主化(1948),民主化,notion,0,1,1,0,2,2,0.009755,4,0.266617,0.281135,0
民主同盟(1948),民主同盟,notion,0,1,1,0,1,1,0.005017,4,0.257497,0.26453,0
民主改革(1948),民主改革,notion,0,1,1,0,1,1,0.009755,4,0.266617,0.281135,0
民主社会主义(1948),民主社会主义,notion,0,2,2,0,3,3,0.01727,4,0.278352,0.300956,1619.09855
民主社会党(1948),民主社会党,notion,0,1,1,0,2,2,0.007515,4,0.262793,0.274313,0
民主运动(1948),民主运动,notion,0,4,4,0,5,5,0.052527,4,0.337345,0.379598,11365.251801
民主革命(1948),民主革命,notion,0,1,1,0,1,1,0.016518,4,0.278724,0.3015,0
民兵(1948),民兵,notion,0,1,1,0,2,2,0.016518,4,0.278724,0.3015,0
民初(1948),民初,notion,0,1,1,0,1,1,0.007515,4,0.262793,0.274313,0
民力(1948),民力,notion,0,2,2,0,2,2,0.028074,4,0.296149,0.327943,1864.79583
民友报(1948),民友报,notion,0,1,1,0,1,1,0.007515,4,0.262793,0.274313,0
民变(1948),民变,notion,0,4,4,0,5,5,0.054812,4,0.338622,0.380995,11236.851379
民命(1948),民命,notion,0,1,1,0,1,1,0.01424,4,0.275514,0.296275,0
民心(1948),民心,notion,0,2,2,0,2,2,0.033269,4,0.305692,0.34112,2297.98609
民情(1948),民情,notion,0,1,1,0,1,1,0.011322,4,0.269061,0.285394,0
民意(1948),民意,notion,0,2,2,0,2,2,0.01996,4,0.281333,0.305715,1305.273912
民意机关(1948),民意机关,notion,0,2,2,0,2,2,0.017736,4,0.278993,0.301988,1631.559673
民意测验(1948),民意测验,notion,0,1,1,0,1,1,0.005389,4,0.25849,0.266394,0
民意调查(1948),民意调查,notion,0,1,1,0,1,1,0.009739,4,0.265806,0.279704,0
民政局长(1948),民政局长,notion,0,1,1,0,1,1,0.01424,4,0.275514,0.296275,0
民族(1948),民族,notion,0,8,8,0,18,18,0.096062,4,0.417088,0.450663,52983.869739
民族主义(1948),民族主义,notion,0,4,4,0,4,4,0.044394,4,0.324325,0.364723,10783.439507
民族运动(1948),民族运动,notion,0,1,1,0,1,1,0.009739,4,0.265806,0.279704,0
民权(1948),民权,notion,0,1,1,0,1,1,0.008247,4,0.26379,0.27611,0
民权思想(1948),民权思想,notion,0,1,1,0,1,1,0.004718,4,0.258401,0.266227,0
民歌(1948),民歌,notion,0,2,2,0,2,2,0.019972,4,0.283949,0.309807,2243.008915
民武(1948),民武,notion,0,1,1,0,1,1,0.009751,4,0.267186,0.282133,0
民生(1948),民生,notion,0,1,1,0,1,1,0.004718,4,0.258401,0.266227,0
民生主义(1948),民生主义,notion,0,1,1,0,1,1,0.01424,4,0.275514,0.296275,0
民社党(1948),民社党,notion,0,3,3,0,4,4,0.029058,4,0.295869,0.327599,4510.104359
民穷财尽(1948),民穷财尽,notion,0,1,1,0,1,1,0.01022,4,0.267243,0.282233,0
民营(1948),民营,notion,0,1,1,0,1,1,0.005017,4,0.257497,0.26453,0
民衆(1948),民衆,notion,0,1,1,0,1,1,0.01424,4,0.275514,0.296275,0
民谣(1948),民谣,notion,0,3,3,0,4,4,0.031287,4,0.299001,0.332024,3863.30515
民选(1948),民选,notion,0,1,1,0,1,1,0.007515,4,0.262793,0.274313,0
民间(1948),民间,notion,0,2,2,0,2,2,0.021469,4,0.287095,0.314632,2527.522512
民隐(1948),民隐,notion,0,1,1,0,1,1,0.01022,4,0.267243,0.282233,0
民食(1948),民食,notion,0,2,2,0,2,2,0.030758,4,0.303347,0.337959,2812.221703
气氛(1948),气氛,notion,0,1,1,0,1,1,0.005017,4,0.257497,0.26453,0
气焰(1948),气焰,notion,0,1,1,0,1,1,0.01424,4,0.275514,0.296275,0
气的(1948),气的,notion,0,1,1,0,1,1,0.016752,4,0.279138,0.302165,0
气节(1948),气节,notion,0,1,1,0,1,1,0.016752,4,0.279138,0.302165,0
水一冲(1948),水一冲,notion,0,1,1,0,1,1,0.009751,4,0.267186,0.282133,0
水利建设(1948),水利建设,notion,0,1,1,0,1,1,0.007515,4,0.262793,0.274313,0
水城(1948),水城,notion,0,1,1,0,1,1,0.008247,4,0.26379,0.27611,0
水底(1948),水底,notion,0,1,1,0,1,1,0.016518,4,0.278724,0.3015,0
水池(1948),水池,notion,0,1,1,0,1,1,0.007515,4,0.262793,0.274313,0
水涨(1948),水涨,notion,0,1,1,0,1,1,0.01424,4,0.275514,0.296275,0
水深火热(1948),水深火热,notion,0,1,1,0,2,2,0.009755,4,0.266617,0.281135,0
水溃(1948),水溃,notion,0,1,1,0,1,1,0.016518,4,0.278724,0.3015,0
水火(1948),水火,notion,0,1,1,0,1,1,0.008247,4,0.26379,0.27611,0
水萝萄(1948),水萝萄,notion,0,1,1,0,1,1,0.016518,4,0.278724,0.3015,0
永世(1948),永世,notion,0,1,1,0,1,1,0.016518,4,0.278724,0.3015,0
永久(1948),永久,notion,0,1,1,0,1,1,0.009739,4,0.265806,0.279704,0
永别(1948),永别,notion,0,1,1,0,1,1,0.009755,4,0.266617,0.281135,0
永垂不朽(1948),永垂不朽,notion,0,1,1,0,1,1,0.016518,4,0.278724,0.3015,0
永生(1948),永生,notion,0,1,1,0,1,1,0.016518,4,0.278724,0.3015,0
永远(1948),永远,notion,0,3,3,0,3,3,0.033747,4,0.308758,0.345235,7565.717635
求死不能(1948),求死不能,notion,0,1,1,0,1,1,0.009739,4,0.265806,0.279704,0
求生不得(1948),求生不得,notion,0,1,1,0,1,1,0.009739,4,0.265806,0.279704,0
汇率(1948),汇率,notion,0,1,1,0,1,1,0.011322,4,0.269061,0.285394,0
汇辑(1948),汇辑,notion,0,1,1,0,1,1,0.004718,4,0.258401,0.266227,0
汉代(1948),汉代,notion,0,1,1,0,1,1,0.011322,4,0.269061,0.285394,0
汉奸(1948),汉奸,notion,0,2,2,0,2,2,0.026269,4,0.293695,0.324415,1931.353166
汉字(1948),汉字,notion,0,1,1,0,1,1,0.011322,4,0.269061,0.285394,0
汉时(1948),汉时,notion,0,1,1,0,1,1,0.007515,4,0.262793,0.274313,0
汉浔(1948),汉浔,notion,0,1,1,0,1,1,0.01022,4,0.267243,0.282233,0
汉王(1948),汉王,notion,0,1,1,0,1,1,0.009739,4,0.265806,0.279704,0
汕头(1948),汕头,notion,0,2,2,0,2,2,0.019972,4,0.283949,0.309807,2243.008915
汝关(1948),汝关,notion,0,1,1,0,1,1,0.01424,4,0.275514,0.296275,0
江上(1948),江上,notion,0,1,1,0,1,1,0.009739,4,0.265806,0.279704,0
江亚轮(1948),江亚轮,notion,0,1,1,0,1,1,0.016752,4,0.279138,0.302165,0
江北(1948),江北,notion,0,1,1,0,1,1,0.009751,4,0.267186,0.282133,0
江北岸(1948),江北岸,notion,0,1,1,0,1,1,0.016518,4,0.278724,0.3015,0
江山(1948),江山,notion,0,1,1,0,1,1,0.009755,4,0.266617,0.281135,0
江汉(1948),江汉,notion,0,3,3,0,3,3,0.035782,4,0.309037,0.345601,5882.616477
江河(1948),江河,notion,0,1,1,0,1,1,0.016752,4,0.279138,0.302165,0
江淮(1948),江淮,notion,0,1,1,0,1,1,0.016752,4,0.279138,0.302165,0
江湖(1948),江湖,notion,0,2,2,0,2,2,0.026269,4,0.293695,0.324415,1931.353166
江湖医生(1948),江湖医生,notion,0,1,1,0,1,1,0.016518,4,0.278724,0.3015,0
江而守(1948),江而守,notion,0,1,1,0,1,1,0.016518,4,0.278724,0.3015,0
江苏省(1948),江苏省,notion,0,1,1,0,1,1,0.004718,4,0.258401,0.266227,0
江西(1948),江西,notion,0,1,1,0,1,1,0.01022,4,0.267243,0.282233,0
江边(1948),江边,notion,0,1,1,0,1,1,0.009739,4,0.265806,0.279704,0
江防(1948),江防,notion,0,1,1,0,1,1,0.016752,4,0.279138,0.302165,0
汤麦士(1948),汤麦士,notion,0,1,1,0,1,1,0.01022,4,0.267243,0.282233,0
汪府(1948),汪府,notion,0,1,1,0,1,1,0.009751,4,0.267186,0.282133,0
汪穰卿(1948),汪穰卿,notion,0,1,1,0,1,1,0.007515,4,0.262793,0.274313,0
汹湧(1948),汹湧,notion,0,1,1,0,2,2,0.016518,4,0.278724,0.3015,0
汽车(1948),汽车,notion,0,1,1,0,1,1,0.009751,4,0.267186,0.282133,0
汾阳(1948),汾阳,notion,0,1,1,0,1,1,0.01022,4,0.267243,0.282233,0
沈从文(1948),沈从文,notion,0,1,1,0,1,1,0.01424,4,0.275514,0.296275,0
沈钧儒(1948),沈钧儒,notion,0,1,1,0,1,1,0.01424,4,0.275514,0.296275,0
沈阳(1948),沈阳,notion,0,3,3,0,5,5,0.036712,4,0.306816,0.342673,4458.540834
沉沦(1948),沉沦,notion,0,1,1,0,1,1,0.008247,4,0.26379,0.27611,0
沉疴(1948),沉疴,notion,0,1,1,0,1,1,0.007515,4,0.262793,0.274313,0
沉痛(1948),沉痛,notion,0,2,2,0,2,2,0.019491,4,0.281819,0.30648,1649.883746
沉着(1948),沉着,notion,0,1,1,0,1,1,0.004718,4,0.258401,0.266227,0
沉舟(1948),沉舟,notion,0,1,1,0,1,1,0.004718,4,0.258401,0.266227,0
沙坪坝(1948),沙坪坝,notion,0,1,1,0,1,1,0.01022,4,0.267243,0.282233,0
沙市(1948),沙市,notion,0,1,1,0,1,1,0.01424,4,0.275514,0.296275,0
沙田(1948),沙田,notion,0,1,1,0,2,2,0.009751,4,0.267186,0.282133,0
沙鱼(1948),沙鱼,notion,0,1,1,0,1,1,0.009751,4,0.267186,0.282133,0
没收(1948),没收,notion,0,1,1,0,1,1,0.016518,4,0.278724,0.3015,0
没法(1948),没法,notion,0,1,1,0,1,1,0.016518,4,0.278724,0.3015,0
没落(1948),没落,notion,0,1,1,0,1,1,0.01022,4,0.267243,0.282233,0
沪市(1948),沪市,notion,0,1,1,0,1,1,0.01424,4,0.275514,0.296275,0
沮丧(1948),沮丧,notion,0,1,1,0,1,1,0.01424,4,0.275514,0.296275,0
河上(1948),河上,notion,0,1,1,0,1,1,0.01424,4,0.275514,0.296275,0
河南(1948),河南,notion,0,2,2,0,2,2,0.01561,4,0.274548,0.294734,907.836731
河源(1948),河源,notion,0,1,1,0,1,1,0.01424,4,0.275514,0.296275,0
河畔(1948),河畔,notion,0,1,1,0,1,1,0.008247,4,0.26379,0.27611,0
治下(1948),治下,notion,0,3,3,0,3,3,0.02002,4,0.276102,0.297351,1213.217211
治安(1948),治安,notion,0,3,3,0,3,3,0.02002,4,0.276102,0.297351,1213.217211
治粤(1948),治粤,notion,0,1,1,0,1,1,0.011322,4,0.269061,0.285394,0
治罪(1948),治罪,notion,0,2,2,0,2,2,0.021061,4,0.283157,0.308576,1336.570675
沿江(1948),沿江,notion,0,1,1,0,1,1,0.016752,4,0.279138,0.302165,0
沿海(1948),沿海,notion,0,2,2,0,2,2,0.026972,4,0.293947,0.324781,1749.441854
泄漏(1948),泄漏,notion,0,3,3,0,3,3,0.018919,4,0.274568,0.294822,1295.743183
泉眼(1948),泉眼,notion,0,1,1,0,1,1,0.004718,4,0.258401,0.266227,0
法兰西(1948),法兰西,notion,0,2,2,0,2,2,0.025562,4,0.293259,0.323783,2167.4723
法军(1948),法军,notion,0,1,1,0,1,1,0.016518,4,0.278724,0.3015,0
法国人(1948),法国人,notion,0,1,1,0,1,1,0.009739,4,0.265806,0.279704,0
法国共产党(1948),法国共产党,notion,0,3,3,0,5,5,0.033788,4,0.305692,0.341175,5972.023623
法官(1948),法官,notion,0,1,1,0,1,1,0.016518,4,0.278724,0.3015,0
法币(1948),法币,notion,0,4,4,0,4,4,0.046307,4,0.323655,0.363925,10228.181888
法律(1948),法律,notion,0,5,5,0,9,9,0.051545,4,0.333718,0.375627,17284.507254
法意(1948),法意,notion,0,1,1,0,1,1,0.011322,4,0.269061,0.285394,0
法治(1948),法治,notion,0,2,2,0,2,2,0.012233,4,0.270573,0.288045,1678.569586
法浅(1948),法浅,notion,0,1,1,0,1,1,0.007515,4,0.262793,0.274313,0
法西斯(1948),法西斯,notion,0,5,5,0,7,7,0.043596,4,0.314681,0.352966,10164.007434
法西斯主义(1948),法西斯主义,notion,0,1,1,0,2,2,0.009755,4,0.266617,0.281135,0
法西斯蒂(1948),法西斯蒂,notion,0,1,1,0,1,1,0.002332,4,0.253398,0.256677,0
法规(1948),法规,notion,0,1,1,0,1,1,0.008247,4,0.26379,0.27611,0
法越(1948),法越,notion,0,2,2,0,2,2,0.018002,4,0.27945,0.30272,1656.832374
法郎(1948),法郎,notion,0,3,3,0,4,4,0.036493,4,0.309342,0.346,5642.475469
泛滥(1948),泛滥,notion,0,2,2,0,2,2,0.033269,4,0.305692,0.34112,2297.98609
波动(1948),波动,notion,0,1,1,0,1,1,0.016518,4,0.278724,0.3015,0
波士顿(1948),波士顿,notion,0,1,1,0,1,1,0.005017,4,0.257497,0.26453,0
波浪(1948),波浪,notion,0,2,2,0,2,2,0.021542,4,0.284314,0.310373,1410.419447
波涛(1948),波涛,notion,0,1,1,0,1,1,0.016518,4,0.278724,0.3015,0
波罗的海(1948),波罗的海,notion,0,2,2,0,2,2,0.019506,4,0.282731,0.307911,1903.779982
波茨坦(1948),波茨坦,notion,0,1,1,0,1,1,0.01022,4,0.267243,0.282233,0
泥坑(1948),泥坑,notion,0,1,1,0,1,1,0.016752,4,0.279138,0.302165,0
泥足(1948),泥足,notion,0,2,2,0,2,2,0.017255,4,0.277263,0.299193,1338.862931
注意(1948),注意,notion,0,4,4,0,8,8,0.051831,4,0.338134,0.380463,14242.039677
注视(1948),注视,notion,0,3,3,0,3,3,0.019486,4,0.281396,0.30587,4066.237846
泪了(1948),泪了,notion,0,1,1,0,1,1,0.016518,4,0.278724,0.3015,0
泪眼(1948),泪眼,notion,0,2,2,0,2,2,0.021542,4,0.284314,0.310373,1410.419447
泰到(1948),泰到,notion,0,2,2,0,2,2,0.026972,4,0.293947,0.324781,1749.441854
泰勒(1948),泰勒,notion,0,2,2,0,3,3,0.026491,4,0.291937,0.321853,1403.825067
泰晤士报(1948),泰晤士报,notion,0,1,1,0,1,1,0.01424,4,0.275514,0.296275,0
泰林汉(1948),泰林汉,notion,0,1,1,0,1,1,0.009755,4,0.266617,0.281135,0
洋鬼子(1948),洋鬼子,notion,0,1,1,0,1,1,0.01424,4,0.275514,0.296275,0
洗刷(1948),洗刷,notion,0,1,1,0,1,1,0.009751,4,0.267186,0.282133,0
洗劫(1948),洗劫,notion,0,1,1,0,1,1,0.009751,4,0.267186,0.282133,0
洛夫(1948),洛夫,notion,0,1,1,0,2,2,0.009755,4,0.266617,0.281135,0
洛杉矶(1948),洛杉矶,notion,0,1,1,0,1,1,0.005017,4,0.257497,0.26453,0
津浦(1948),津浦,notion,0,1,1,0,1,1,0.007515,4,0.262793,0.274313,0
津贴(1948),津贴,notion,0,1,1,0,1,1,0.011322,4,0.269061,0.285394,0
洩币狱(1948),洩币狱,notion,0,1,1,0,1,1,0.007515,4,0.262793,0.274313,0
洩露(1948),洩露,notion,0,1,1,0,1,1,0.01424,4,0.275514,0.296275,0
洪宪(1948),洪宪,notion,0,1,1,0,1,1,0.016752,4,0.279138,0.302165,0
洪流(1948),洪流,notion,0,1,1,0,1,1,0.009751,4,0.267186,0.282133,0
洪深氏(1948),洪深氏,notion,0,1,1,0,1,1,0.01424,4,0.275514,0.296275,0
活不下去(1948),活不下去,notion,0,2,2,0,2,2,0.033269,4,0.305692,0.34112,2297.98609
活动(1948),活动,notion,0,5,5,0,5,5,0.049812,4,0.330809,0.372332,18203.548423
活命(1948),活命,notion,0,3,3,0,3,3,0.044591,4,0.323126,0.363237,6083.12181
活捉(1948),活捉,notion,0,1,1,0,2,2,0.016518,4,0.278724,0.3015,0
活着(1948),活着,notion,0,1,1,0,1,1,0.009739,4,0.265806,0.279704,0
活跃(1948),活跃,notion,0,2,2,0,2,2,0.026269,4,0.293695,0.324415,1931.353166
派布(1948),派布,notion,0,1,1,0,1,1,0.009739,4,0.265806,0.279704,0
派系(1948),派系,notion,0,2,2,0,2,2,0.019972,4,0.283949,0.309807,2243.008915
流亡(1948),流亡,notion,0,3,3,0,4,4,0.018919,4,0.274568,0.294822,1295.743183
流传(1948),流传,notion,0,1,1,0,1,1,0.011322,4,0.269061,0.285394,0
流光(1948),流光,notion,0,1,1,0,1,1,0.009739,4,0.265806,0.279704,0
流动(1948),流动,notion,0,1,1,0,1,1,0.004718,4,0.258401,0.266227,0
流向(1948),流向,notion,0,1,1,0,2,2,0.002332,4,0.253398,0.256677,0
流星(1948),流星,notion,0,1,1,0,1,1,0.007515,4,0.262793,0.274313,0
流民(1948),流民,notion,0,1,1,0,1,1,0.008247,4,0.26379,0.27611,0
流氓(1948),流氓,notion,0,2,2,0,2,2,0.025562,4,0.293259,0.323783,2167.4723
流浪(1948),流浪,notion,0,1,1,0,1,1,0.016752,4,0.279138,0.302165,0
流火(1948),流火,notion,0,2,2,0,2,2,0.024999,4,0.291484,0.321188,1929.694181
流血(1948),流血,notion,0,2,2,0,4,4,0.01885,4,0.28146,0.305914,1156.716461
流行(1948),流行,notion,0,1,1,0,1,1,0.005017,4,0.257497,0.26453,0
流通券(1948),流通券,notion,0,1,1,0,1,1,0.011322,4,0.269061,0.285394,0
流露(1948),流露,notion,0,1,1,0,1,1,0.016752,4,0.279138,0.302165,0
浅评(1948),浅评,notion,0,1,1,0,1,1,0.016752,4,0.279138,0.302165,0
浅谈(1948),浅谈,notion,0,1,1,0,1,1,0.008247,4,0.26379,0.27611,0
测验(1948),测验,notion,0,1,1,0,1,1,0.011322,4,0.269061,0.285394,0
济慈(1948),济慈,notion,0,1,1,0,1,1,0.007515,4,0.262793,0.274313,0
浙大(1948),浙大,notion,0,5,5,0,5,5,0.059348,4,0.341422,0.384079,13830.771425
浙江(1948),浙江,notion,0,1,1,0,2,2,0.016752,4,0.279138,0.302165,0
浙省(1948),浙省,notion,0,1,1,0,1,1,0.004718,4,0.258401,0.266227,0
浠水(1948),浠水,notion,0,1,1,0,1,1,0.016518,4,0.278724,0.3015,0
浦口(1948),浦口,notion,0,1,1,0,1,1,0.011322,4,0.269061,0.285394,0
浩劫(1948),浩劫,notion,0,2,2,0,2,2,0.008698,4,0.258507,0.266483,0.569098
浪涛(1948),浪涛,notion,0,1,1,0,1,1,0.01424,4,0.275514,0.296275,0
浪潮(1948),浪潮,notion,0,2,2,0,2,2,0.033269,4,0.305692,0.34112,2297.98609
浪花(1948),浪花,notion,0,1,1,0,1,1,0.016752,4,0.279138,0.302165,0
浪费(1948),浪费,notion,0,1,1,0,1,1,0.01424,4,0.275514,0.296275,0
浮力(1948),浮力,notion,0,1,1,0,1,1,0.009739,4,0.265806,0.279704,0
浮华世界(1948),浮华世界,notion,0,1,1,0,1,1,0.01022,4,0.267243,0.282233,0
海丰(1948),海丰,notion,0,2,2,0,3,3,0.026269,4,0.293695,0.324415,1931.353166
海南(1948),海南,notion,0,1,1,0,1,1,0.009751,4,0.267186,0.282133,0
海南岛(1948),海南岛,notion,0,2,2,0,2,2,0.028074,4,0.296149,0.327943,1864.79583
海口(1948),海口,notion,0,1,1,0,1,1,0.009751,4,0.267186,0.282133,0
海外(1948),海外,notion,0,3,3,0,6,6,0.04751,4,0.331714,0.373253,8022.59349
海岛(1948),海岛,notion,0,1,1,0,1,1,0.005017,4,0.257497,0.26453,0
海德拉巴(1948),海德拉巴,notion,0,1,1,0,1,1,0.011322,4,0.269061,0.285394,0
海战(1948),海战,notion,0,1,1,0,1,1,0.016752,4,0.279138,0.302165,0
海村(1948),海村,notion,0,1,1,0,1,1,0.004718,4,0.258401,0.266227,0
海滨(1948),海滨,notion,0,1,1,0,1,1,0.008247,4,0.26379,0.27611,0
海王(1948),海王,notion,0,1,1,0,1,1,0.009755,4,0.266617,0.281135,0
海盗(1948),海盗,notion,0,1,1,0,1,1,0.016518,4,0.278724,0.3015,0
海船(1948),海船,notion,0,1,1,0,1,1,0.011322,4,0.269061,0.285394,0
海花(1948),海花,notion,0,1,1,0,1,1,0.01424,4,0.275514,0.296275,0
海运(1948),海运,notion,0,1,1,0,1,1,0.007515,4,0.262793,0.274313,0
海防(1948),海防,notion,0,1,1,0,1,1,0.01424,4,0.275514,0.296275,0
海隅(1948),海隅,notion,0,1,1,0,1,1,0.016752,4,0.279138,0.302165,0
消弭(1948),消弭,notion,0,2,2,0,2,2,0.024461,4,0.291756,0.321587,2304.72473
消息(1948),消息,notion,0,3,3,0,4,4,0.037987,4,0.314128,0.352156,7349.461704
消极(1948),消极,notion,0,1,1,0,1,1,0.011322,4,0.269061,0.285394,0
消灭(1948),消灭,notion,0,3,3,0,6,6,0.034516,4,0.306741,0.342573,5925.88426
消费者(1948),消费者,notion,0,1,1,0,1,1,0.011322,4,0.269061,0.285394,0
消逝(1948),消逝,notion,0,1,1,0,1,1,0.009739,4,0.265806,0.279704,0
消长(1948),消长,notion,0,1,1,0,1,1,0.016752,4,0.279138,0.302165,0
涉及(1948),涉及,notion,0,1,1,0,1,1,0.01424,4,0.275514,0.296275,0
涌之战(1948),涌之战,notion,0,1,1,0,1,1,0.009751,4,0.267186,0.282133,0
涨价(1948),涨价,notion,0,2,2,0,2,2,0.026972,4,0.293947,0.324781,1749.441854
涨到(1948),涨到,notion,0,1,1,0,1,1,0.009739,4,0.265806,0.279704,0
淡水(1948),淡水,notion,0,1,1,0,1,1,0.004718,4,0.258401,0.266227,0
淮上(1948),淮上,notion,0,1,1,0,1,1,0.016752,4,0.279138,0.302165,0
淮北(1948),淮北,notion,0,1,1,0,1,1,0.016752,4,0.279138,0.302165,0
淮河(1948),淮河,notion,0,1,1,0,1,1,0.016518,4,0.278724,0.3015,0
深入(1948),深入,notion,0,2,2,0,2,2,0.018958,4,0.283863,0.309674,3113.558811
深切(1948),深切,notion,0,2,2,0,2,2,0.008698,4,0.258507,0.266483,0.569098
深处(1948),深处,notion,0,1,1,0,1,1,0.01022,4,0.267243,0.282233,0
深放(1948),深放,notion,0,1,1,0,1,1,0.016752,4,0.279138,0.302165,0
深秋(1948),深秋,notion,0,1,1,0,1,1,0.016752,4,0.279138,0.302165,0
混乱(1948),混乱,notion,0,1,1,0,1,1,0.016518,4,0.278724,0.3015,0
混水摸鱼(1948),混水摸鱼,notion,0,1,1,0,1,1,0.016752,4,0.279138,0.302165,0
清初(1948),清初,notion,0,1,1,0,1,1,0.01424,4,0.275514,0.296275,0
清剿(1948),清剿,notion,0,1,1,0,1,1,0.01022,4,0.267243,0.282233,0
清华(1948),清华,notion,0,3,3,0,4,4,0.02645,4,0.29029,0.31948,3090.00099
清华北大(1948),清华北大,notion,0,1,1,0,1,1,0.007515,4,0.262793,0.274313,0
清华园(1948),清华园,notion,0,3,3,0,4,4,0.044591,4,0.323126,0.363237,6083.12181
清华大学(1948),清华大学,notion,0,3,3,0,3,3,0.034739,4,0.304503,0.339578,4684.566207
清单(1948),清单,notion,0,1,1,0,2,2,0.01022,4,0.267243,0.282233,0
清吏(1948),清吏,notion,0,1,1,0,1,1,0.005389,4,0.25849,0.266394,0
清寒(1948),清寒,notion,0,2,2,0,2,2,0.02398,4,0.290133,0.319191,1998.682918
清才(1948),清才,notion,0,1,1,0,1,1,0.01424,4,0.275514,0.296275,0
清晰(1948),清晰,notion,0,1,1,0,1,1,0.01022,4,0.267243,0.282233,0
清末(1948),清末,notion,0,1,1,0,1,1,0.005389,4,0.25849,0.266394,0
清楚(1948),清楚,notion,0,2,2,0,2,2,0.01727,4,0.278352,0.300956,1619.09855
清算(1948),清算,notion,0,3,3,0,3,3,0.038287,4,0.310827,0.34793,4250.67334
清谈家(1948),清谈家,notion,0,1,1,0,1,1,0.016518,4,0.278724,0.3015,0
清远(1948),清远,notion,0,1,1,0,1,1,0.009751,4,0.267186,0.282133,0
清除(1948),清除,notion,0,1,1,0,1,1,0.01424,4,0.275514,0.296275,0
渍水(1948),渍水,notion,0,1,1,0,1,1,0.01022,4,0.267243,0.282233,0
渐变(1948),渐变,notion,0,2,2,0,2,2,0.026972,4,0.293947,0.324781,1749.441854
渐臻(1948),渐臻,notion,0,1,1,0,1,1,0.016752,4,0.279138,0.302165,0
渔业(1948),渔业,notion,0,1,1,0,3,3,0.004718,4,0.258401,0.266227,0
渔民(1948),渔民,notion,0,2,2,0,2,2,0.021469,4,0.287095,0.314632,2527.522512
渡江(1948),渡江,notion,0,3,3,0,5,5,0.034985,4,0.307418,0.343471,5704.202313
渡过(1948),渡过,notion,0,1,1,0,1,1,0.01424,4,0.275514,0.296275,0
温和派(1948),温和派,notion,0,2,2,0,2,2,0.008698,4,0.258507,0.266483,0.569098
温度表(1948),温度表,notion,0,1,1,0,1,1,0.016752,4,0.279138,0.302165,0
温情(1948),温情,notion,0,1,1,0,1,1,0.016752,4,0.279138,0.302165,0
温故而知新(1948),温故而知新,notion,0,1,1,0,1,1,0.008247,4,0.26379,0.27611,0
温饱(1948),温饱,notion,0,1,1,0,1,1,0.005017,4,0.257497,0.26453,0
港九(1948),港九,notion,0,2,2,0,2,2,0.017255,4,0.277263,0.299193,1338.862931
港币(1948),港币,notion,0,1,1,0,1,1,0.011322,4,0.269061,0.285394,0
港报(1948),港报,notion,0,1,1,0,1,1,0.016752,4,0.279138,0.302165,0
港方(1948),港方,notion,0,1,1,0,1,1,0.016752,4,0.279138,0.302165,0
港星(1948),港星,notion,0,1,1,0,2,2,0.016752,4,0.279138,0.302165,0
游击区(1948),游击区,notion,0,2,2,0,3,3,0.026269,4,0.293695,0.324415,1931.353166
游击队(1948),游击队,notion,0,2,2,0,2,2,0.019494,4,0.280535,0.30445,1251.270065
游心影(1948),游心影,notion,0,1,1,0,1,1,0.01424,4,0.275514,0.296275,0
游日(1948),游日,notion,0,1,1,0,1,1,0.01022,4,0.267243,0.282233,0
游牧民族(1948),游牧民族,notion,0,1,1,0,1,1,0.01424,4,0.275514,0.296275,0
渺茫(1948),渺茫,notion,0,1,1,0,1,1,0.005389,4,0.25849,0.266394,0
湄南河(1948),湄南河,notion,0,1,1,0,1,1,0.016518,4,0.278724,0.3015,0
湖上(1948),湖上,notion,0,1,1,0,1,1,0.01424,4,0.275514,0.296275,0
湖北(1948),湖北,notion,0,1,1,0,1,1,0.01022,4,0.267243,0.282233,0
湖北省(1948),湖北省,notion,0,1,1,0,1,1,0.007515,4,0.262793,0.274313,0
湘东(1948),湘东,notion,0,1,1,0,1,1,0.016752,4,0.279138,0.302165,0
湘军(1948),湘军,notion,0,1,1,0,1,1,0.007515,4,0.262793,0.274313,0
湘政(1948),湘政,notion,0,1,1,0,1,1,0.005389,4,0.25849,0.266394,0
湘粤赣(1948),湘粤赣,notion,0,1,1,0,1,1,0.009751,4,0.267186,0.282133,0
湘鄂(1948),湘鄂,notion,0,1,1,0,1,1,0.01022,4,0.267243,0.282233,0
湛江(1948),湛江,notion,0,1,1,0,2,2,0.009751,4,0.267186,0.282133,0
溃疡(1948),溃疡,notion,0,1,1,0,1,1,0.011322,4,0.269061,0.285394,0
溃败(1948),溃败,notion,0,1,1,0,1,1,0.016518,4,0.278724,0.3015,0
源头(1948),源头,notion,0,1,1,0,1,1,0.008247,4,0.26379,0.27611,0
滇南(1948),滇南,notion,0,1,1,0,1,1,0.01424,4,0.275514,0.296275,0
滇情(1948),滇情,notion,0,1,1,0,1,1,0.016752,4,0.279138,0.302165,0
滇西(1948),滇西,notion,0,2,2,0,2,2,0.017736,4,0.278993,0.301988,1631.559673
滑稽(1948),滑稽,notion,0,1,1,0,1,1,0.01424,4,0.275514,0.296275,0
滚出去(1948),滚出去,notion,0,1,1,0,1,1,0.016518,4,0.278724,0.3015,0
满天(1948),满天,notion,0,1,1,0,1,1,0.016752,4,0.279138,0.302165,0
滥发(1948),滥发,notion,0,2,2,0,2,2,0.015763,4,0.275232,0.295865,1348.309636
滥炸(1948),滥炸,notion,0,2,2,0,2,2,0.008698,4,0.258507,0.266483,0.569098
滥用(1948),滥用,notion,0,1,1,0,1,1,0.008247,4,0.26379,0.27611,0
滨湖(1948),滨湖,notion,0,1,1,0,1,1,0.01424,4,0.275514,0.296275,0
漏题(1948),漏题,notion,0,1,1,0,1,1,0.011322,4,0.269061,0.285394,0
演出(1948),演出,notion,0,1,1,0,1,1,0.009751,4,0.267186,0.282133,0
演出成功(1948),演出成功,notion,0,1,1,0,1,1,0.009751,4,0.267186,0.282133,0
演变(1948),演变,notion,0,3,3,0,3,3,0.033747,4,0.308758,0.345235,7565.717635
演奏会(1948),演奏会,notion,0,1,1,0,1,1,0.016752,4,0.279138,0.302165,0
演讲(1948),演讲,notion,0,3,3,0,5,5,0.033772,4,0.304503,0.339578,5420.300526
演讲稿(1948),演讲稿,notion,0,1,1,0,1,1,0.008247,4,0.26379,0.27611,0
演讲词(1948),演讲词,notion,0,1,1,0,1,1,0.016752,4,0.279138,0.302165,0
演说辞(1948),演说辞,notion,0,1,1,0,1,1,0.009755,4,0.266617,0.281135,0
漠北(1948),漠北,notion,0,1,1,0,1,1,0.007515,4,0.262793,0.274313,0
漫淡(1948),漫淡,notion,0,1,1,0,1,1,0.01022,4,0.267243,0.282233,0
潘光旦(1948),潘光旦,notion,0,2,2,0,4,4,0.016711,4,0.276081,0.297263,848.405205
潜能(1948),潜能,notion,0,1,1,0,1,1,0.008247,4,0.26379,0.27611,0
潮州(1948),潮州,notion,0,1,1,0,3,3,0.009751,4,0.267186,0.282133,0
潮梅(1948),潮梅,notion,0,1,1,0,1,1,0.009751,4,0.267186,0.282133,0
潮汕(1948),潮汕,notion,0,2,2,0,3,3,0.026269,4,0.293695,0.324415,1931.353166
潮洲(1948),潮洲,notion,0,1,1,0,2,2,0.009751,4,0.267186,0.282133,0
澎湃(1948),澎湃,notion,0,1,1,0,1,1,0.009739,4,0.265806,0.279704,0
激化(1948),激化,notion,0,1,1,0,1,1,0.016752,4,0.279138,0.302165,0
激发(1948),激发,notion,0,1,1,0,2,2,0.01424,4,0.275514,0.296275,0
激增(1948),激增,notion,0,1,1,0,1,1,0.008247,4,0.26379,0.27611,0
激战(1948),激战,notion,0,1,1,0,1,1,0.016752,4,0.279138,0.302165,0
激流(1948),激流,notion,0,1,1,0,1,1,0.016518,4,0.278724,0.3015,0
激荡(1948),激荡,notion,0,2,2,0,2,2,0.01996,4,0.281333,0.305715,1305.273912
激起(1948),激起,notion,0,1,1,0,1,1,0.011322,4,0.269061,0.285394,0
激速(1948),激速,notion,0,1,1,0,1,1,0.011322,4,0.269061,0.285394,0
濒死(1948),濒死,notion,0,1,1,0,1,1,0.016518,4,0.278724,0.3015,0
瀚海(1948),瀚海,notion,0,1,1,0,1,1,0.002332,4,0.253398,0.256677,0
瀰漫(1948),瀰漫,notion,0,1,1,0,1,1,0.011322,4,0.269061,0.285394,0
灌云(1948),灌云,notion,0,2,2,0,2,2,0.026491,4,0.291937,0.321853,1403.825067
灌输(1948),灌输,notion,0,1,1,0,1,1,0.002332,4,0.253398,0.256677,0
火併(1948),火併,notion,0,1,1,0,1,1,0.016518,4,0.278724,0.3015,0
火山(1948),火山,notion,0,1,1,0,1,1,0.016752,4,0.279138,0.302165,0
火柴(1948),火柴,notion,0,2,2,0,2,2,0.021073,4,0.285785,0.312636,2242.44705
火烧(1948),火烧,notion,0,3,3,0,3,3,0.036478,4,0.30767,0.343804,4821.551069
火种(1948),火种,notion,0,2,2,0,2,2,0.021535,4,0.28397,0.309841,889.229879
火药味(1948),火药味,notion,0,2,2,0,2,2,0.028074,4,0.296149,0.327943,1864.79583
火车头(1948),火车头,notion,0,1,1,0,1,1,0.016518,4,0.278724,0.3015,0
灭亡(1948),灭亡,notion,0,2,2,0,4,4,0.030758,4,0.303347,0.337959,2812.221703
灯塔(1948),灯塔,notion,0,1,1,0,1,1,0.016518,4,0.278724,0.3015,0
灰心(1948),灰心,notion,0,1,1,0,1,1,0.016752,4,0.279138,0.302165,0
灰暗(1948),灰暗,notion,0,1,1,0,1,1,0.016518,4,0.278724,0.3015,0
灵崖山(1948),灵崖山,notion,0,1,1,0,1,1,0.01424,4,0.275514,0.296275,0
灵活(1948),灵活,notion,0,1,1,0,1,1,0.016518,4,0.278724,0.3015,0
灵魂(1948),灵魂,notion,0,2,2,0,2,2,0.024033,4,0.291281,0.320888,2559.028705
灼灼(1948),灼灼,notion,0,1,1,0,1,1,0.016752,4,0.279138,0.302165,0
灾况(1948),灾况,notion,0,1,1,0,1,1,0.016752,4,0.279138,0.302165,0
灾区(1948),灾区,notion,0,1,1,0,1,1,0.009739,4,0.265806,0.279704,0
灾害(1948),灾害,notion,0,1,1,0,1,1,0.009739,4,0.265806,0.279704,0
灾民(1948),灾民,notion,0,2,2,0,2,2,0.026269,4,0.293695,0.324415,1931.353166
灾难(1948),灾难,notion,0,3,3,0,5,5,0.044591,4,0.323126,0.363237,6083.12181
灾黎(1948),灾黎,notion,0,1,1,0,1,1,0.016752,4,0.279138,0.302165,0
炎热(1948),炎热,notion,0,1,1,0,1,1,0.016752,4,0.279138,0.302165,0
炮声(1948),炮声,notion,0,1,1,0,1,1,0.016518,4,0.278724,0.3015,0
炮灰(1948),炮灰,notion,0,1,1,0,1,1,0.01022,4,0.267243,0.282233,0
炸药(1948),炸药,notion,0,1,1,0,1,1,0.009751,4,0.267186,0.282133,0
点将(1948),点将,notion,0,1,1,0,1,1,0.011322,4,0.269061,0.285394,0
点滴(1948),点滴,notion,0,2,2,0,2,2,0.024765,4,0.291552,0.321288,2097.245087
炼狱(1948),炼狱,notion,0,2,2,0,2,2,0.019975,4,0.283071,0.308443,1854.710834
烂污(1948),烂污,notion,0,2,2,0,2,2,0.028074,4,0.296149,0.327943,1864.79583
烈士(1948),烈士,notion,0,1,1,0,1,1,0.009751,4,0.267186,0.282133,0
烟幕(1948),烟幕,notion,0,4,4,0,4,4,0.052764,4,0.333274,0.375072,10282.282394
烟沙吞去(1948),烟沙吞去,notion,0,1,1,0,1,1,0.009751,4,0.267186,0.282133,0
烦恼(1948),烦恼,notion,0,2,2,0,2,2,0.028074,4,0.296149,0.327943,1864.79583
烧成灰(1948),烧成灰,notion,0,1,1,0,1,1,0.016518,4,0.278724,0.3015,0
热情(1948),热情,notion,0,1,1,0,1,1,0.016518,4,0.278724,0.3015,0
热战(1948),热战,notion,0,1,1,0,1,1,0.008247,4,0.26379,0.27611,0
热河(1948),热河,notion,0,1,1,0,1,1,0.007515,4,0.262793,0.274313,0
热潮(1948),热潮,notion,0,3,3,0,5,5,0.043021,4,0.321604,0.361407,6898.300577
热烈(1948),热烈,notion,0,2,2,0,2,2,0.026972,4,0.293947,0.324781,1749.441854
热烈庆祝(1948),热烈庆祝,notion,0,1,1,0,1,1,0.01424,4,0.275514,0.296275,0
烽烟(1948),烽烟,notion,0,1,1,0,2,2,0.016752,4,0.279138,0.302165,0
焉用(1948),焉用,notion,0,1,1,0,1,1,0.01424,4,0.275514,0.296275,0
焚宪(1948),焚宪,notion,0,1,1,0,1,1,0.009739,4,0.265806,0.279704,0
焦急(1948),焦急,notion,0,1,1,0,1,1,0.009739,4,0.265806,0.279704,0
焦点(1948),焦点,notion,0,2,2,0,2,2,0.02398,4,0.290133,0.319191,1998.682918
焦虑(1948),焦虑,notion,0,1,1,0,1,1,0.004718,4,0.258401,0.266227,0
焦躁(1948),焦躁,notion,0,1,1,0,1,1,0.016518,4,0.278724,0.3015,0
然后(1948),然后,notion,0,1,1,0,1,1,0.008247,4,0.26379,0.27611,0
煎熬(1948),煎熬,notion,0,1,1,0,1,1,0.016518,4,0.278724,0.3015,0
煤商(1948),煤商,notion,0,1,1,0,1,1,0.004718,4,0.258401,0.266227,0
照办(1948),照办,notion,0,1,1,0,1,1,0.01424,4,0.275514,0.296275,0
照妖镜(1948),照妖镜,notion,0,1,1,0,1,1,0.01424,4,0.275514,0.296275,0
照登(1948),照登,notion,0,2,2,0,2,2,0.028074,4,0.296149,0.327943,1864.79583
熬炼(1948),熬炼,notion,0,1,1,0,1,1,0.011322,4,0.269061,0.285394,0
燃遍(1948),燃遍,notion,0,1,1,0,1,1,0.016518,4,0.278724,0.3015,0
燎原(1948),燎原,notion,0,1,1,0,1,1,0.016752,4,0.279138,0.302165,0
燕京(1948),燕京,notion,0,3,3,0,4,4,0.03806,4,0.311162,0.348363,5324.627604
燕京大学(1948),燕京大学,notion,0,1,1,0,2,2,0.01022,4,0.267243,0.282233,0
燕园(1948),燕园,notion,0,1,1,0,1,1,0.016752,4,0.279138,0.302165,0
燕赵(1948),燕赵,notion,0,1,1,0,1,1,0.01424,4,0.275514,0.296275,0
爆发(1948),爆发,notion,0,1,1,0,1,1,0.016518,4,0.278724,0.3015,0
爆炸(1948),爆炸,notion,0,1,1,0,1,1,0.011322,4,0.269061,0.285394,0
爪牙(1948),爪牙,notion,0,1,1,0,2,2,0.016518,4,0.278724,0.3015,0
爱伦堡(1948),爱伦堡,notion,0,1,1,0,1,1,0.009755,4,0.266617,0.281135,0
爱因斯坦(1948),爱因斯坦,notion,0,1,1,0,1,1,0.009755,4,0.266617,0.281135,0
爱国运动(1948),爱国运动,notion,0,1,1,0,1,1,0.016518,4,0.278724,0.3015,0
爱子(1948),爱子,notion,0,1,1,0,1,1,0.009755,4,0.266617,0.281135,0
爱护(1948),爱护,notion,0,1,1,0,1,1,0.009751,4,0.267186,0.282133,0
爲主(1948),爲主,notion,0,1,1,0,1,1,0.016518,4,0.278724,0.3015,0
爵溪(1948),爵溪,notion,0,1,1,0,1,1,0.016752,4,0.279138,0.302165,0
父亲(1948),父亲,notion,0,1,1,0,1,1,0.009751,4,0.267186,0.282133,0
父母心(1948),父母心,notion,0,1,1,0,1,1,0.016752,4,0.279138,0.302165,0
爸妈(1948),爸妈,notion,0,1,1,0,1,1,0.011322,4,0.269061,0.285394,0
片山(1948),片山,notion,0,2,2,0,2,2,0.021061,4,0.283157,0.308576,1336.570675
片断(1948),片断,notion,0,2,2,0,2,2,0.021076,4,0.284616,0.310839,1735.877057
牛后(1948),牛后,notion,0,1,1,0,1,1,0.016752,4,0.279138,0.302165,0
牛油(1948),牛油,notion,0,1,1,0,1,1,0.009755,4,0.266617,0.281135,0
牛皮(1948),牛皮,notion,0,1,1,0,1,1,0.016518,4,0.278724,0.3015,0
牛郎织女(1948),牛郎织女,notion,0,1,1,0,1,1,0.008247,4,0.26379,0.27611,0
牢狱(1948),牢狱,notion,0,1,1,0,1,1,0.011322,4,0.269061,0.285394,0
物价上涨(1948),物价上涨,notion,0,2,2,0,2,2,0.018468,4,0.27997,0.303552,1613.088959
物价指数(1948),物价指数,notion,0,2,2,0,3,3,0.019569,4,0.280598,0.30455,1193.220239
物价政策(1948),物价政策,notion,0,1,1,0,1,1,0.01022,4,0.267243,0.282233,0
物价管制(1948),物价管制,notion,0,2,2,0,2,2,0.025562,4,0.293259,0.323783,2167.4723
物价飞涨(1948),物价飞涨,notion,0,1,1,0,2,2,0.01424,4,0.275514,0.296275,0
物品(1948),物品,notion,0,1,1,0,1,1,0.01424,4,0.275514,0.296275,0
物质(1948),物质,notion,0,1,1,0,1,1,0.009755,4,0.266617,0.281135,0
物资(1948),物资,notion,0,4,4,0,5,5,0.044629,4,0.324074,0.364424,10533.167523
物资交流(1948),物资交流,notion,0,2,2,0,2,2,0.008698,4,0.258507,0.266483,0.569098
牯岭(1948),牯岭,notion,0,1,1,0,1,1,0.016518,4,0.278724,0.3015,0
特价(1948),特价,notion,0,1,1,0,1,1,0.01424,4,0.275514,0.296275,0
特写(1948),特写,notion,0,1,1,0,1,1,0.009739,4,0.265806,0.279704,0
特别(1948),特别,notion,0,1,1,0,1,1,0.009755,4,0.266617,0.281135,0
特务(1948),特务,notion,0,2,2,0,4,4,0.021535,4,0.28397,0.309841,889.229879
特征(1948),特征,notion,0,2,2,0,4,4,0.019975,4,0.283071,0.308443,1854.710834
特徵(1948),特徵,notion,0,1,1,0,1,1,0.008247,4,0.26379,0.27611,0
特捐(1948),特捐,notion,0,4,4,0,7,7,0.050718,4,0.333689,0.375538,11937.18042
特此(1948),特此,notion,0,2,2,0,2,2,0.008698,4,0.258507,0.266483,0.569098
特点(1948),特点,notion,0,1,1,0,1,1,0.009751,4,0.267186,0.282133,0
特种(1948),特种,notion,0,4,4,0,4,4,0.044959,4,0.319988,0.359499,9352.370932
特稿(1948),特稿,notion,0,1,1,0,2,2,0.01424,4,0.275514,0.296275,0
特讯(1948),特讯,notion,0,1,1,0,1,1,0.016752,4,0.279138,0.302165,0
牺牲(1948),牺牲,notion,0,2,2,0,2,2,0.019569,4,0.280598,0.30455,1193.220239
牺牲品(1948),牺牲品,notion,0,1,1,0,1,1,0.008247,4,0.26379,0.27611,0
牺牲者(1948),牺牲者,notion,0,1,1,0,1,1,0.01424,4,0.275514,0.296275,0
犯法(1948),犯法,notion,0,1,1,0,1,1,0.011322,4,0.269061,0.285394,0
状况(1948),状况,notion,0,2,2,0,3,3,0.030758,4,0.303347,0.337959,2812.221703
状态(1948),状态,notion,0,1,1,0,1,1,0.01424,4,0.275514,0.296275,0
犹太人(1948),犹太人,notion,0,1,1,0,1,1,0.01022,4,0.267243,0.282233,0
狂吠(1948),狂吠,notion,0,1,1,0,1,1,0.01424,4,0.275514,0.296275,0
狂妄(1948),狂妄,notion,0,2,2,0,2,2,0.016711,4,0.276081,0.297263,848.405205
狂想曲(1948),狂想曲,notion,0,1,1,0,1,1,0.009755,4,0.266617,0.281135,0
狂澜(1948),狂澜,notion,0,1,1,0,1,1,0.011322,4,0.269061,0.285394,0
狄托(1948),狄托,notion,0,1,1,0,2,2,0.01424,4,0.275514,0.296275,0
狗争(1948),狗争,notion,0,1,1,0,1,1,0.016518,4,0.278724,0.3015,0
狗官(1948),狗官,notion,0,1,1,0,1,1,0.009751,4,0.267186,0.282133,0
独占(1948),独占,notion,0,2,2,0,4,4,0.018002,4,0.27945,0.30272,1656.832374
独立(1948),独立,notion,0,8,8,0,10,10,0.079144,4,0.377633,0.419351,38860.14956
独立国(1948),独立国,notion,0,1,1,0,1,1,0.011322,4,0.269061,0.285394,0
独立战争(1948),独立战争,notion,0,2,2,0,2,2,0.026507,4,0.294224,0.325181,2012.895914
独立自主(1948),独立自主,notion,0,1,1,0,1,1,0.009755,4,0.266617,0.281135,0
独立运动(1948),独立运动,notion,0,1,1,0,1,1,0.009739,4,0.265806,0.279704,0
独脚戏(1948),独脚戏,notion,0,1,1,0,1,1,0.016518,4,0.278724,0.3015,0
独裁(1948),独裁,notion,0,1,1,0,1,1,0.008247,4,0.26379,0.27611,0
独裁者(1948),独裁者,notion,0,1,1,0,1,1,0.005017,4,0.257497,0.26453,0
狭路相逢(1948),狭路相逢,notion,0,1,1,0,1,1,0.011322,4,0.269061,0.285394,0
狱中(1948),狱中,notion,0,1,1,0,1,1,0.009739,4,0.265806,0.279704,0
狱囚(1948),狱囚,notion,0,1,1,0,1,1,0.011322,4,0.269061,0.285394,0
狼来了(1948),狼来了,notion,0,1,1,0,1,1,0.009751,4,0.267186,0.282133,0
猖狂(1948),猖狂,notion,0,1,1,0,1,1,0.009751,4,0.267186,0.282133,0
猖獗(1948),猖獗,notion,0,1,1,0,1,1,0.016752,4,0.279138,0.302165,0
猪仔(1948),猪仔,notion,0,1,1,0,1,1,0.016518,4,0.278724,0.3015,0
猫腻(1948),猫腻,notion,0,1,1,0,1,1,0.004718,4,0.258401,0.266227,0
献给(1948),献给,notion,0,4,4,0,4,4,0.035201,4,0.303005,0.337604,6071.924526
献词(1948),献词,notion,0,1,1,0,1,1,0.009751,4,0.267186,0.282133,0
献身(1948),献身,notion,0,1,1,0,1,1,0.004718,4,0.258401,0.266227,0
献辞(1948),献辞,notion,0,2,2,0,2,2,0.021907,4,0.286133,0.313168,1304.9596
献金(1948),献金,notion,0,2,2,0,2,2,0.023992,4,0.29271,0.322985,3168.205568
獠牙(1948),獠牙,notion,0,1,1,0,1,1,0.01424,4,0.275514,0.296275,0
率师(1948),率师,notion,0,1,1,0,1,1,0.016518,4,0.278724,0.3015,0
玉山(1948),玉山,notion,0,1,1,0,1,1,0.016518,4,0.278724,0.3015,0
玉皇山(1948),玉皇山,notion,0,1,1,0,1,1,0.01424,4,0.275514,0.296275,0
王东原(1948),王东原,notion,0,1,1,0,1,1,0.01022,4,0.267243,0.282233,0
王云五(1948),王云五,notion,0,1,1,0,1,1,0.007515,4,0.262793,0.274313,0
王凤岗(1948),王凤岗,notion,0,1,1,0,1,1,0.009751,4,0.267186,0.282133,0
王叔文(1948),王叔文,notion,0,1,1,0,1,1,0.007515,4,0.262793,0.274313,0
王孝和(1948),王孝和,notion,0,1,1,0,1,1,0.016518,4,0.278724,0.3015,0
王庭(1948),王庭,notion,0,1,1,0,1,1,0.01424,4,0.275514,0.296275,0
王怀勳(1948),王怀勳,notion,0,1,1,0,1,1,0.005017,4,0.257497,0.26453,0
王揖唐(1948),王揖唐,notion,0,1,1,0,1,1,0.007515,4,0.262793,0.274313,0
王牌(1948),王牌,notion,0,2,2,0,3,3,0.033269,4,0.305692,0.34112,2297.98609
王立明(1948),王立明,notion,0,1,1,0,1,1,0.01424,4,0.275514,0.296275,0
王艮仲(1948),王艮仲,notion,0,1,1,0,1,1,0.004718,4,0.258401,0.266227,0
王芸生(1948),王芸生,notion,0,2,2,0,2,2,0.025562,4,0.293259,0.323783,2167.4723
王阳明(1948),王阳明,notion,0,1,1,0,1,1,0.01424,4,0.275514,0.296275,0
王陵基(1948),王陵基,notion,0,1,1,0,1,1,0.016752,4,0.279138,0.302165,0
玛瑙(1948),玛瑙,notion,0,1,1,0,1,1,0.011322,4,0.269061,0.285394,0
玩弄(1948),玩弄,notion,0,1,1,0,1,1,0.016752,4,0.279138,0.302165,0
环境(1948),环境,notion,0,1,1,0,1,1,0.011322,4,0.269061,0.285394,0
现代(1948),现代,notion,0,7,7,0,10,10,0.058676,4,0.341236,0.38399,26733.67221
现代文明(1948),现代文明,notion,0,1,1,0,1,1,0.002332,4,0.253398,0.256677,0
现势(1948),现势,notion,0,2,2,0,2,2,0.027839,4,0.295962,0.327676,1920.33989
现在(1948),现在,notion,0,5,5,0,5,5,0.047703,4,0.324353,0.364812,12461.349225
现实主义(1948),现实主义,notion,0,2,2,0,2,2,0.008698,4,0.258507,0.266483,0.569098
现局(1948),现局,notion,0,1,1,0,1,1,0.01022,4,0.267243,0.282233,0
现已(1948),现已,notion,0,2,2,0,2,2,0.025562,4,0.293259,0.323783,2167.4723
现形记(1948),现形记,notion,0,1,1,0,1,1,0.01022,4,0.267243,0.282233,0
现政府(1948),现政府,notion,0,1,1,0,1,1,0.008247,4,0.26379,0.27611,0
现状(1948),现状,notion,0,4,4,0,5,5,0.050486,4,0.333186,0.374972,12072.791745
现行(1948),现行,notion,0,2,2,0,2,2,0.019569,4,0.280598,0.30455,1193.220239
现象(1948),现象,notion,0,1,1,0,1,1,0.009751,4,0.267186,0.282133,0
现阶段(1948),现阶段,notion,0,4,4,0,4,4,0.033843,4,0.305469,0.340931,8769.401478
玻里(1948),玻里,notion,0,1,1,0,1,1,0.007515,4,0.262793,0.274313,0
珍惜(1948),珍惜,notion,0,1,1,0,1,1,0.016752,4,0.279138,0.302165,0
珠江(1948),珠江,notion,0,1,1,0,1,1,0.008247,4,0.26379,0.27611,0
理事会(1948),理事会,notion,0,3,3,0,3,3,0.029324,4,0.296125,0.327965,4585.929671
理学(1948),理学,notion,0,1,1,0,1,1,0.007515,4,0.262793,0.274313,0
理工(1948),理工,notion,0,1,1,0,1,1,0.016752,4,0.279138,0.302165,0
理应(1948),理应,notion,0,1,1,0,1,1,0.01424,4,0.275514,0.296275,0
理性(1948),理性,notion,0,2,2,0,2,2,0.012233,4,0.270573,0.288045,1678.569586
理想(1948),理想,notion,0,2,2,0,3,3,0.022488,4,0.288152,0.31623,2102.825587
理由(1948),理由,notion,0,1,1,0,1,1,0.01022,4,0.267243,0.282233,0
理论(1948),理论,notion,0,3,3,0,4,4,0.040513,4,0.31882,0.358013,7099.850156
理论家(1948),理论家,notion,0,1,1,0,1,1,0.009755,4,0.266617,0.281135,0
琉球(1948),琉球,notion,0,1,1,0,1,1,0.008247,4,0.26379,0.27611,0
琐谈(1948),琐谈,notion,0,1,1,0,1,1,0.016752,4,0.279138,0.302165,0
琼州(1948),琼州,notion,0,1,1,0,1,1,0.016752,4,0.279138,0.302165,0
瑞士人(1948),瑞士人,notion,0,1,1,0,1,1,0.008247,4,0.26379,0.27611,0
瓜分(1948),瓜分,notion,0,1,1,0,1,1,0.007515,4,0.262793,0.274313,0
瓦尔(1948),瓦尔,notion,0,1,1,0,1,1,0.009751,4,0.267186,0.282133,0
瓦尔瓦(1948),瓦尔瓦,notion,0,1,1,0,1,1,0.009751,4,0.267186,0.282133,0
瓦解(1948),瓦解,notion,0,2,2,0,2,2,0.026503,4,0.295799,0.327444,2668.961321
生于(1948),生于,notion,0,1,1,0,1,1,0.009755,4,0.266617,0.281135,0
生产者(1948),生产者,notion,0,1,1,0,1,1,0.011322,4,0.269061,0.285394,0
生产能力(1948),生产能力,notion,0,1,1,0,1,1,0.008247,4,0.26379,0.27611,0
生力军(1948),生力军,notion,0,1,1,0,1,1,0.009755,4,0.266617,0.281135,0
生命(1948),生命,notion,0,2,2,0,2,2,0.023992,4,0.29271,0.322985,3168.205568
生意经(1948),生意经,notion,0,1,1,0,1,1,0.011322,4,0.269061,0.285394,0
生括(1948),生括,notion,0,1,1,0,1,1,0.016518,4,0.278724,0.3015,0
生日(1948),生日,notion,0,1,1,0,1,1,0.007515,4,0.262793,0.274313,0
生死(1948),生死,notion,0,1,1,0,1,1,0.011322,4,0.269061,0.285394,0
生死存亡(1948),生死存亡,notion,0,1,1,0,1,1,0.01424,4,0.275514,0.296275,0
生气(1948),生气,notion,0,1,1,0,1,1,0.016518,4,0.278724,0.3015,0
生活态度(1948),生活态度,notion,0,1,1,0,1,1,0.016752,4,0.279138,0.302165,0
生活水准(1948),生活水准,notion,0,1,1,0,1,1,0.009755,4,0.266617,0.281135,0
生物科学(1948),生物科学,notion,0,1,1,0,1,1,0.004718,4,0.258401,0.266227,0
生育(1948),生育,notion,0,2,2,0,2,2,0.019569,4,0.280598,0.30455,1193.220239
生路(1948),生路,notion,0,1,1,0,1,1,0.004718,4,0.258401,0.266227,0
生长(1948),生长,notion,0,1,1,0,1,1,0.004718,4,0.258401,0.266227,0
用到(1948),用到,notion,0,1,1,0,1,1,0.011322,4,0.269061,0.285394,0
用纸(1948),用纸,notion,0,1,1,0,1,1,0.009751,4,0.267186,0.282133,0
田鸡(1948),田鸡,notion,0,1,1,0,1,1,0.004718,4,0.258401,0.266227,0
由下(1948),由下,notion,0,1,1,0,1,1,0.01022,4,0.267243,0.282233,0
由口(1948),由口,notion,0,1,1,0,1,1,0.008247,4,0.26379,0.27611,0
由史(1948),由史,notion,0,1,1,0,1,1,0.01022,4,0.267243,0.282233,0
由扬(1948),由扬,notion,0,1,1,0,1,1,0.01022,4,0.267243,0.282233,0
由衷之言(1948),由衷之言,notion,0,1,1,0,1,1,0.01022,4,0.267243,0.282233,0
甲申(1948),甲申,notion,0,1,1,0,1,1,0.007515,4,0.262793,0.274313,0
申九(1948),申九,notion,0,1,1,0,1,1,0.009739,4,0.265806,0.279704,0
申冤(1948),申冤,notion,0,1,1,0,1,1,0.009751,4,0.267186,0.282133,0
申新(1948),申新,notion,0,3,3,0,3,3,0.036009,4,0.307318,0.343338,5103.645801
申论(1948),申论,notion,0,2,2,0,2,2,0.017987,4,0.278331,0.300923,1351.046959
申霁的巴(1948),申霁的巴,notion,0,1,1,0,1,1,0.016518,4,0.278724,0.3015,0
电令(1948),电令,notion,0,1,1,0,1,1,0.016752,4,0.279138,0.302165,0
电力(1948),电力,notion,0,1,1,0,1,1,0.016752,4,0.279138,0.302165,0
电加工(1948),电加工,notion,0,1,1,0,1,1,0.009739,4,0.265806,0.279704,0
电厂(1948),电厂,notion,0,1,1,0,1,1,0.016518,4,0.278724,0.3015,0
电影(1948),电影,notion,0,4,4,0,8,8,0.052776,4,0.337193,0.379431,12608.87284
电影业(1948),电影业,notion,0,1,1,0,1,1,0.011322,4,0.269061,0.285394,0
电映(1948),电映,notion,0,1,1,0,1,1,0.009751,4,0.267186,0.282133,0
电覆(1948),电覆,notion,0,1,1,0,2,2,0.016518,4,0.278724,0.3015,0
电讯(1948),电讯,notion,0,1,1,0,1,1,0.016752,4,0.279138,0.302165,0
电贺(1948),电贺,notion,0,1,1,0,1,1,0.016518,4,0.278724,0.3015,0
画刊(1948),画刊,notion,0,1,1,0,1,1,0.01424,4,0.275514,0.296275,0
画家(1948),画家,notion,0,3,3,0,3,3,0.018453,4,0.274528,0.294756,1725.62382
画报(1948),画报,notion,0,1,1,0,1,1,0.01424,4,0.275514,0.296275,0
画皮(1948),画皮,notion,0,2,2,0,2,2,0.019258,4,0.282157,0.307012,1389.971062
画面(1948),画面,notion,0,1,1,0,1,1,0.016518,4,0.278724,0.3015,0
留在(1948),留在,notion,0,1,1,0,1,1,0.009751,4,0.267186,0.282133,0
留学生(1948),留学生,notion,0,1,1,0,1,1,0.011322,4,0.269061,0.285394,0
留恋(1948),留恋,notion,0,1,1,0,1,1,0.01424,4,0.275514,0.296275,0
留校(1948),留校,notion,0,1,1,0,1,1,0.01022,4,0.267243,0.282233,0
留港(1948),留港,notion,0,1,1,0,1,1,0.009739,4,0.265806,0.279704,0
留给(1948),留给,notion,0,1,1,0,1,1,0.009751,4,0.267186,0.282133,0
留美(1948),留美,notion,0,1,1,0,1,1,0.01424,4,0.275514,0.296275,0
留美学生(1948),留美学生,notion,0,1,1,0,1,1,0.011322,4,0.269061,0.285394,0
略谈(1948),略谈,notion,0,2,2,0,2,2,0.021073,4,0.285785,0.312636,2242.44705
畸重畸轻(1948),畸重畸轻,notion,0,1,1,0,1,1,0.01022,4,0.267243,0.282233,0
疆场(1948),疆场,notion,0,1,1,0,1,1,0.016752,4,0.279138,0.302165,0
疏通(1948),疏通,notion,0,2,2,0,2,2,0.014938,4,0.275333,0.296031,2167.523118
疑案(1948),疑案,notion,0,1,1,0,1,1,0.007515,4,0.262793,0.274313,0
疑虑(1948),疑虑,notion,0,1,1,0,1,1,0.01424,4,0.275514,0.296275,0
疯狂(1948),疯狂,notion,0,2,2,0,2,2,0.026272,4,0.29319,0.323683,1793.896368
疯狗(1948),疯狗,notion,0,1,1,0,1,1,0.016518,4,0.278724,0.3015,0
疲劳(1948),疲劳,notion,0,1,1,0,1,1,0.011322,4,0.269061,0.285394,0
疲於奔命(1948),疲於奔命,notion,0,1,1,0,1,1,0.016518,4,0.278724,0.3015,0
疾病(1948),疾病,notion,0,1,1,0,1,1,0.002332,4,0.253398,0.256677,0
疾苦(1948),疾苦,notion,0,1,1,0,1,1,0.01424,4,0.275514,0.296275,0
病人(1948),病人,notion,0,1,1,0,1,1,0.007515,4,0.262793,0.274313,0
病态(1948),病态,notion,0,2,2,0,3,3,0.024461,4,0.291756,0.321587,2304.72473
病根(1948),病根,notion,0,1,1,0,1,1,0.009751,4,0.267186,0.282133,0
病死(1948),病死,notion,0,1,1,0,1,1,0.009751,4,0.267186,0.282133,0
病源(1948),病源,notion,0,1,1,0,1,1,0.002332,4,0.253398,0.256677,0
病者(1948),病者,notion,0,1,1,0,1,1,0.016518,4,0.278724,0.3015,0
病逝(1948),病逝,notion,0,1,1,0,1,1,0.011322,4,0.269061,0.285394,0
症结(1948),症结,notion,0,1,1,0,1,1,0.01022,4,0.267243,0.282233,0
痛心(1948),痛心,notion,0,2,2,0,2,2,0.021756,4,0.286964,0.314433,2044.761444
痛快(1948),痛快,notion,0,1,1,0,1,1,0.004718,4,0.258401,0.266227,0
痛斥(1948),痛斥,notion,0,1,1,0,1,1,0.016518,4,0.278724,0.3015,0
痛言(1948),痛言,notion,0,1,1,0,1,1,0.016752,4,0.279138,0.302165,0
痛陈(1948),痛陈,notion,0,1,1,0,1,1,0.01424,4,0.275514,0.296275,0
痴人说梦(1948),痴人说梦,notion,0,1,1,0,1,1,0.01022,4,0.267243,0.282233,0
瘫痪(1948),瘫痪,notion,0,1,1,0,1,1,0.011322,4,0.269061,0.285394,0
癡人(1948),癡人,notion,0,1,1,0,1,1,0.01424,4,0.275514,0.296275,0
登台(1948),登台,notion,0,1,1,0,1,1,0.005017,4,0.257497,0.26453,0
登峯(1948),登峯,notion,0,1,1,0,1,1,0.011322,4,0.269061,0.285394,0
登记(1948),登记,notion,0,1,1,0,1,1,0.004718,4,0.258401,0.266227,0
登陆艇(1948),登陆艇,notion,0,1,1,0,1,1,0.01424,4,0.275514,0.296275,0
白俄罗斯(1948),白俄罗斯,notion,0,1,1,0,1,1,0.009755,4,0.266617,0.281135,0
白崇禧(1948),白崇禧,notion,0,1,1,0,1,1,0.01022,4,0.267243,0.282233,0
白帽(1948),白帽,notion,0,1,1,0,1,1,0.01022,4,0.267243,0.282233,0
白报纸(1948),白报纸,notion,0,4,4,0,4,4,0.045522,4,0.323237,0.363426,10523.143983
白米(1948),白米,notion,0,1,1,0,1,1,0.01022,4,0.267243,0.282233,0
白色恐怖(1948),白色恐怖,notion,0,1,1,0,2,2,0.016752,4,0.279138,0.302165,0
百丑图(1948),百丑图,notion,0,1,1,0,1,1,0.005017,4,0.257497,0.26453,0
百余年(1948),百余年,notion,0,1,1,0,1,1,0.002332,4,0.253398,0.256677,0
百姓(1948),百姓,notion,0,2,2,0,2,2,0.025562,4,0.293259,0.323783,2167.4723
百孔千疮(1948),百孔千疮,notion,0,1,1,0,1,1,0.011322,4,0.269061,0.285394,0
百年(1948),百年,notion,0,1,1,0,1,1,0.016518,4,0.278724,0.3015,0
百年纪念(1948),百年纪念,notion,0,1,1,0,1,1,0.009755,4,0.266617,0.281135,0
百年诞辰(1948),百年诞辰,notion,0,1,1,0,1,1,0.009755,4,0.266617,0.281135,0
百货公司(1948),百货公司,notion,0,1,1,0,1,1,0.009755,4,0.266617,0.281135,0
百週年(1948),百週年,notion,0,1,1,0,1,1,0.016518,4,0.278724,0.3015,0
百醜图(1948),百醜图,notion,0,1,1,0,2,2,0.016518,4,0.278724,0.3015,0
的了(1948),的了,notion,0,1,1,0,1,1,0.008247,4,0.26379,0.27611,0
的侵(1948),的侵,notion,0,1,1,0,1,1,0.016518,4,0.278724,0.3015,0
的信(1948),的信,notion,0,1,1,0,1,1,0.01424,4,0.275514,0.296275,0
的变(1948),的变,notion,0,1,1,0,1,1,0.01022,4,0.267243,0.282233,0
的火(1948),的火,notion,0,1,1,0,1,1,0.01424,4,0.275514,0.296275,0
的犯(1948),的犯,notion,0,1,1,0,1,1,0.016752,4,0.279138,0.302165,0
的管(1948),的管,notion,0,1,1,0,1,1,0.01424,4,0.275514,0.296275,0
的话(1948),的话,notion,0,4,4,0,5,5,0.034444,4,0.307948,0.344226,12315.115708
的路(1948),的路,notion,0,1,1,0,1,1,0.01424,4,0.275514,0.296275,0
皆然(1948),皆然,notion,0,1,1,0,1,1,0.01424,4,0.275514,0.296275,0
皇家(1948),皇家,notion,0,1,1,0,1,1,0.01424,4,0.275514,0.296275,0
皇权(1948),皇权,notion,0,2,2,0,2,2,0.019569,4,0.280598,0.30455,1193.220239
皈依(1948),皈依,notion,0,1,1,0,1,1,0.008247,4,0.26379,0.27611,0
皖北(1948),皖北,notion,0,1,1,0,1,1,0.016752,4,0.279138,0.302165,0
皖南(1948),皖南,notion,0,2,2,0,2,2,0.026972,4,0.293947,0.324781,1749.441854
皖境(1948),皖境,notion,0,1,1,0,1,1,0.01022,4,0.267243,0.282233,0
皖政(1948),皖政,notion,0,1,1,0,1,1,0.016752,4,0.279138,0.302165,0
皖豫(1948),皖豫,notion,0,1,1,0,1,1,0.016752,4,0.279138,0.302165,0
盐商(1948),盐商,notion,0,1,1,0,1,1,0.01424,4,0.275514,0.296275,0
盐场(1948),盐场,notion,0,1,1,0,2,2,0.004718,4,0.258401,0.266227,0
盐民(1948),盐民,notion,0,1,1,0,1,1,0.004718,4,0.258401,0.266227,0
监军(1948),监军,notion,0,1,1,0,1,1,0.007515,4,0.262793,0.274313,0
监委(1948),监委,notion,0,3,3,0,3,3,0.033077,4,0.30475,0.339911,5680.358983
监察委员(1948),监察委员,notion,0,1,1,0,1,1,0.008247,4,0.26379,0.27611,0
监牢(1948),监牢,notion,0,1,1,0,1,1,0.016518,4,0.278724,0.3015,0
监狱(1948),监狱,notion,0,2,2,0,2,2,0.021542,4,0.284314,0.310373,1410.419447
监督(1948),监督,notion,0,1,1,0,1,1,0.008247,4,0.26379,0.27611,0
监视(1948),监视,notion,0,1,1,0,1,1,0.01022,4,0.267243,0.282233,0
盖世太保(1948),盖世太保,notion,0,1,1,0,1,1,0.009755,4,0.266617,0.281135,0
盖棺(1948),盖棺,notion,0,2,2,0,2,2,0.030992,4,0.303936,0.338757,2912.385696
盗卖(1948),盗卖,notion,0,1,1,0,1,1,0.016518,4,0.278724,0.3015,0
盘剥(1948),盘剥,notion,0,1,1,0,1,1,0.01022,4,0.267243,0.282233,0
盘据(1948),盘据,notion,0,1,1,0,1,1,0.01022,4,0.267243,0.282233,0
盛会(1948),盛会,notion,0,2,2,0,2,2,0.022141,4,0.285959,0.312902,1122.074528
盛意(1948),盛意,notion,0,1,1,0,2,2,0.011322,4,0.269061,0.285394,0
盛极必衰(1948),盛极必衰,notion,0,1,1,0,1,1,0.01424,4,0.275514,0.296275,0
盛谣(1948),盛谣,notion,0,1,1,0,1,1,0.01022,4,0.267243,0.282233,0
盟员(1948),盟员,notion,0,1,1,0,1,1,0.005017,4,0.257497,0.26453,0
目击(1948),目击,notion,0,1,1,0,1,1,0.01022,4,0.267243,0.282233,0
目击记(1948),目击记,notion,0,1,1,0,1,1,0.004718,4,0.258401,0.266227,0
目可(1948),目可,notion,0,1,1,0,1,1,0.01424,4,0.275514,0.296275,0
目标(1948),目标,notion,0,4,4,0,4,4,0.042254,4,0.316537,0.35524,9551.372376
目的(1948),目的,notion,0,2,2,0,2,2,0.021756,4,0.286964,0.314433,2044.761444
目睹(1948),目睹,notion,0,1,1,0,1,1,0.009739,4,0.265806,0.279704,0
盲肠(1948),盲肠,notion,0,1,1,0,1,1,0.01022,4,0.267243,0.282233,0
直到现在(1948),直到现在,notion,0,2,2,0,2,2,0.008698,4,0.258507,0.266483,0.569098
直抵(1948),直抵,notion,0,1,1,0,1,1,0.01022,4,0.267243,0.282233,0
直接(1948),直接,notion,0,1,1,0,1,1,0.011322,4,0.269061,0.285394,0
直系(1948),直系,notion,0,1,1,0,1,1,0.01022,4,0.267243,0.282233,0
直薄(1948),直薄,notion,0,1,1,0,1,1,0.016752,4,0.279138,0.302165,0
相互瞭解(1948),相互瞭解,notion,0,1,1,0,1,1,0.011322,4,0.269061,0.285394,0
相信(1948),相信,notion,0,1,1,0,1,1,0.005389,4,0.25849,0.266394,0
相处(1948),相处,notion,0,2,2,0,2,2,0.028074,4,0.296149,0.327943,1864.79583
相容性(1948),相容性,notion,0,1,1,0,1,1,0.008247,4,0.26379,0.27611,0
相左(1948),相左,notion,0,1,1,0,1,1,0.007515,4,0.262793,0.274313,0
相率(1948),相率,notion,0,1,1,0,1,1,0.009739,4,0.265806,0.279704,0
省区(1948),省区,notion,0,1,1,0,1,1,0.01424,4,0.275514,0.296275,0
省市(1948),省市,notion,0,1,1,0,1,1,0.007515,4,0.262793,0.274313,0
省训团(1948),省训团,notion,0,1,1,0,1,1,0.007515,4,0.262793,0.274313,0
眉睫(1948),眉睫,notion,0,1,1,0,1,1,0.01022,4,0.267243,0.282233,0
看上(1948),看上,notion,0,1,1,0,1,1,0.016518,4,0.278724,0.3015,0
看不到(1948),看不到,notion,0,1,1,0,1,1,0.016518,4,0.278724,0.3015,0
看中(1948),看中,notion,0,3,3,0,3,3,0.043009,4,0.318172,0.357214,5224.220047
看了(1948),看了,notion,0,2,2,0,2,2,0.026269,4,0.293695,0.324415,1931.353166
看人兽(1948),看人兽,notion,0,1,1,0,1,1,0.016518,4,0.278724,0.3015,0
看冬(1948),看冬,notion,0,1,1,0,1,1,0.009755,4,0.266617,0.281135,0
看出(1948),看出,notion,0,1,1,0,1,1,0.016518,4,0.278724,0.3015,0
看到(1948),看到,notion,0,1,1,0,1,1,0.009739,4,0.265806,0.279704,0
看和谣(1948),看和谣,notion,0,2,2,0,2,2,0.026491,4,0.291937,0.321853,1403.825067
看守所(1948),看守所,notion,0,1,1,0,1,1,0.011322,4,0.269061,0.285394,0
看官(1948),看官,notion,0,1,1,0,1,1,0.002332,4,0.253398,0.256677,0
看川(1948),看川,notion,0,1,1,0,1,1,0.016752,4,0.279138,0.302165,0
看川局(1948),看川局,notion,0,2,2,0,2,2,0.026491,4,0.291937,0.321853,1403.825067
看川防(1948),看川防,notion,0,1,1,0,1,1,0.016752,4,0.279138,0.302165,0
看得(1948),看得,notion,0,1,1,0,1,1,0.009755,4,0.266617,0.281135,0
看战(1948),看战,notion,0,1,1,0,1,1,0.016518,4,0.278724,0.3015,0
看日帝(1948),看日帝,notion,0,1,1,0,1,1,0.009755,4,0.266617,0.281135,0
看样子(1948),看样子,notion,0,1,1,0,1,1,0.016518,4,0.278724,0.3015,0
看法(1948),看法,notion,0,8,8,0,15,15,0.07108,4,0.360768,0.403878,32918.014178
看秋战(1948),看秋战,notion,0,1,1,0,1,1,0.016518,4,0.278724,0.3015,0
看美(1948),看美,notion,0,1,1,0,1,1,0.009751,4,0.267186,0.282133,0
看美帝(1948),看美帝,notion,0,1,1,0,1,1,0.009751,4,0.267186,0.282133,0
看见(1948),看见,notion,0,2,2,0,2,2,0.017999,4,0.280116,0.303785,1897.286008
看过(1948),看过,notion,0,1,1,0,1,1,0.016518,4,0.278724,0.3015,0
看齐(1948),看齐,notion,0,2,2,0,2,2,0.024999,4,0.291484,0.321188,1929.694181
真假(1948),真假,notion,0,1,1,0,1,1,0.016518,4,0.278724,0.3015,0
真实(1948),真实,notion,0,2,2,0,2,2,0.019491,4,0.281819,0.30648,1649.883746
真心(1948),真心,notion,0,1,1,0,1,1,0.009751,4,0.267186,0.282133,0
真恨(1948),真恨,notion,0,1,1,0,1,1,0.004718,4,0.258401,0.266227,0
真正(1948),真正,notion,0,3,3,0,3,3,0.024977,4,0.28681,0.314255,2734.374113
真理(1948),真理,notion,0,2,2,0,2,2,0.019972,4,0.283949,0.309807,2243.008915
真理报(1948),真理报,notion,0,1,1,0,2,2,0.009755,4,0.266617,0.281135,0
真的(1948),真的,notion,0,1,1,0,2,2,0.016752,4,0.279138,0.302165,0
真相(1948),真相,notion,0,5,5,0,6,6,0.06478,4,0.361567,0.404477,22725.640158
真空(1948),真空,notion,0,1,1,0,1,1,0.016518,4,0.278724,0.3015,0
真诚(1948),真诚,notion,0,1,1,0,1,1,0.009751,4,0.267186,0.282133,0
真谛(1948),真谛,notion,0,1,1,0,1,1,0.007515,4,0.262793,0.274313,0
真面目(1948),真面目,notion,0,1,1,0,1,1,0.009755,4,0.266617,0.281135,0
眼中(1948),眼中,notion,0,5,5,0,6,6,0.068586,4,0.366756,0.409368,22011.602934
眼前(1948),眼前,notion,0,2,2,0,2,2,0.026269,4,0.293695,0.324415,1931.353166
眼看(1948),眼看,notion,0,3,3,0,5,5,0.033091,4,0.30186,0.335984,3805.149484
眼睛(1948),眼睛,notion,0,1,1,0,1,1,0.016518,4,0.278724,0.3015,0
眼里(1948),眼里,notion,0,1,1,0,1,1,0.01022,4,0.267243,0.282233,0
眼镜(1948),眼镜,notion,0,1,1,0,1,1,0.011322,4,0.269061,0.285394,0
着什(1948),着什,notion,0,1,1,0,1,1,0.011322,4,0.269061,0.285394,0
督察(1948),督察,notion,0,1,1,0,1,1,0.007515,4,0.262793,0.274313,0
瞭解(1948),瞭解,notion,0,2,2,0,2,2,0.019569,4,0.280598,0.30455,1193.220239
瞻望(1948),瞻望,notion,0,1,1,0,1,1,0.002332,4,0.253398,0.256677,0
矛攻(1948),矛攻,notion,0,1,1,0,1,1,0.01022,4,0.267243,0.282233,0
矛盾(1948),矛盾,notion,0,5,5,0,7,7,0.067004,4,0.361706,0.40461,20499.304796
知兵(1948),知兵,notion,0,1,1,0,1,1,0.007515,4,0.262793,0.274313,0
知己知彼(1948),知己知彼,notion,0,1,1,0,1,1,0.009751,4,0.267186,0.282133,0
知识分子(1948),知识分子,notion,0,7,7,0,9,9,0.07775,4,0.375406,0.417332,29859.080805
知道(1948),知道,notion,0,1,1,0,1,1,0.016752,4,0.279138,0.302165,0
短兵相接(1948),短兵相接,notion,0,1,1,0,1,1,0.016518,4,0.278724,0.3015,0
短波(1948),短波,notion,0,1,1,0,1,1,0.009739,4,0.265806,0.279704,0
短篇(1948),短篇,notion,0,1,1,0,1,1,0.01424,4,0.275514,0.296275,0
石在(1948),石在,notion,0,1,1,0,1,1,0.005017,4,0.257497,0.26453,0
石头(1948),石头,notion,0,1,1,0,1,1,0.016518,4,0.278724,0.3015,0
石室(1948),石室,notion,0,1,1,0,1,1,0.007515,4,0.262793,0.274313,0
石家(1948),石家,notion,0,1,1,0,1,1,0.009751,4,0.267186,0.282133,0
石家庄(1948),石家庄,notion,0,1,1,0,1,1,0.005017,4,0.257497,0.26453,0
石家莊(1948),石家莊,notion,0,1,1,0,2,2,0.016518,4,0.278724,0.3015,0
石工(1948),石工,notion,0,1,1,0,1,1,0.009755,4,0.266617,0.281135,0
石敬塘(1948),石敬塘,notion,0,1,1,0,1,1,0.01022,4,0.267243,0.282233,0
石榴花(1948),石榴花,notion,0,1,1,0,1,1,0.016752,4,0.279138,0.302165,0
石油(1948),石油,notion,0,1,1,0,1,1,0.016752,4,0.279138,0.302165,0
石达开(1948),石达开,notion,0,1,1,0,1,1,0.01424,4,0.275514,0.296275,0
码头工人(1948),码头工人,notion,0,1,1,0,1,1,0.009739,4,0.265806,0.279704,0
研究会(1948),研究会,notion,0,4,4,0,4,4,0.047799,4,0.324746,0.365223,9488.881081
研究所(1948),研究所,notion,0,1,1,0,2,2,0.004718,4,0.258401,0.266227,0
研究生(1948),研究生,notion,0,1,1,0,1,1,0.011322,4,0.269061,0.285394,0
研究院(1948),研究院,notion,0,1,1,0,1,1,0.01424,4,0.275514,0.296275,0
破坏(1948),破坏,notion,0,3,3,0,5,5,0.036493,4,0.309342,0.346,5642.475469
破裂(1948),破裂,notion,0,2,2,0,2,2,0.019491,4,0.281819,0.30648,1649.883746
硬压(1948),硬压,notion,0,1,1,0,1,1,0.016752,4,0.279138,0.302165,0
硬夺(1948),硬夺,notion,0,1,1,0,1,1,0.016518,4,0.278724,0.3015,0
硬打(1948),硬打,notion,0,1,1,0,1,1,0.01022,4,0.267243,0.282233,0
硬抢(1948),硬抢,notion,0,1,1,0,1,1,0.016518,4,0.278724,0.3015,0
硬拼(1948),硬拼,notion,0,1,1,0,1,1,0.01022,4,0.267243,0.282233,0
确信(1948),确信,notion,0,1,1,0,1,1,0.009751,4,0.267186,0.282133,0
确立(1948),确立,notion,0,2,2,0,2,2,0.014469,4,0.27493,0.295366,1965.542095
碧潭(1948),碧潭,notion,0,1,1,0,1,1,0.004718,4,0.258401,0.266227,0
碰到(1948),碰到,notion,0,1,1,0,1,1,0.009755,4,0.266617,0.281135,0
磁针(1948),磁针,notion,0,1,1,0,1,1,0.016752,4,0.279138,0.302165,0
磨擦(1948),磨擦,notion,0,1,1,0,1,1,0.01022,4,0.267243,0.282233,0
示威(1948),示威,notion,0,4,4,0,6,6,0.041495,4,0.312638,0.350315,7139.881149
示威游行(1948),示威游行,notion,0,1,1,0,1,1,0.009739,4,0.265806,0.279704,0
示威运动(1948),示威运动,notion,0,2,2,0,2,2,0.008698,4,0.258507,0.266483,0.569098
示範(1948),示範,notion,0,1,1,0,2,2,0.016518,4,0.278724,0.3015,0
示范(1948),示范,notion,0,1,1,0,2,2,0.004718,4,0.258401,0.266227,0
示范区(1948),示范区,notion,0,2,2,0,4,4,0.014938,4,0.275333,0.296031,2167.523118
社会党(1948),社会党,notion,0,3,3,0,3,3,0.036727,4,0.309444,0.346133,5617.048602
社会化(1948),社会化,notion,0,1,1,0,1,1,0.005389,4,0.25849,0.266394,0
社会契约论(1948),社会契约论,notion,0,1,1,0,1,1,0.011322,4,0.269061,0.285394,0
社会局(1948),社会局,notion,0,1,1,0,1,1,0.016752,4,0.279138,0.302165,0
社会民主党(1948),社会民主党,notion,0,1,1,0,1,1,0.009755,4,0.266617,0.281135,0
社会科学(1948),社会科学,notion,0,3,3,0,3,3,0.018438,4,0.273429,0.292926,1298.292089
社函嘱(1948),社函嘱,notion,0,1,1,0,1,1,0.009739,4,0.265806,0.279704,0
社员(1948),社员,notion,0,1,1,0,2,2,0.004718,4,0.258401,0.266227,0
社庆(1948),社庆,notion,0,1,1,0,2,2,0.004718,4,0.258401,0.266227,0
社经会(1948),社经会,notion,0,1,1,0,1,1,0.01424,4,0.275514,0.296275,0
祈祷(1948),祈祷,notion,0,1,1,0,1,1,0.009739,4,0.265806,0.279704,0
祕密(1948),祕密,notion,0,1,1,0,1,1,0.01424,4,0.275514,0.296275,0
祕笈(1948),祕笈,notion,0,1,1,0,1,1,0.007515,4,0.262793,0.274313,0
祖先(1948),祖先,notion,0,1,1,0,1,1,0.016752,4,0.279138,0.302165,0
祖国(1948),祖国,notion,0,5,5,0,5,5,0.061023,4,0.351387,0.394461,20189.93049
祖宗(1948),祖宗,notion,0,1,1,0,1,1,0.016518,4,0.278724,0.3015,0
祝中苏(1948),祝中苏,notion,0,1,1,0,1,1,0.009755,4,0.266617,0.281135,0
祝贺(1948),祝贺,notion,0,1,1,0,1,1,0.005017,4,0.257497,0.26453,0
神圣同盟(1948),神圣同盟,notion,0,1,1,0,1,1,0.009755,4,0.266617,0.281135,0
神境(1948),神境,notion,0,1,1,0,1,1,0.011322,4,0.269061,0.285394,0
神经(1948),神经,notion,0,1,1,0,1,1,0.01022,4,0.267243,0.282233,0
神经战(1948),神经战,notion,0,2,2,0,2,2,0.008698,4,0.258507,0.266483,0.569098
祥和(1948),祥和,notion,0,1,1,0,1,1,0.016518,4,0.278724,0.3015,0
祭悼(1948),祭悼,notion,0,1,1,0,1,1,0.009751,4,0.267186,0.282133,0
祸乱(1948),祸乱,notion,0,1,1,0,1,1,0.01424,4,0.275514,0.296275,0
祸鲁(1948),祸鲁,notion,0,1,1,0,1,1,0.01022,4,0.267243,0.282233,0
禁舞(1948),禁舞,notion,0,1,1,0,1,1,0.01022,4,0.267243,0.282233,0
福利(1948),福利,notion,0,2,2,0,2,2,0.030758,4,0.303347,0.337959,2812.221703
福地(1948),福地,notion,0,2,2,0,2,2,0.024999,4,0.291484,0.321188,1929.694181
福安(1948),福安,notion,0,1,1,0,1,1,0.016518,4,0.278724,0.3015,0
福州(1948),福州,notion,0,2,2,0,4,4,0.024765,4,0.291552,0.321288,2097.245087
福斯(1948),福斯,notion,0,2,2,0,11,11,0.014469,4,0.27493,0.295366,1965.542095
福斯特(1948),福斯特,notion,0,1,1,0,1,1,0.008247,4,0.26379,0.27611,0
离奇(1948),离奇,notion,0,1,1,0,1,1,0.009739,4,0.265806,0.279704,0
离开(1948),离开,notion,0,2,2,0,2,2,0.025562,4,0.293259,0.323783,2167.4723
离谱(1948),离谱,notion,0,1,1,0,1,1,0.016518,4,0.278724,0.3015,0
禽兽(1948),禽兽,notion,0,1,1,0,1,1,0.01424,4,0.275514,0.296275,0
秀才(1948),秀才,notion,0,1,1,0,1,1,0.009751,4,0.267186,0.282133,0
秀才造反(1948),秀才造反,notion,0,1,1,0,1,1,0.005389,4,0.25849,0.266394,0
私人(1948),私人,notion,0,2,2,0,2,2,0.019506,4,0.282731,0.307911,1903.779982
私小(1948),私小,notion,0,1,1,0,1,1,0.016752,4,0.279138,0.302165,0
私有财产(1948),私有财产,notion,0,1,1,0,1,1,0.008247,4,0.26379,0.27611,0
私生子(1948),私生子,notion,0,1,1,0,1,1,0.011322,4,0.269061,0.285394,0
私立中学(1948),私立中学,notion,0,1,1,0,1,1,0.016752,4,0.279138,0.302165,0
私访记(1948),私访记,notion,0,1,1,0,1,1,0.016518,4,0.278724,0.3015,0
秋季(1948),秋季,notion,0,7,7,0,9,9,0.066957,4,0.35165,0.394838,24075.955425
秋战(1948),秋战,notion,0,1,1,0,1,1,0.016752,4,0.279138,0.302165,0
秋收(1948),秋收,notion,0,1,1,0,1,1,0.016518,4,0.278724,0.3015,0
秋景(1948),秋景,notion,0,1,1,0,1,1,0.016752,4,0.279138,0.302165,0
秋暮(1948),秋暮,notion,0,1,1,0,1,1,0.016752,4,0.279138,0.302165,0
秋水(1948),秋水,notion,0,1,1,0,1,1,0.016752,4,0.279138,0.302165,0
秋讯(1948),秋讯,notion,0,2,2,0,2,2,0.008698,4,0.258507,0.266483,0.569098
秋雨(1948),秋雨,notion,0,3,3,0,3,3,0.043021,4,0.321604,0.361407,6898.300577
秋风(1948),秋风,notion,0,3,3,0,4,4,0.036321,4,0.307771,0.343937,4987.71025
秋风扫落叶(1948),秋风扫落叶,notion,0,1,1,0,1,1,0.005017,4,0.257497,0.26453,0
秋高马肥(1948),秋高马肥,notion,0,1,1,0,1,1,0.008247,4,0.26379,0.27611,0
种田人(1948),种田人,notion,0,1,1,0,1,1,0.004718,4,0.258401,0.266227,0
种种(1948),种种,notion,0,5,5,0,5,5,0.059063,4,0.348163,0.391166,20980.046587
科举(1948),科举,notion,0,1,1,0,1,1,0.011322,4,0.269061,0.285394,0
科学界(1948),科学界,notion,0,1,1,0,1,1,0.005389,4,0.25849,0.266394,0
科学研究(1948),科学研究,notion,0,2,2,0,2,2,0.012233,4,0.270573,0.288045,1678.569586
秘密(1948),秘密,notion,0,3,3,0,3,3,0.034216,4,0.307973,0.344203,6653.167649
秘密会议(1948),秘密会议,notion,0,1,1,0,1,1,0.008247,4,0.26379,0.27611,0
租界(1948),租界,notion,0,3,3,0,4,4,0.018919,4,0.274568,0.294822,1295.743183
秣陵(1948),秣陵,notion,0,2,2,0,2,2,0.033269,4,0.305692,0.34112,2297.98609
秦景龙(1948),秦景龙,notion,0,1,1,0,1,1,0.009751,4,0.267186,0.282133,0
秦汉(1948),秦汉,notion,0,1,1,0,1,1,0.01424,4,0.275514,0.296275,0
秩序(1948),秩序,notion,0,1,1,0,1,1,0.016752,4,0.279138,0.302165,0
积极(1948),积极,notion,0,2,2,0,2,2,0.026272,4,0.29319,0.323683,1793.896368
积石山(1948),积石山,notion,0,1,1,0,1,1,0.01424,4,0.275514,0.296275,0
积蓄(1948),积蓄,notion,0,1,1,0,1,1,0.016518,4,0.278724,0.3015,0
积铁(1948),积铁,notion,0,1,1,0,1,1,0.011322,4,0.269061,0.285394,0
移动(1948),移动,notion,0,1,1,0,1,1,0.005389,4,0.25849,0.266394,0
移国(1948),移国,notion,0,1,1,0,1,1,0.007515,4,0.262793,0.274313,0
程孟明案(1948),程孟明案,notion,0,1,1,0,3,3,0.011322,4,0.269061,0.285394,0
程序(1948),程序,notion,0,2,2,0,2,2,0.015763,4,0.275232,0.295865,1348.309636
程度(1948),程度,notion,0,3,3,0,4,4,0.032239,4,0.305568,0.341009,7168.317163
程潜(1948),程潜,notion,0,1,1,0,1,1,0.016752,4,0.279138,0.302165,0
稍停(1948),稍停,notion,0,1,1,0,1,1,0.01424,4,0.275514,0.296275,0
稚气(1948),稚气,notion,0,1,1,0,1,1,0.01424,4,0.275514,0.296275,0
稳定(1948),稳定,notion,0,4,4,0,4,4,0.046755,4,0.329157,0.37038,12517.610147
稳定性(1948),稳定性,notion,0,1,1,0,1,1,0.009755,4,0.266617,0.281135,0
稳定物价(1948),稳定物价,notion,0,1,1,0,2,2,0.011322,4,0.269061,0.285394,0
穆仁智(1948),穆仁智,notion,0,1,1,0,1,1,0.009751,4,0.267186,0.282133,0
穆尔卡(1948),穆尔卡,notion,0,1,1,0,2,2,0.009755,4,0.266617,0.281135,0
究竟(1948),究竟,notion,0,2,2,0,3,3,0.019569,4,0.280598,0.30455,1193.220239
穷人(1948),穷人,notion,0,1,1,0,1,1,0.016518,4,0.278724,0.3015,0
穷则变(1948),穷则变,notion,0,1,1,0,1,1,0.009739,4,0.265806,0.279704,0
穷通(1948),穷通,notion,0,1,1,0,1,1,0.01424,4,0.275514,0.296275,0
空军(1948),空军,notion,0,1,1,0,1,1,0.01022,4,0.267243,0.282233,0
空前(1948),空前,notion,0,1,1,0,1,1,0.009751,4,0.267186,0.282133,0
空城计(1948),空城计,notion,0,1,1,0,1,1,0.009751,4,0.267186,0.282133,0
空想(1948),空想,notion,0,1,1,0,1,1,0.004718,4,0.258401,0.266227,0
空箱(1948),空箱,notion,0,1,1,0,1,1,0.016518,4,0.278724,0.3015,0
空间(1948),空间,notion,0,1,1,0,1,1,0.01022,4,0.267243,0.282233,0
空隙(1948),空隙,notion,0,1,1,0,1,1,0.016518,4,0.278724,0.3015,0
突击(1948),突击,notion,0,1,1,0,1,1,0.016518,4,0.278724,0.3015,0
突变(1948),突变,notion,0,1,1,0,1,1,0.016752,4,0.279138,0.302165,0
突破(1948),突破,notion,0,2,2,0,2,2,0.019972,4,0.283949,0.309807,2243.008915
窒息(1948),窒息,notion,0,3,3,0,3,3,0.039239,4,0.316724,0.355417,6944.905464
窗外(1948),窗外,notion,0,1,1,0,1,1,0.004718,4,0.258401,0.266227,0
立刻(1948),立刻,notion,0,1,1,0,1,1,0.016518,4,0.278724,0.3015,0
立即(1948),立即,notion,0,1,1,0,1,1,0.009751,4,0.267186,0.282133,0
立场(1948),立场,notion,0,3,3,0,3,3,0.040747,4,0.319852,0.359277,7419.013695
立宪(1948),立宪,notion,0,1,1,0,1,1,0.01022,4,0.267243,0.282233,0
立德(1948),立德,notion,0,1,1,0,1,1,0.008247,4,0.26379,0.27611,0
立法委员(1948),立法委员,notion,0,3,3,0,4,4,0.030003,4,0.299549,0.33279,5495.896668
立法院(1948),立法院,notion,0,4,4,0,5,5,0.03682,4,0.308377,0.344791,8135.796477
立言(1948),立言,notion,0,1,1,0,1,1,0.007515,4,0.262793,0.274313,0
站立起来(1948),站立起来,notion,0,1,1,0,1,1,0.016518,4,0.278724,0.3015,0
竞技场(1948),竞技场,notion,0,1,1,0,1,1,0.009739,4,0.265806,0.279704,0
竞赛(1948),竞赛,notion,0,1,1,0,2,2,0.007515,4,0.262793,0.274313,0
竞选(1948),竞选,notion,0,7,7,0,13,13,0.077802,4,0.380501,0.421791,37520.057191
竞选活动(1948),竞选活动,notion,0,1,1,0,1,1,0.004718,4,0.258401,0.266227,0
竟为(1948),竟为,notion,0,1,1,0,1,1,0.016752,4,0.279138,0.302165,0
竟成(1948),竟成,notion,0,1,1,0,1,1,0.011322,4,0.269061,0.285394,0
竟殴(1948),竟殴,notion,0,1,1,0,1,1,0.009739,4,0.265806,0.279704,0
竟见(1948),竟见,notion,0,1,1,0,1,1,0.01424,4,0.275514,0.296275,0
竟选(1948),竟选,notion,0,1,1,0,1,1,0.016752,4,0.279138,0.302165,0
竟选会(1948),竟选会,notion,0,1,1,0,1,1,0.016752,4,0.279138,0.302165,0
章伯钧(1948),章伯钧,notion,0,1,1,0,1,1,0.01424,4,0.275514,0.296275,0
童奴(1948),童奴,notion,0,1,1,0,1,1,0.008247,4,0.26379,0.27611,0
童工(1948),童工,notion,0,1,1,0,1,1,0.009751,4,0.267186,0.282133,0
童话(1948),童话,notion,0,1,1,0,1,1,0.009739,4,0.265806,0.279704,0
童贞(1948),童贞,notion,0,1,1,0,1,1,0.016752,4,0.279138,0.302165,0
端午节(1948),端午节,notion,0,2,2,0,2,2,0.021073,4,0.285785,0.312636,2242.44705
笑剧(1948),笑剧,notion,0,1,1,0,1,1,0.01022,4,0.267243,0.282233,0
笑口开(1948),笑口开,notion,0,1,1,0,1,1,0.009751,4,0.267186,0.282133,0
笑骂(1948),笑骂,notion,0,1,1,0,1,1,0.016518,4,0.278724,0.3015,0
笔会(1948),笔会,notion,0,1,1,0,2,2,0.004718,4,0.258401,0.266227,0
笔祸(1948),笔祸,notion,0,1,1,0,1,1,0.007515,4,0.262793,0.274313,0
笔者(1948),笔者,notion,0,1,1,0,1,1,0.008247,4,0.26379,0.27611,0
笔记(1948),笔记,notion,0,2,2,0,2,2,0.015141,4,0.274909,0.295333,1225.700317
笔谈(1948),笔谈,notion,0,3,3,0,8,8,0.026487,4,0.292847,0.32324,4648.953527
符咒(1948),符咒,notion,0,1,1,0,1,1,0.008247,4,0.26379,0.27611,0
符拉第(1948),符拉第,notion,0,1,1,0,1,1,0.009755,4,0.266617,0.281135,0
第一号(1948),第一号,notion,0,1,1,0,1,1,0.016518,4,0.278724,0.3015,0
第一场(1948),第一场,notion,0,1,1,0,1,1,0.002332,4,0.253398,0.256677,0
第一季(1948),第一季,notion,0,1,1,0,1,1,0.009755,4,0.266617,0.281135,0
第一届(1948),第一届,notion,0,1,1,0,1,1,0.011322,4,0.269061,0.285394,0
第一条(1948),第一条,notion,0,1,1,0,1,1,0.007515,4,0.262793,0.274313,0
第一次(1948),第一次,notion,0,4,4,0,4,4,0.041647,4,0.31855,0.357735,10124.180344
第一章(1948),第一章,notion,0,1,1,0,1,1,0.016518,4,0.278724,0.3015,0
第一课(1948),第一课,notion,0,1,1,0,1,1,0.016518,4,0.278724,0.3015,0
第一部(1948),第一部,notion,0,1,1,0,1,1,0.009751,4,0.267186,0.282133,0
第三世界(1948),第三世界,notion,0,1,1,0,1,1,0.002332,4,0.253398,0.256677,0
第三党(1948),第三党,notion,0,4,4,0,4,4,0.036105,4,0.307042,0.343028,7944.479979
第三卷(1948),第三卷,notion,0,1,1,0,1,1,0.011322,4,0.269061,0.285394,0
第三届(1948),第三届,notion,0,1,1,0,1,1,0.016518,4,0.278724,0.3015,0
第三年(1948),第三年,notion,0,4,4,0,4,4,0.054346,4,0.33853,0.380895,11625.791149
第三方面(1948),第三方面,notion,0,5,5,0,9,9,0.043843,4,0.316643,0.355428,11083.641551
第三条(1948),第三条,notion,0,1,1,0,2,2,0.009751,4,0.267186,0.282133,0
第三次(1948),第三次,notion,0,6,6,0,7,7,0.074594,4,0.378393,0.419905,30898.04523
第二(1948),第二,notion,0,2,2,0,4,4,0.019972,4,0.283949,0.309807,2243.008915
第二个(1948),第二个,notion,0,2,2,0,3,3,0.028074,4,0.296149,0.327943,1864.79583
第二十七次(1948),第二十七次,notion,0,1,1,0,1,1,0.009755,4,0.266617,0.281135,0
第二卷(1948),第二卷,notion,0,1,1,0,1,1,0.01424,4,0.275514,0.296275,0
第二天(1948),第二天,notion,0,1,1,0,1,1,0.011322,4,0.269061,0.285394,0
第二期(1948),第二期,notion,0,1,1,0,1,1,0.016518,4,0.278724,0.3015,0
第二次(1948),第二次,notion,0,1,1,0,1,1,0.011322,4,0.269061,0.285394,0
第二次世界大战(1948),第二次世界大战,notion,0,1,1,0,1,1,0.009755,4,0.266617,0.281135,0
第二阶段(1948),第二阶段,notion,0,1,1,0,1,1,0.002332,4,0.253398,0.256677,0
第五纵队(1948),第五纵队,notion,0,1,1,0,2,2,0.009755,4,0.266617,0.281135,0
第六届(1948),第六届,notion,0,1,1,0,1,1,0.009755,4,0.266617,0.281135,0
第六次(1948),第六次,notion,0,1,1,0,1,1,0.016518,4,0.278724,0.3015,0
第十一(1948),第十一,notion,0,1,1,0,1,1,0.016752,4,0.279138,0.302165,0
第十四届(1948),第十四届,notion,0,1,1,0,1,1,0.009755,4,0.266617,0.281135,0
第四卷(1948),第四卷,notion,0,1,1,0,2,2,0.011322,4,0.269061,0.285394,0
笼罩(1948),笼罩,notion,0,1,1,0,1,1,0.01022,4,0.267243,0.282233,0
等待(1948),等待,notion,0,2,2,0,2,2,0.030758,4,0.303347,0.337959,2812.221703
答友瑟(1948),答友瑟,notion,0,1,1,0,1,1,0.016752,4,0.279138,0.302165,0
答复(1948),答复,notion,0,2,2,0,2,2,0.022488,4,0.288152,0.31623,2102.825587
答覆(1948),答覆,notion,0,3,3,0,5,5,0.029324,4,0.296125,0.327965,4585.929671
答辩(1948),答辩,notion,0,1,1,0,1,1,0.011322,4,0.269061,0.285394,0
答问(1948),答问,notion,0,1,1,0,2,2,0.01424,4,0.275514,0.296275,0
策略(1948),策略,notion,0,1,1,0,1,1,0.009739,4,0.265806,0.279704,0
筹办(1948),筹办,notion,0,1,1,0,1,1,0.01424,4,0.275514,0.296275,0
筹委会(1948),筹委会,notion,0,1,1,0,1,1,0.016518,4,0.278724,0.3015,0
签名运动(1948),签名运动,notion,0,1,1,0,1,1,0.016752,4,0.279138,0.302165,0
签订(1948),签订,notion,0,2,2,0,2,2,0.026507,4,0.294224,0.325181,2012.895914
简明(1948),简明,notion,0,2,2,0,2,2,0.026272,4,0.29319,0.323683,1793.896368
简述(1948),简述,notion,0,1,1,0,1,1,0.007515,4,0.262793,0.274313,0
算是(1948),算是,notion,0,3,3,0,3,3,0.033731,4,0.307318,0.343338,6816.772232
算算看(1948),算算看,notion,0,1,1,0,1,1,0.011322,4,0.269061,0.285394,0
管制(1948),管制,notion,0,2,2,0,3,3,0.028074,4,0.296149,0.327943,1864.79583
管制经济(1948),管制经济,notion,0,1,1,0,1,1,0.01022,4,0.267243,0.282233,0
管理(1948),管理,notion,0,1,1,0,1,1,0.004718,4,0.258401,0.266227,0
管窥(1948),管窥,notion,0,1,1,0,1,1,0.004718,4,0.258401,0.266227,0
箭在弦上(1948),箭在弦上,notion,0,1,1,0,1,1,0.011322,4,0.269061,0.285394,0
篇文章(1948),篇文章,notion,0,1,1,0,1,1,0.008247,4,0.26379,0.27611,0
築路(1948),築路,notion,0,1,1,0,1,1,0.011322,4,0.269061,0.285394,0
米仓(1948),米仓,notion,0,1,1,0,1,1,0.01022,4,0.267243,0.282233,0
米价(1948),米价,notion,0,2,2,0,2,2,0.026738,4,0.294408,0.325447,1993.868267
米市(1948),米市,notion,0,1,1,0,1,1,0.01022,4,0.267243,0.282233,0
米潮(1948),米潮,notion,0,1,1,0,1,1,0.016752,4,0.279138,0.302165,0
类型(1948),类型,notion,0,1,1,0,1,1,0.009755,4,0.266617,0.281135,0
粉碎(1948),粉碎,notion,0,3,3,0,5,5,0.031287,4,0.299001,0.332024,3863.30515
粉饰(1948),粉饰,notion,0,1,1,0,1,1,0.011322,4,0.269061,0.285394,0
粗属(1948),粗属,notion,0,1,1,0,1,1,0.01424,4,0.275514,0.296275,0
粗描近(1948),粗描近,notion,0,1,1,0,1,1,0.002332,4,0.253398,0.256677,0
粤东(1948),粤东,notion,0,2,2,0,3,3,0.019972,4,0.283949,0.309807,2243.008915
粤军(1948),粤军,notion,0,1,1,0,1,1,0.009739,4,0.265806,0.279704,0
粤北(1948),粤北,notion,0,1,1,0,3,3,0.009751,4,0.267186,0.282133,0
粤政(1948),粤政,notion,0,1,1,0,1,1,0.016752,4,0.279138,0.302165,0
粤港(1948),粤港,notion,0,1,1,0,1,1,0.01022,4,0.267243,0.282233,0
粮价(1948),粮价,notion,0,1,1,0,1,1,0.016752,4,0.279138,0.302165,0
粮官(1948),粮官,notion,0,1,1,0,1,1,0.01022,4,0.267243,0.282233,0
粮政(1948),粮政,notion,0,2,2,0,2,2,0.025562,4,0.293259,0.323783,2167.4723
粮潮(1948),粮潮,notion,0,1,1,0,1,1,0.009751,4,0.267186,0.282133,0
粮荒(1948),粮荒,notion,0,4,4,0,5,5,0.048879,4,0.328523,0.369648,9376.167071
粲七哀(1948),粲七哀,notion,0,1,1,0,1,1,0.009739,4,0.265806,0.279704,0
精工(1948),精工,notion,0,1,1,0,1,1,0.011322,4,0.269061,0.285394,0
精彩表演(1948),精彩表演,notion,0,1,1,0,1,1,0.01424,4,0.275514,0.296275,0
精神(1948),精神,notion,0,5,5,0,7,7,0.052063,4,0.336318,0.378522,20319.968533
精采(1948),精采,notion,0,1,1,0,1,1,0.016752,4,0.279138,0.302165,0
糜烂(1948),糜烂,notion,0,3,3,0,3,3,0.033809,4,0.305096,0.340377,5463.518126
糟塌(1948),糟塌,notion,0,1,1,0,1,1,0.01424,4,0.275514,0.296275,0
紊淆(1948),紊淆,notion,0,1,1,0,1,1,0.007515,4,0.262793,0.274313,0
素描(1948),素描,notion,0,1,1,0,1,1,0.009755,4,0.266617,0.281135,0
紧似(1948),紧似,notion,0,1,1,0,1,1,0.016752,4,0.279138,0.302165,0
紧张(1948),紧张,notion,0,4,4,0,5,5,0.046541,4,0.32307,0.363226,9760.66051
紧急(1948),紧急,notion,0,1,1,0,1,1,0.011322,4,0.269061,0.285394,0
紧急处分(1948),紧急处分,notion,0,1,1,0,1,1,0.016752,4,0.279138,0.302165,0
紧跟着(1948),紧跟着,notion,0,1,1,0,1,1,0.009751,4,0.267186,0.282133,0
繁荣(1948),繁荣,notion,0,2,2,0,2,2,0.012965,4,0.271708,0.289975,1825.821004
纠正(1948),纠正,notion,0,2,2,0,2,2,0.023992,4,0.29271,0.322985,3168.205568
纠纷(1948),纠纷,notion,0,3,3,0,4,4,0.04208,4,0.32089,0.360542,6900.033893
纠缠不清(1948),纠缠不清,notion,0,1,1,0,1,1,0.009751,4,0.267186,0.282133,0
红军(1948),红军,notion,0,2,2,0,2,2,0.026738,4,0.294408,0.325447,1993.868267
红帽(1948),红帽,notion,0,1,1,0,1,1,0.01022,4,0.267243,0.282233,0
红帽子(1948),红帽子,notion,0,1,1,0,1,1,0.011322,4,0.269061,0.285394,0
红球(1948),红球,notion,0,1,1,0,2,2,0.016752,4,0.279138,0.302165,0
红色(1948),红色,notion,0,1,1,0,1,1,0.01424,4,0.275514,0.296275,0
约法(1948),约法,notion,0,1,1,0,1,1,0.016518,4,0.278724,0.3015,0
约翰(1948),约翰,notion,0,2,2,0,2,2,0.021076,4,0.284616,0.310839,1735.877057
纪实(1948),纪实,notion,0,2,2,0,2,2,0.012965,4,0.271708,0.289975,1825.821004
纪录片(1948),纪录片,notion,0,1,1,0,1,1,0.016752,4,0.279138,0.302165,0
纪律(1948),纪律,notion,0,2,2,0,3,3,0.023992,4,0.29271,0.322985,3168.205568
纪念周(1948),纪念周,notion,0,1,1,0,1,1,0.005017,4,0.257497,0.26453,0
纪行(1948),纪行,notion,0,1,1,0,1,1,0.009755,4,0.266617,0.281135,0
纪要(1948),纪要,notion,0,1,1,0,1,1,0.009739,4,0.265806,0.279704,0
纪载(1948),纪载,notion,0,1,1,0,1,1,0.01022,4,0.267243,0.282233,0
纯粹(1948),纯粹,notion,0,1,1,0,1,1,0.004718,4,0.258401,0.266227,0
纳粹(1948),纳粹,notion,0,1,1,0,3,3,0.009755,4,0.266617,0.281135,0
纵横谈(1948),纵横谈,notion,0,1,1,0,1,1,0.008247,4,0.26379,0.27611,0
纵火案(1948),纵火案,notion,0,1,1,0,1,1,0.009755,4,0.266617,0.281135,0
纵谈(1948),纵谈,notion,0,1,1,0,1,1,0.007515,4,0.262793,0.274313,0
纵队(1948),纵队,notion,0,1,1,0,2,2,0.009751,4,0.267186,0.282133,0
纷争(1948),纷争,notion,0,1,1,0,1,1,0.01424,4,0.275514,0.296275,0
纷纷(1948),纷纷,notion,0,1,1,0,1,1,0.009739,4,0.265806,0.279704,0
纸上谈兵(1948),纸上谈兵,notion,0,1,1,0,1,1,0.01424,4,0.275514,0.296275,0
纸本(1948),纸本,notion,0,1,1,0,1,1,0.01022,4,0.267243,0.282233,0
纸浆(1948),纸浆,notion,0,1,1,0,1,1,0.01022,4,0.267243,0.282233,0
纺代织(1948),纺代织,notion,0,1,1,0,1,1,0.01424,4,0.275514,0.296275,0
纺织工业(1948),纺织工业,notion,0,1,1,0,1,1,0.016752,4,0.279138,0.302165,0
纽约时报(1948),纽约时报,notion,0,1,1,0,1,1,0.007515,4,0.262793,0.274313,0
纽结(1948),纽结,notion,0,1,1,0,1,1,0.008247,4,0.26379,0.27611,0
练兵(1948),练兵,notion,0,1,1,0,1,1,0.009751,4,0.267186,0.282133,0
练成(1948),练成,notion,0,1,1,0,1,1,0.009751,4,0.267186,0.282133,0
组成(1948),组成,notion,0,1,1,0,1,1,0.016518,4,0.278724,0.3015,0
组织(1948),组织,notion,0,4,4,0,7,7,0.034099,4,0.309164,0.345823,12301.891295
组视桥(1948),组视桥,notion,0,1,1,0,1,1,0.004718,4,0.258401,0.266227,0
组阁(1948),组阁,notion,0,2,2,0,2,2,0.025562,4,0.293259,0.323783,2167.4723
细波(1948),细波,notion,0,1,1,0,1,1,0.002332,4,0.253398,0.256677,0
细胞(1948),细胞,notion,0,1,1,0,1,1,0.004718,4,0.258401,0.266227,0
绊脚石(1948),绊脚石,notion,0,1,1,0,1,1,0.011322,4,0.269061,0.285394,0
经不起(1948),经不起,notion,0,1,1,0,1,1,0.009755,4,0.266617,0.281135,0
经历(1948),经历,notion,0,2,2,0,2,2,0.021756,4,0.286964,0.314433,2044.761444
经委会(1948),经委会,notion,0,1,1,0,1,1,0.009755,4,0.266617,0.281135,0
经济危机(1948),经济危机,notion,0,4,4,0,4,4,0.028267,4,0.287425,0.315242,3567.203068
经济委员会(1948),经济委员会,notion,0,2,2,0,2,2,0.019569,4,0.280598,0.30455,1193.220239
经济学(1948),经济学,notion,0,4,4,0,6,6,0.041325,4,0.316884,0.355672,10324.714445
经济学说(1948),经济学说,notion,0,1,1,0,1,1,0.011322,4,0.269061,0.285394,0
经济恐慌(1948),经济恐慌,notion,0,1,1,0,2,2,0.009739,4,0.265806,0.279704,0
经济战线(1948),经济战线,notion,0,1,1,0,1,1,0.005017,4,0.257497,0.26453,0
经济部长(1948),经济部长,notion,0,1,1,0,1,1,0.016518,4,0.278724,0.3015,0
经管(1948),经管,notion,0,1,1,0,1,1,0.011322,4,0.269061,0.285394,0
经纬(1948),经纬,notion,0,1,1,0,1,1,0.008247,4,0.26379,0.27611,0
经营(1948),经营,notion,0,1,1,0,1,1,0.004718,4,0.258401,0.266227,0
经验主义(1948),经验主义,notion,0,1,1,0,1,1,0.016518,4,0.278724,0.3015,0
经验谈(1948),经验谈,notion,0,1,1,0,1,1,0.009751,4,0.267186,0.282133,0
绒线衫(1948),绒线衫,notion,0,1,1,0,1,1,0.004718,4,0.258401,0.266227,0
结合(1948),结合,notion,0,1,1,0,1,1,0.009751,4,0.267186,0.282133,0
结局(1948),结局,notion,0,1,1,0,1,1,0.009755,4,0.266617,0.281135,0
结束(1948),结束,notion,0,2,2,0,2,2,0.017267,4,0.279595,0.302953,2297.821122
结构(1948),结构,notion,0,1,1,0,1,1,0.011322,4,0.269061,0.285394,0
结果(1948),结果,notion,0,1,1,0,1,1,0.009755,4,0.266617,0.281135,0
结汇(1948),结汇,notion,0,3,3,0,3,3,0.036724,4,0.31142,0.348696,6661.412091
结算(1948),结算,notion,0,1,1,0,1,1,0.016752,4,0.279138,0.302165,0
结论(1948),结论,notion,0,3,3,0,3,3,0.04349,4,0.321192,0.360908,6041.296212
绘画(1948),绘画,notion,0,1,1,0,1,1,0.009755,4,0.266617,0.281135,0
给予(1948),给予,notion,0,2,2,0,2,2,0.027839,4,0.295962,0.327676,1920.33989
给钱(1948),给钱,notion,0,1,1,0,1,1,0.01022,4,0.267243,0.282233,0
绝俗(1948),绝俗,notion,0,1,1,0,1,1,0.01424,4,0.275514,0.296275,0
绝句(1948),绝句,notion,0,2,2,0,2,2,0.022141,4,0.285959,0.312902,1122.074528
绝妙(1948),绝妙,notion,0,1,1,0,1,1,0.01424,4,0.275514,0.296275,0
绝技(1948),绝技,notion,0,1,1,0,1,1,0.01022,4,0.267243,0.282233,0
绝望(1948),绝望,notion,0,2,2,0,2,2,0.012965,4,0.271708,0.289975,1825.821004
绝灭(1948),绝灭,notion,0,1,1,0,1,1,0.005017,4,0.257497,0.26453,0
绝食(1948),绝食,notion,0,1,1,0,1,1,0.009739,4,0.265806,0.279704,0
统一性(1948),统一性,notion,0,1,1,0,1,1,0.01424,4,0.275514,0.296275,0
统一战线(1948),统一战线,notion,0,5,5,0,11,11,0.055266,4,0.339448,0.381949,17059.940487
统计(1948),统计,notion,0,3,3,0,4,4,0.023555,4,0.288484,0.316784,5268.923885
绥线(1948),绥线,notion,0,1,1,0,1,1,0.016518,4,0.278724,0.3015,0
绥远(1948),绥远,notion,0,1,1,0,1,1,0.016752,4,0.279138,0.302165,0
绥靖(1948),绥靖,notion,0,2,2,0,3,3,0.026738,4,0.294408,0.325447,1993.868267
绥靖区(1948),绥靖区,notion,0,1,1,0,1,1,0.016752,4,0.279138,0.302165,0
继往开来(1948),继往开来,notion,0,1,1,0,1,1,0.004718,4,0.258401,0.266227,0
继承人(1948),继承人,notion,0,1,1,0,1,1,0.009755,4,0.266617,0.281135,0
继替(1948),继替,notion,0,1,1,0,1,1,0.011322,4,0.269061,0.285394,0
继续(1948),继续,notion,0,2,2,0,2,2,0.021061,4,0.283157,0.308576,1336.570675
绩溪(1948),绩溪,notion,0,1,1,0,1,1,0.016752,4,0.279138,0.302165,0
续上(1948),续上,notion,0,1,1,0,1,1,0.01424,4,0.275514,0.296275,0
续篇(1948),续篇,notion,0,1,1,0,1,1,0.009739,4,0.265806,0.279704,0
续闻(1948),续闻,notion,0,1,1,0,1,1,0.016518,4,0.278724,0.3015,0
维亚(1948),维亚,notion,0,1,1,0,1,1,0.007515,4,0.262793,0.274313,0
维利(1948),维利,notion,0,1,1,0,1,1,0.016518,4,0.278724,0.3015,0
维持(1948),维持,notion,0,1,1,0,1,1,0.008247,4,0.26379,0.27611,0
维柯(1948),维柯,notion,0,1,1,0,1,1,0.009755,4,0.266617,0.281135,0
缅共(1948),缅共,notion,0,1,1,0,1,1,0.016518,4,0.278724,0.3015,0
缅甸(1948),缅甸,notion,0,5,5,0,10,10,0.05125,4,0.327607,0.368639,12811.331785
编写(1948),编写,notion,0,1,1,0,1,1,0.009751,4,0.267186,0.282133,0
编辑(1948),编辑,notion,0,3,3,0,4,4,0.039005,4,0.316377,0.354985,7012.292377
缘起(1948),缘起,notion,0,1,1,0,1,1,0.01424,4,0.275514,0.296275,0
缤纷(1948),缤纷,notion,0,1,1,0,1,1,0.016752,4,0.279138,0.302165,0
缩小(1948),缩小,notion,0,1,1,0,1,1,0.01424,4,0.275514,0.296275,0
缩影(1948),缩影,notion,0,1,1,0,1,1,0.016752,4,0.279138,0.302165,0
缩短(1948),缩短,notion,0,1,1,0,1,1,0.01424,4,0.275514,0.296275,0
缴获(1948),缴获,notion,0,1,1,0,1,1,0.016518,4,0.278724,0.3015,0
缴费(1948),缴费,notion,0,1,1,0,1,1,0.016752,4,0.279138,0.302165,0
缺点(1948),缺点,notion,0,1,1,0,1,1,0.016518,4,0.278724,0.3015,0
网罗(1948),网罗,notion,0,1,1,0,1,1,0.009755,4,0.266617,0.281135,0
罕见(1948),罕见,notion,0,1,1,0,1,1,0.009751,4,0.267186,0.282133,0
罗伯慈(1948),罗伯慈,notion,0,1,1,0,1,1,0.005017,4,0.257497,0.26453,0
罗佛宫(1948),罗佛宫,notion,0,1,1,0,1,1,0.01424,4,0.275514,0.296275,0
罗哈斯(1948),罗哈斯,notion,0,2,2,0,2,2,0.026257,4,0.292073,0.322053,1522.40889
罗城(1948),罗城,notion,0,1,1,0,1,1,0.016518,4,0.278724,0.3015,0
罗宝树(1948),罗宝树,notion,0,1,1,0,1,1,0.01424,4,0.275514,0.296275,0
罗果(1948),罗果,notion,0,1,1,0,1,1,0.009755,4,0.266617,0.281135,0
罗果夫(1948),罗果夫,notion,0,1,1,0,1,1,0.009755,4,0.266617,0.281135,0
罗申(1948),罗申,notion,0,1,1,0,1,1,0.009739,4,0.265806,0.279704,0
罗马(1948),罗马,notion,0,2,2,0,2,2,0.01727,4,0.278352,0.300956,1619.09855
罗马尼亚(1948),罗马尼亚,notion,0,4,4,0,7,7,0.032027,4,0.297603,0.330117,6572.414447
罗鸿涛(1948),罗鸿涛,notion,0,1,1,0,1,1,0.01424,4,0.275514,0.296275,0
罢工(1948),罢工,notion,0,3,3,0,3,3,0.043009,4,0.318172,0.357214,5224.220047
罢教(1948),罢教,notion,0,2,2,0,2,2,0.014757,4,0.271708,0.289975,655.261449
罢考(1948),罢考,notion,0,1,1,0,1,1,0.01022,4,0.267243,0.282233,0
罪与罚(1948),罪与罚,notion,0,1,1,0,1,1,0.01022,4,0.267243,0.282233,0
罪恶(1948),罪恶,notion,0,4,4,0,4,4,0.04876,4,0.332272,0.373941,12956.753204
罪案(1948),罪案,notion,0,1,1,0,1,1,0.008247,4,0.26379,0.27611,0
罪行(1948),罪行,notion,0,3,3,0,3,3,0.043024,4,0.320397,0.359943,6104.778372
罪言(1948),罪言,notion,0,1,1,0,1,1,0.004718,4,0.258401,0.266227,0
罪魁祸首(1948),罪魁祸首,notion,0,2,2,0,2,2,0.024765,4,0.291552,0.321288,2097.245087
置於(1948),置於,notion,0,1,1,0,1,1,0.01424,4,0.275514,0.296275,0
羊城(1948),羊城,notion,0,1,1,0,1,1,0.009739,4,0.265806,0.279704,0
羊头(1948),羊头,notion,0,1,1,0,1,1,0.01424,4,0.275514,0.296275,0
美一(1948),美一,notion,0,1,1,0,1,1,0.009739,4,0.265806,0.279704,0
美专(1948),美专,notion,0,1,1,0,1,1,0.005017,4,0.257497,0.26453,0
美丽(1948),美丽,notion,0,2,2,0,2,2,0.021756,4,0.286964,0.314433,2044.761444
美之盾(1948),美之盾,notion,0,1,1,0,1,1,0.01022,4,0.267243,0.282233,0
美京(1948),美京,notion,0,1,1,0,1,1,0.016518,4,0.278724,0.3015,0
美人(1948),美人,notion,0,2,2,0,2,2,0.01996,4,0.281333,0.305715,1305.273912
美以(1948),美以,notion,0,1,1,0,1,1,0.009739,4,0.265806,0.279704,0
美会(1948),美会,notion,0,1,1,0,1,1,0.016752,4,0.279138,0.302165,0
美侨(1948),美侨,notion,0,1,1,0,1,1,0.01022,4,0.267243,0.282233,0
美元(1948),美元,notion,0,1,1,0,4,4,0.009755,4,0.266617,0.281135,0
美兵(1948),美兵,notion,0,2,2,0,2,2,0.026738,4,0.294408,0.325447,1993.868267
美军(1948),美军,notion,0,2,2,0,3,3,0.033269,4,0.305692,0.34112,2297.98609
美利坚(1948),美利坚,notion,0,1,1,0,1,1,0.009751,4,0.267186,0.282133,0
美到(1948),美到,notion,0,1,1,0,1,1,0.005017,4,0.257497,0.26453,0
美制(1948),美制,notion,0,1,1,0,1,1,0.009751,4,0.267186,0.282133,0
美助(1948),美助,notion,0,1,1,0,1,1,0.016752,4,0.279138,0.302165,0
美商(1948),美商,notion,0,1,1,0,1,1,0.016752,4,0.279138,0.302165,0
美国化(1948),美国化,notion,0,1,1,0,1,1,0.009755,4,0.266617,0.281135,0
美国国会(1948),美国国会,notion,0,1,1,0,2,2,0.007515,4,0.262793,0.274313,0
美国政府(1948),美国政府,notion,0,1,1,0,1,1,0.008247,4,0.26379,0.27611,0
美国版(1948),美国版,notion,0,1,1,0,1,1,0.009755,4,0.266617,0.281135,0
美展(1948),美展,notion,0,1,1,0,1,1,0.016752,4,0.279138,0.302165,0
美帝国主义(1948),美帝国主义,notion,0,3,3,0,4,4,0.036012,4,0.306365,0.342074,4567.575323
美日(1948),美日,notion,0,2,2,0,2,2,0.019258,4,0.282157,0.307012,1389.971062
美是(1948),美是,notion,0,1,1,0,1,1,0.016752,4,0.279138,0.302165,0
美棉(1948),美棉,notion,0,1,1,0,4,4,0.004718,4,0.258401,0.266227,0
美洲(1948),美洲,notion,0,1,1,0,1,1,0.01022,4,0.267243,0.282233,0
美的(1948),美的,notion,0,1,1,0,1,1,0.016518,4,0.278724,0.3015,0
美舰(1948),美舰,notion,0,1,1,0,1,1,0.009739,4,0.265806,0.279704,0
美苏关系(1948),美苏关系,notion,0,3,3,0,4,4,0.036727,4,0.309444,0.346133,5617.048602
美英(1948),美英,notion,0,1,1,0,2,2,0.009755,4,0.266617,0.281135,0
美蒋(1948),美蒋,notion,0,1,1,0,2,2,0.016518,4,0.278724,0.3015,0
美访(1948),美访,notion,0,1,1,0,1,1,0.016752,4,0.279138,0.302165,0
美货(1948),美货,notion,0,1,1,0,1,1,0.016518,4,0.278724,0.3015,0
美贷(1948),美贷,notion,0,2,2,0,2,2,0.017736,4,0.278993,0.301988,1631.559673
美金(1948),美金,notion,0,1,1,0,2,2,0.016518,4,0.278724,0.3015,0
美间(1948),美间,notion,0,1,1,0,1,1,0.016518,4,0.278724,0.3015,0
羔羊(1948),羔羊,notion,0,1,1,0,1,1,0.009751,4,0.267186,0.282133,0
羣衆(1948),羣衆,notion,0,1,1,0,1,1,0.01424,4,0.275514,0.296275,0
群众(1948),群众,notion,0,4,4,0,7,7,0.04096,4,0.317018,0.355839,11949.195088
群众观点(1948),群众观点,notion,0,1,1,0,1,1,0.009751,4,0.267186,0.282133,0
群情(1948),群情,notion,0,1,1,0,1,1,0.009751,4,0.267186,0.282133,0
群英会(1948),群英会,notion,0,1,1,0,1,1,0.01022,4,0.267243,0.282233,0
翁文灏(1948),翁文灏,notion,0,3,3,0,4,4,0.033809,4,0.305096,0.340377,5463.518126
翁松禅(1948),翁松禅,notion,0,1,1,0,1,1,0.007515,4,0.262793,0.274313,0
翁氏(1948),翁氏,notion,0,1,1,0,1,1,0.016752,4,0.279138,0.302165,0
翦伯赞(1948),翦伯赞,notion,0,1,1,0,1,1,0.01424,4,0.275514,0.296275,0
翻案(1948),翻案,notion,0,1,1,0,1,1,0.016752,4,0.279138,0.302165,0
翻版(1948),翻版,notion,0,1,1,0,1,1,0.007515,4,0.262793,0.274313,0
翻身(1948),翻身,notion,0,4,4,0,6,6,0.045763,4,0.322267,0.362261,10052.592216
老四(1948),老四,notion,0,1,1,0,1,1,0.009751,4,0.267186,0.282133,0
老太太(1948),老太太,notion,0,1,1,0,1,1,0.011322,4,0.269061,0.285394,0
老宋(1948),老宋,notion,0,1,1,0,1,1,0.009751,4,0.267186,0.282133,0
老家(1948),老家,notion,0,1,1,0,1,1,0.004718,4,0.258401,0.266227,0
老巢(1948),老巢,notion,0,1,1,0,1,1,0.01022,4,0.267243,0.282233,0
老巴夺(1948),老巴夺,notion,0,1,1,0,1,1,0.016518,4,0.278724,0.3015,0
老师(1948),老师,notion,0,2,2,0,2,2,0.026503,4,0.295799,0.327444,2668.961321
老弱(1948),老弱,notion,0,1,1,0,1,1,0.009755,4,0.266617,0.281135,0
老成(1948),老成,notion,0,1,1,0,1,1,0.011322,4,0.269061,0.285394,0
老朋友(1948),老朋友,notion,0,1,1,0,1,1,0.016518,4,0.278724,0.3015,0
老百姓(1948),老百姓,notion,0,4,4,0,6,6,0.04733,4,0.325534,0.366154,10603.003417
老虎(1948),老虎,notion,0,2,2,0,2,2,0.019972,4,0.283949,0.309807,2243.008915
老调(1948),老调,notion,0,1,1,0,1,1,0.009755,4,0.266617,0.281135,0
老释(1948),老释,notion,0,1,1,0,1,1,0.007515,4,0.262793,0.274313,0
老闆(1948),老闆,notion,0,2,2,0,2,2,0.033269,4,0.305692,0.34112,2297.98609
考区(1948),考区,notion,0,1,1,0,2,2,0.011322,4,0.269061,0.285394,0
考大学(1948),考大学,notion,0,1,1,0,1,1,0.01424,4,0.275514,0.296275,0
考察团(1948),考察团,notion,0,1,1,0,1,1,0.011322,4,0.269061,0.285394,0
考灾(1948),考灾,notion,0,1,1,0,1,1,0.016752,4,0.279138,0.302165,0
考生(1948),考生,notion,0,1,1,0,1,1,0.011322,4,0.269061,0.285394,0
考茨基(1948),考茨基,notion,0,1,1,0,1,1,0.007515,4,0.262793,0.274313,0
考试(1948),考试,notion,0,1,1,0,1,1,0.009755,4,0.266617,0.281135,0
考铨(1948),考铨,notion,0,1,1,0,1,1,0.011322,4,0.269061,0.285394,0
而乱(1948),而乱,notion,0,1,1,0,1,1,0.016752,4,0.279138,0.302165,0
而作(1948),而作,notion,0,3,3,0,3,3,0.043024,4,0.320397,0.359943,6104.778372
而发(1948),而发,notion,0,1,1,0,1,1,0.016752,4,0.279138,0.302165,0
而已(1948),而已,notion,0,1,1,0,1,1,0.008247,4,0.26379,0.27611,0
而战(1948),而战,notion,0,2,2,0,3,3,0.026269,4,0.293695,0.324415,1931.353166
而是(1948),而是,notion,0,2,2,0,2,2,0.024267,4,0.290987,0.320456,2179.633602
而来(1948),而来,notion,0,1,1,0,1,1,0.016752,4,0.279138,0.302165,0
而鬥争(1948),而鬥争,notion,0,1,1,0,3,3,0.016518,4,0.278724,0.3015,0
耍花枪(1948),耍花枪,notion,0,1,1,0,1,1,0.016752,4,0.279138,0.302165,0
耕地(1948),耕地,notion,0,1,1,0,1,1,0.009751,4,0.267186,0.282133,0
耕田(1948),耕田,notion,0,1,1,0,1,1,0.009751,4,0.267186,0.282133,0
耕者(1948),耕者,notion,0,1,1,0,1,1,0.008247,4,0.26379,0.27611,0
耕者有其田(1948),耕者有其田,notion,0,3,3,0,3,3,0.025983,4,0.291461,0.32121,4592.958268
耕耘(1948),耕耘,notion,0,1,1,0,1,1,0.004718,4,0.258401,0.266227,0
耶诞节(1948),耶诞节,notion,0,1,1,0,1,1,0.016752,4,0.279138,0.302165,0
耽误(1948),耽误,notion,0,2,2,0,2,2,0.008698,4,0.258507,0.266483,0.569098
聂荣臻(1948),聂荣臻,notion,0,1,1,0,2,2,0.016518,4,0.278724,0.3015,0
聆听(1948),聆听,notion,0,1,1,0,1,1,0.016518,4,0.278724,0.3015,0
职业(1948),职业,notion,0,5,5,0,8,8,0.059199,4,0.347486,0.390468,18670.989863
职业指导(1948),职业指导,notion,0,1,1,0,1,1,0.016752,4,0.279138,0.302165,0
职位(1948),职位,notion,0,1,1,0,1,1,0.007515,4,0.262793,0.274313,0
职员(1948),职员,notion,0,1,1,0,1,1,0.01424,4,0.275514,0.296275,0
职工(1948),职工,notion,0,4,4,0,10,10,0.052764,4,0.333274,0.375072,10282.282394
职权(1948),职权,notion,0,1,1,0,1,1,0.01424,4,0.275514,0.296275,0
职青(1948),职青,notion,0,1,1,0,1,1,0.016752,4,0.279138,0.302165,0
联共(1948),联共,notion,0,1,1,0,2,2,0.009755,4,0.266617,0.281135,0
联合会(1948),联合会,notion,0,3,3,0,3,3,0.043024,4,0.320397,0.359943,6104.778372
联合国大会(1948),联合国大会,notion,0,5,5,0,5,5,0.064097,4,0.356455,0.399519,20372.332668
联合国安全理事会(1948),联合国安全理事会,notion,0,1,1,0,1,1,0.009755,4,0.266617,0.281135,0
联合政府(1948),联合政府,notion,0,2,2,0,2,2,0.021535,4,0.28397,0.309841,889.229879
联想(1948),联想,notion,0,1,1,0,1,1,0.01424,4,0.275514,0.296275,0
联系(1948),联系,notion,0,1,1,0,1,1,0.004718,4,0.258401,0.266227,0
联组(1948),联组,notion,0,1,1,0,1,1,0.011322,4,0.269061,0.285394,0
联谊(1948),联谊,notion,0,1,1,0,1,1,0.004718,4,0.258401,0.266227,0
联谊会(1948),联谊会,notion,0,1,1,0,1,1,0.01022,4,0.267243,0.282233,0
联防(1948),联防,notion,0,3,3,0,4,4,0.030813,4,0.299741,0.333056,5228.901472
聘请(1948),聘请,notion,0,1,1,0,1,1,0.011322,4,0.269061,0.285394,0
聪明(1948),聪明,notion,0,1,1,0,1,1,0.008247,4,0.26379,0.27611,0
肃清(1948),肃清,notion,0,3,3,0,4,4,0.034751,4,0.30858,0.345002,6495.94151
育才(1948),育才,notion,0,4,4,0,4,4,0.030167,4,0.294039,0.325026,5855.905557
胆大(1948),胆大,notion,0,1,1,0,1,1,0.016752,4,0.279138,0.302165,0
胆怯(1948),胆怯,notion,0,1,1,0,1,1,0.016518,4,0.278724,0.3015,0
背影(1948),背影,notion,0,1,1,0,1,1,0.008247,4,0.26379,0.27611,0
背教(1948),背教,notion,0,1,1,0,1,1,0.016752,4,0.279138,0.302165,0
背景(1948),背景,notion,0,2,2,0,4,4,0.017736,4,0.278993,0.301988,1631.559673
胖吗(1948),胖吗,notion,0,1,1,0,1,1,0.016518,4,0.278724,0.3015,0
胡不归(1948),胡不归,notion,0,1,1,0,1,1,0.016752,4,0.279138,0.302165,0
胡乱(1948),胡乱,notion,0,1,1,0,1,1,0.01424,4,0.275514,0.296275,0
胡佛(1948),胡佛,notion,0,1,1,0,1,1,0.009755,4,0.266617,0.281135,0
胡宗南(1948),胡宗南,notion,0,1,1,0,1,1,0.01022,4,0.267243,0.282233,0
胡林翼(1948),胡林翼,notion,0,1,1,0,1,1,0.007515,4,0.262793,0.274313,0
胡蝶(1948),胡蝶,notion,0,1,1,0,1,1,0.01424,4,0.275514,0.296275,0
胡说(1948),胡说,notion,0,2,2,0,2,2,0.030758,4,0.303347,0.337959,2812.221703
胶东(1948),胶东,notion,0,1,1,0,3,3,0.016518,4,0.278724,0.3015,0
能制(1948),能制,notion,0,1,1,0,1,1,0.008247,4,0.26379,0.27611,0
能力(1948),能力,notion,0,1,1,0,1,1,0.008247,4,0.26379,0.27611,0
能够(1948),能够,notion,0,4,4,0,4,4,0.043561,4,0.323293,0.363492,12771.456753
能救(1948),能救,notion,0,1,1,0,1,1,0.007515,4,0.262793,0.274313,0
脉膊(1948),脉膊,notion,0,1,1,0,1,1,0.009739,4,0.265806,0.279704,0
脑力(1948),脑力,notion,0,1,1,0,1,1,0.016518,4,0.278724,0.3015,0
脑力劳动者(1948),脑力劳动者,notion,0,2,2,0,2,2,0.026269,4,0.293695,0.324415,1931.353166
脑海(1948),脑海,notion,0,1,1,0,1,1,0.002332,4,0.253398,0.256677,0
脱口而出(1948),脱口而出,notion,0,1,1,0,1,1,0.016518,4,0.278724,0.3015,0
脱希(1948),脱希,notion,0,1,1,0,1,1,0.007515,4,0.262793,0.274313,0
脱手(1948),脱手,notion,0,1,1,0,1,1,0.01424,4,0.275514,0.296275,0
脱旧(1948),脱旧,notion,0,1,1,0,1,1,0.016518,4,0.278724,0.3015,0
脱裤子(1948),脱裤子,notion,0,1,1,0,1,1,0.016518,4,0.278724,0.3015,0
脸谱(1948),脸谱,notion,0,2,2,0,2,2,0.030758,4,0.303347,0.337959,2812.221703
腐蚀(1948),腐蚀,notion,0,1,1,0,1,1,0.01424,4,0.275514,0.296275,0
膨胀(1948),膨胀,notion,0,2,2,0,2,2,0.024033,4,0.291281,0.320888,2559.028705
自从(1948),自从,notion,0,1,1,0,1,1,0.009739,4,0.265806,0.279704,0
自任(1948),自任,notion,0,1,1,0,1,1,0.01424,4,0.275514,0.296275,0
自供(1948),自供,notion,0,2,2,0,2,2,0.026272,4,0.29319,0.323683,1793.896368
自力更生(1948),自力更生,notion,0,1,1,0,1,1,0.01424,4,0.275514,0.296275,0
自动(1948),自动,notion,0,2,2,0,2,2,0.024461,4,0.291756,0.321587,2304.72473
自助(1948),自助,notion,0,1,1,0,1,1,0.01424,4,0.275514,0.296275,0
自卫(1948),自卫,notion,0,3,3,0,3,3,0.040509,4,0.319498,0.358845,7911.780437
自卫军(1948),自卫军,notion,0,1,1,0,1,1,0.016518,4,0.278724,0.3015,0
自卫队(1948),自卫队,notion,0,1,1,0,1,1,0.01022,4,0.267243,0.282233,0
自在(1948),自在,notion,0,1,1,0,1,1,0.016752,4,0.279138,0.302165,0
自家(1948),自家,notion,0,1,1,0,1,1,0.004718,4,0.258401,0.266227,0
自已(1948),自已,notion,0,1,1,0,1,1,0.009751,4,0.267186,0.282133,0
自强不息(1948),自强不息,notion,0,2,2,0,2,2,0.008698,4,0.258507,0.266483,0.569098
自我(1948),自我,notion,0,2,2,0,2,2,0.016573,4,0.278249,0.30079,1169.878765
自我批评(1948),自我批评,notion,0,3,3,0,3,3,0.036024,4,0.308631,0.345069,5629.029515
自我检讨(1948),自我检讨,notion,0,1,1,0,1,1,0.009751,4,0.267186,0.282133,0
自掘坟墓(1948),自掘坟墓,notion,0,1,1,0,1,1,0.016752,4,0.279138,0.302165,0
自救(1948),自救,notion,0,3,3,0,3,3,0.040744,4,0.321908,0.361773,8749.552586
自杀(1948),自杀,notion,0,2,2,0,2,2,0.026972,4,0.293947,0.324781,1749.441854
自然(1948),自然,notion,0,1,1,0,1,1,0.011322,4,0.269061,0.285394,0
自然主义(1948),自然主义,notion,0,1,1,0,1,1,0.01424,4,0.275514,0.296275,0
自由区(1948),自由区,notion,0,1,1,0,1,1,0.009755,4,0.266617,0.281135,0
自由竞争(1948),自由竞争,notion,0,1,1,0,1,1,0.01424,4,0.275514,0.296275,0
自白(1948),自白,notion,0,4,4,0,4,4,0.036537,4,0.303127,0.33777,5015.80301
自耕农(1948),自耕农,notion,0,1,1,0,1,1,0.01022,4,0.267243,0.282233,0
自认(1948),自认,notion,0,1,1,0,1,1,0.016752,4,0.279138,0.302165,0
自请(1948),自请,notion,0,1,1,0,1,1,0.011322,4,0.269061,0.285394,0
自费留学(1948),自费留学,notion,0,1,1,0,1,1,0.008247,4,0.26379,0.27611,0
自述(1948),自述,notion,0,2,2,0,2,2,0.021076,4,0.284616,0.310839,1735.877057
自食其果(1948),自食其果,notion,0,2,2,0,2,2,0.008698,4,0.258507,0.266483,0.569098
自首(1948),自首,notion,0,1,1,0,1,1,0.008247,4,0.26379,0.27611,0
至今(1948),至今,notion,0,1,1,0,1,1,0.01424,4,0.275514,0.296275,0
至少(1948),至少,notion,0,1,1,0,1,1,0.01424,4,0.275514,0.296275,0
致书(1948),致书,notion,0,1,1,0,1,1,0.009739,4,0.265806,0.279704,0
致函(1948),致函,notion,0,1,1,0,1,1,0.009739,4,0.265806,0.279704,0
致命伤(1948),致命伤,notion,0,1,1,0,1,1,0.008247,4,0.26379,0.27611,0
致电(1948),致电,notion,0,1,1,0,2,2,0.016518,4,0.278724,0.3015,0
致词(1948),致词,notion,0,1,1,0,1,1,0.005389,4,0.25849,0.266394,0
致辞(1948),致辞,notion,0,1,1,0,1,1,0.016752,4,0.279138,0.302165,0
舆爱(1948),舆爱,notion,0,1,1,0,1,1,0.011322,4,0.269061,0.285394,0
舆论(1948),舆论,notion,0,3,3,0,3,3,0.039239,4,0.316724,0.355417,6944.905464
舐犊情深(1948),舐犊情深,notion,0,1,1,0,1,1,0.016752,4,0.279138,0.302165,0
舒适(1948),舒适,notion,0,1,1,0,1,1,0.009755,4,0.266617,0.281135,0
舞女(1948),舞女,notion,0,1,1,0,1,1,0.01022,4,0.267243,0.282233,0
舞弊(1948),舞弊,notion,0,1,1,0,1,1,0.01424,4,0.275514,0.296275,0
航信(1948),航信,notion,0,1,1,0,1,1,0.009739,4,0.265806,0.279704,0
航权(1948),航权,notion,0,1,1,0,1,1,0.01022,4,0.267243,0.282233,0
航空母舰(1948),航空母舰,notion,0,1,1,0,1,1,0.005389,4,0.25849,0.266394,0
航行权(1948),航行权,notion,0,1,1,0,2,2,0.01022,4,0.267243,0.282233,0
航讯(1948),航讯,notion,0,2,2,0,4,4,0.026491,4,0.291937,0.321853,1403.825067
船上(1948),船上,notion,0,2,2,0,2,2,0.027839,4,0.295962,0.327676,1920.33989
船坞(1948),船坞,notion,0,1,1,0,1,1,0.009751,4,0.267186,0.282133,0
船票(1948),船票,notion,0,1,1,0,1,1,0.01424,4,0.275514,0.296275,0
良好(1948),良好,notion,0,1,1,0,1,1,0.011322,4,0.269061,0.285394,0
良心话(1948),良心话,notion,0,1,1,0,1,1,0.01424,4,0.275514,0.296275,0
良机(1948),良机,notion,0,1,1,0,1,1,0.01424,4,0.275514,0.296275,0
艰辛(1948),艰辛,notion,0,1,1,0,1,1,0.016752,4,0.279138,0.302165,0
艰险(1948),艰险,notion,0,1,1,0,1,1,0.01424,4,0.275514,0.296275,0
艰难(1948),艰难,notion,0,2,2,0,2,2,0.015129,4,0.273409,0.292837,905.025109
色彩(1948),色彩,notion,0,1,1,0,1,1,0.01424,4,0.275514,0.296275,0
艳迹(1948),艳迹,notion,0,1,1,0,1,1,0.016752,4,0.279138,0.302165,0
艳阳天(1948),艳阳天,notion,0,1,1,0,1,1,0.016752,4,0.279138,0.302165,0
艺人(1948),艺人,notion,0,1,1,0,1,1,0.009755,4,0.266617,0.281135,0
艺坛(1948),艺坛,notion,0,1,1,0,1,1,0.009755,4,0.266617,0.281135,0
艺术史(1948),艺术史,notion,0,1,1,0,1,1,0.01424,4,0.275514,0.296275,0
艺术家(1948),艺术家,notion,0,4,4,0,4,4,0.028192,4,0.288219,0.31644,4274.616876
艺术工作者(1948),艺术工作者,notion,0,1,1,0,1,1,0.009751,4,0.267186,0.282133,0
艾德礼(1948),艾德礼,notion,0,1,1,0,1,1,0.009755,4,0.266617,0.281135,0
艾特礼的(1948),艾特礼的,notion,0,1,1,0,1,1,0.007515,4,0.262793,0.274313,0
节制(1948),节制,notion,0,1,1,0,1,1,0.01424,4,0.275514,0.296275,0
节在(1948),节在,notion,0,1,1,0,1,1,0.016752,4,0.279138,0.302165,0
节录(1948),节录,notion,0,1,1,0,1,1,0.009755,4,0.266617,0.281135,0
节日(1948),节日,notion,0,1,1,0,1,1,0.009751,4,0.267186,0.282133,0
节约(1948),节约,notion,0,3,3,0,6,6,0.022938,4,0.283542,0.309231,2406.045322
节而作(1948),节而作,notion,0,1,1,0,1,1,0.016518,4,0.278724,0.3015,0
芜湖(1948),芜湖,notion,0,1,1,0,1,1,0.016752,4,0.279138,0.302165,0
芝加哥(1948),芝加哥,notion,0,1,1,0,1,1,0.005017,4,0.257497,0.26453,0
芦田(1948),芦田,notion,0,2,2,0,2,2,0.019494,4,0.280535,0.30445,1251.270065
芦田到(1948),芦田到,notion,0,2,2,0,2,2,0.033269,4,0.305692,0.34112,2297.98609
芦田均(1948),芦田均,notion,0,1,1,0,1,1,0.009739,4,0.265806,0.279704,0
花园(1948),花园,notion,0,1,1,0,1,1,0.008247,4,0.26379,0.27611,0
花旗(1948),花旗,notion,0,1,1,0,1,1,0.016518,4,0.278724,0.3015,0
花果(1948),花果,notion,0,1,1,0,1,1,0.009755,4,0.266617,0.281135,0
花样(1948),花样,notion,0,1,1,0,1,1,0.01022,4,0.267243,0.282233,0
花沙布代(1948),花沙布代,notion,0,1,1,0,1,1,0.01424,4,0.275514,0.296275,0
花溪(1948),花溪,notion,0,1,1,0,1,1,0.016518,4,0.278724,0.3015,0
花鸟(1948),花鸟,notion,0,1,1,0,1,1,0.004718,4,0.258401,0.266227,0
芸香(1948),芸香,notion,0,1,1,0,1,1,0.011322,4,0.269061,0.285394,0
苍蝇(1948),苍蝇,notion,0,1,1,0,1,1,0.008247,4,0.26379,0.27611,0
苏与(1948),苏与,notion,0,1,1,0,2,2,0.009755,4,0.266617,0.281135,0
苏军(1948),苏军,notion,0,1,1,0,2,2,0.009755,4,0.266617,0.281135,0
苏前(1948),苏前,notion,0,1,1,0,1,1,0.01022,4,0.267243,0.282233,0
苏岛(1948),苏岛,notion,0,1,1,0,1,1,0.005017,4,0.257497,0.26453,0
苏州(1948),苏州,notion,0,2,2,0,2,2,0.033269,4,0.305692,0.34112,2297.98609
苏志(1948),苏志,notion,0,1,1,0,1,1,0.009751,4,0.267186,0.282133,0
苏柯(1948),苏柯,notion,0,1,1,0,1,1,0.009755,4,0.266617,0.281135,0
苏武(1948),苏武,notion,0,1,1,0,1,1,0.005017,4,0.257497,0.26453,0
苏维埃(1948),苏维埃,notion,0,3,3,0,5,5,0.033788,4,0.305692,0.341175,5972.023623
苏维埃社会主义共和国(1948),苏维埃社会主义共和国,notion,0,1,1,0,2,2,0.009755,4,0.266617,0.281135,0
苏美(1948),苏美,notion,0,1,1,0,1,1,0.009755,4,0.266617,0.281135,0
苏联部长会议(1948),苏联部长会议,notion,0,1,1,0,1,1,0.009755,4,0.266617,0.281135,0
苗山(1948),苗山,notion,0,1,1,0,1,1,0.009751,4,0.267186,0.282133,0
苗民之歌(1948),苗民之歌,notion,0,1,1,0,1,1,0.009751,4,0.267186,0.282133,0
苦恼(1948),苦恼,notion,0,1,1,0,1,1,0.004718,4,0.258401,0.266227,0
苦撑(1948),苦撑,notion,0,3,3,0,3,3,0.031893,4,0.30298,0.337515,5016.736167
苦肉计(1948),苦肉计,notion,0,1,1,0,1,1,0.016518,4,0.278724,0.3015,0
苦闷(1948),苦闷,notion,0,5,5,0,6,6,0.046992,4,0.317554,0.35656,9162.359996
苦难(1948),苦难,notion,0,5,5,0,13,13,0.055093,4,0.337678,0.380019,15642.237639
苦鬥(1948),苦鬥,notion,0,1,1,0,1,1,0.011322,4,0.269061,0.285394,0
英伊(1948),英伊,notion,0,1,1,0,1,1,0.009739,4,0.265806,0.279704,0
英共(1948),英共,notion,0,1,1,0,1,1,0.009739,4,0.265806,0.279704,0
英勇(1948),英勇,notion,0,1,1,0,1,1,0.016518,4,0.278724,0.3015,0
英国人(1948),英国人,notion,0,2,2,0,2,2,0.021076,4,0.284616,0.310839,1735.877057
英国工党(1948),英国工党,notion,0,2,2,0,2,2,0.01727,4,0.278352,0.300956,1619.09855
英姿(1948),英姿,notion,0,1,1,0,1,1,0.016518,4,0.278724,0.3015,0
英属(1948),英属,notion,0,1,1,0,1,1,0.009739,4,0.265806,0.279704,0
英方(1948),英方,notion,0,1,1,0,1,1,0.011322,4,0.269061,0.285394,0
英澳(1948),英澳,notion,0,1,1,0,1,1,0.016752,4,0.279138,0.302165,0
英镑(1948),英镑,notion,0,1,1,0,1,1,0.009755,4,0.266617,0.281135,0
英雄(1948),英雄,notion,0,3,3,0,3,3,0.029246,4,0.296593,0.32863,4804.933793
英雄本色(1948),英雄本色,notion,0,1,1,0,1,1,0.01424,4,0.275514,0.296275,0
英首相(1948),英首相,notion,0,1,1,0,1,1,0.007515,4,0.262793,0.274313,0
茅凹(1948),茅凹,notion,0,1,1,0,1,1,0.016518,4,0.278724,0.3015,0
茅盾(1948),茅盾,notion,0,1,1,0,2,2,0.016752,4,0.279138,0.302165,0
茫茫(1948),茫茫,notion,0,2,2,0,2,2,0.024765,4,0.291552,0.321288,2097.245087
草婴译(1948),草婴译,notion,0,1,1,0,1,1,0.009755,4,0.266617,0.281135,0
草率(1948),草率,notion,0,1,1,0,1,1,0.011322,4,0.269061,0.285394,0
草目(1948),草目,notion,0,1,1,0,1,1,0.004718,4,0.258401,0.266227,0
荒看(1948),荒看,notion,0,1,1,0,1,1,0.016752,4,0.279138,0.302165,0
荒谬(1948),荒谬,notion,0,1,1,0,3,3,0.01424,4,0.275514,0.296275,0
荒谬绝伦(1948),荒谬绝伦,notion,0,1,1,0,1,1,0.01424,4,0.275514,0.296275,0
荡漾(1948),荡漾,notion,0,1,1,0,1,1,0.008247,4,0.26379,0.27611,0
荣成湾(1948),荣成湾,notion,0,1,1,0,1,1,0.016752,4,0.279138,0.302165,0
荣膺(1948),荣膺,notion,0,1,1,0,1,1,0.01424,4,0.275514,0.296275,0
荣获(1948),荣获,notion,0,1,1,0,1,1,0.016752,4,0.279138,0.302165,0
荷兰(1948),荷兰,notion,0,1,1,0,1,1,0.009755,4,0.266617,0.281135,0
荷印(1948),荷印,notion,0,1,1,0,1,1,0.009755,4,0.266617,0.281135,0
莅临(1948),莅临,notion,0,1,1,0,1,1,0.01022,4,0.267243,0.282233,0
莫干山(1948),莫干山,notion,0,1,1,0,1,1,0.016752,4,0.279138,0.302165,0
莫此为甚(1948),莫此为甚,notion,0,1,1,0,1,1,0.008247,4,0.26379,0.27611,0
莫高窟(1948),莫高窟,notion,0,1,1,0,1,1,0.01424,4,0.275514,0.296275,0
莱翁(1948),莱翁,notion,0,1,1,0,2,2,0.009755,4,0.266617,0.281135,0
获城(1948),获城,notion,0,1,1,0,1,1,0.01424,4,0.275514,0.296275,0
获得(1948),获得,notion,0,1,1,0,1,1,0.01022,4,0.267243,0.282233,0
获胜(1948),获胜,notion,0,1,1,0,2,2,0.009739,4,0.265806,0.279704,0
菜市(1948),菜市,notion,0,1,1,0,1,1,0.008247,4,0.26379,0.27611,0
菲岛(1948),菲岛,notion,0,1,1,0,1,1,0.016518,4,0.278724,0.3015,0
菲律宾(1948),菲律宾,notion,0,1,1,0,2,2,0.016752,4,0.279138,0.302165,0
萌生(1948),萌生,notion,0,1,1,0,1,1,0.01022,4,0.267243,0.282233,0
萌芽(1948),萌芽,notion,0,1,1,0,1,1,0.016752,4,0.279138,0.302165,0
营口(1948),营口,notion,0,1,1,0,1,1,0.016518,4,0.278724,0.3015,0
营救(1948),营救,notion,0,3,3,0,4,4,0.036712,4,0.306816,0.342673,4458.540834
萧一山(1948),萧一山,notion,0,1,1,0,1,1,0.01424,4,0.275514,0.296275,0
萧伯纳(1948),萧伯纳,notion,0,2,2,0,2,2,0.021061,4,0.283157,0.308576,1336.570675
萧条(1948),萧条,notion,0,1,1,0,1,1,0.007515,4,0.262793,0.274313,0
萧洛(1948),萧洛,notion,0,1,1,0,1,1,0.009755,4,0.266617,0.281135,0
萨里(1948),萨里,notion,0,1,1,0,1,1,0.011322,4,0.269061,0.285394,0
落乡(1948),落乡,notion,0,1,1,0,1,1,0.009751,4,0.267186,0.282133,0
落伍(1948),落伍,notion,0,1,1,0,1,1,0.002332,4,0.253398,0.256677,0
落入(1948),落入,notion,0,1,1,0,1,1,0.01424,4,0.275514,0.296275,0
落后(1948),落后,notion,0,2,2,0,2,2,0.024267,4,0.290987,0.320456,2179.633602
葛柏德(1948),葛柏德,notion,0,1,1,0,1,1,0.016752,4,0.279138,0.302165,0
董事会(1948),董事会,notion,0,1,1,0,1,1,0.016752,4,0.279138,0.302165,0
董必武(1948),董必武,notion,0,1,1,0,3,3,0.016518,4,0.278724,0.3015,0
董时(1948),董时,notion,0,1,1,0,1,1,0.01022,4,0.267243,0.282233,0
蒋介石(1948),蒋介石,notion,0,1,1,0,4,4,0.016518,4,0.278724,0.3015,0
蒋俘(1948),蒋俘,notion,0,1,1,0,3,3,0.009751,4,0.267186,0.282133,0
蒋党(1948),蒋党,notion,0,1,1,0,1,1,0.009751,4,0.267186,0.282133,0
蒋军(1948),蒋军,notion,0,2,2,0,8,8,0.026269,4,0.293695,0.324415,1931.353166
蒋军降(1948),蒋军降,notion,0,1,1,0,1,1,0.009751,4,0.267186,0.282133,0
蒋匀田(1948),蒋匀田,notion,0,1,1,0,1,1,0.01424,4,0.275514,0.296275,0
蒋夫人(1948),蒋夫人,notion,0,1,1,0,1,1,0.008247,4,0.26379,0.27611,0
蒋宋(1948),蒋宋,notion,0,2,2,0,2,2,0.026269,4,0.293695,0.324415,1931.353166
蒋家(1948),蒋家,notion,0,1,1,0,2,2,0.016518,4,0.278724,0.3015,0
蒋小二(1948),蒋小二,notion,0,1,1,0,1,1,0.016518,4,0.278724,0.3015,0
蒋府(1948),蒋府,notion,0,1,1,0,1,1,0.005017,4,0.257497,0.26453,0
蒋总统(1948),蒋总统,notion,0,1,1,0,1,1,0.008247,4,0.26379,0.27611,0
蒋日(1948),蒋日,notion,0,1,1,0,1,1,0.016518,4,0.278724,0.3015,0
蒋朝(1948),蒋朝,notion,0,2,2,0,5,5,0.026269,4,0.293695,0.324415,1931.353166
蒋朝的(1948),蒋朝的,notion,0,1,1,0,2,2,0.016518,4,0.278724,0.3015,0
蒋根(1948),蒋根,notion,0,2,2,0,3,3,0.026269,4,0.293695,0.324415,1931.353166
蒋灾(1948),蒋灾,notion,0,1,1,0,1,1,0.016518,4,0.278724,0.3015,0
蒋特(1948),蒋特,notion,0,1,1,0,1,1,0.016518,4,0.278724,0.3015,0
蒋的(1948),蒋的,notion,0,1,1,0,1,1,0.005017,4,0.257497,0.26453,0
蒋管区(1948),蒋管区,notion,0,2,2,0,7,7,0.021535,4,0.28397,0.309841,889.229879
蒋经国(1948),蒋经国,notion,0,3,3,0,5,5,0.039005,4,0.316377,0.354985,7012.292377
蒋美(1948),蒋美,notion,0,1,1,0,1,1,0.016518,4,0.278724,0.3015,0
蒋美日(1948),蒋美日,notion,0,1,1,0,1,1,0.016518,4,0.278724,0.3015,0
蒋莱子(1948),蒋莱子,notion,0,1,1,0,1,1,0.016518,4,0.278724,0.3015,0
蒋记(1948),蒋记,notion,0,1,1,0,3,3,0.016518,4,0.278724,0.3015,0
蒋谍(1948),蒋谍,notion,0,1,1,0,1,1,0.016518,4,0.278724,0.3015,0
蒋选(1948),蒋选,notion,0,1,1,0,1,1,0.009751,4,0.267186,0.282133,0
蓬勃发展(1948),蓬勃发展,notion,0,1,1,0,2,2,0.016518,4,0.278724,0.3015,0
蔓延(1948),蔓延,notion,0,2,2,0,3,3,0.026491,4,0.291937,0.321853,1403.825067
蔡特金(1948),蔡特金,notion,0,1,1,0,1,1,0.009739,4,0.265806,0.279704,0
薪工(1948),薪工,notion,0,1,1,0,1,1,0.008247,4,0.26379,0.27611,0
薪水(1948),薪水,notion,0,1,1,0,1,1,0.01424,4,0.275514,0.296275,0
薪给(1948),薪给,notion,0,1,1,0,1,1,0.01022,4,0.267243,0.282233,0
虎口(1948),虎口,notion,0,1,1,0,1,1,0.016752,4,0.279138,0.302165,0
虚心(1948),虚心,notion,0,2,2,0,2,2,0.026269,4,0.293695,0.324415,1931.353166
虚此(1948),虚此,notion,0,1,1,0,1,1,0.016752,4,0.279138,0.302165,0
虬松(1948),虬松,notion,0,1,1,0,1,1,0.01424,4,0.275514,0.296275,0
虽然(1948),虽然,notion,0,1,1,0,1,1,0.011322,4,0.269061,0.285394,0
虾球(1948),虾球,notion,0,1,1,0,1,1,0.009751,4,0.267186,0.282133,0
蛆虫(1948),蛆虫,notion,0,1,1,0,1,1,0.016518,4,0.278724,0.3015,0
蜀中(1948),蜀中,notion,0,1,1,0,1,1,0.016752,4,0.279138,0.302165,0
蜕变(1948),蜕变,notion,0,2,2,0,2,2,0.019569,4,0.280598,0.30455,1193.220239
蜘蛛(1948),蜘蛛,notion,0,2,2,0,2,2,0.018002,4,0.27945,0.30272,1656.832374
蝉联(1948),蝉联,notion,0,1,1,0,1,1,0.008247,4,0.26379,0.27611,0
蝴蝶(1948),蝴蝶,notion,0,1,1,0,1,1,0.016752,4,0.279138,0.302165,0
蠢货(1948),蠢货,notion,0,1,1,0,1,1,0.016518,4,0.278724,0.3015,0
血债(1948),血债,notion,0,1,1,0,1,1,0.016752,4,0.279138,0.302165,0
血和油(1948),血和油,notion,0,1,1,0,1,1,0.016752,4,0.279138,0.302165,0
血染(1948),血染,notion,0,1,1,0,1,1,0.016518,4,0.278724,0.3015,0
血案(1948),血案,notion,0,4,4,0,8,8,0.049609,4,0.32838,0.369482,8912.705343
血汗(1948),血汗,notion,0,1,1,0,1,1,0.011322,4,0.269061,0.285394,0
血泊(1948),血泊,notion,0,1,1,0,1,1,0.016518,4,0.278724,0.3015,0
血泪(1948),血泪,notion,0,1,1,0,1,1,0.016752,4,0.279138,0.302165,0
血洗(1948),血洗,notion,0,1,1,0,1,1,0.016518,4,0.278724,0.3015,0
血海(1948),血海,notion,0,1,1,0,1,1,0.016518,4,0.278724,0.3015,0
血液(1948),血液,notion,0,1,1,0,1,1,0.016518,4,0.278724,0.3015,0
血溅(1948),血溅,notion,0,1,1,0,1,1,0.016518,4,0.278724,0.3015,0
血滴(1948),血滴,notion,0,1,1,0,1,1,0.01022,4,0.267243,0.282233,0
血腥(1948),血腥,notion,0,2,2,0,3,3,0.026269,4,0.293695,0.324415,1931.353166
行不得(1948),行不得,notion,0,1,1,0,1,1,0.01424,4,0.275514,0.296275,0
行为(1948),行为,notion,0,1,1,0,1,1,0.01424,4,0.275514,0.296275,0
行人(1948),行人,notion,0,1,1,0,1,1,0.016752,4,0.279138,0.302165,0
行列(1948),行列,notion,0,1,1,0,1,1,0.009755,4,0.266617,0.281135,0
行在(1948),行在,notion,0,1,1,0,1,1,0.005017,4,0.257497,0.26453,0
行宪(1948),行宪,notion,0,5,5,0,7,7,0.051064,4,0.33192,0.373597,16349.877928
行宪国(1948),行宪国,notion,0,3,3,0,3,3,0.035301,4,0.30767,0.343804,5502.725894
行局(1948),行局,notion,0,1,1,0,1,1,0.009739,4,0.265806,0.279704,0
行得通(1948),行得通,notion,0,1,1,0,1,1,0.008247,4,0.26379,0.27611,0
行政(1948),行政,notion,0,2,2,0,2,2,0.015763,4,0.275232,0.295865,1348.309636
行政官(1948),行政官,notion,0,1,1,0,1,1,0.007515,4,0.262793,0.274313,0
行止(1948),行止,notion,0,1,1,0,1,1,0.01022,4,0.267243,0.282233,0
行路难(1948),行路难,notion,0,1,1,0,1,1,0.01424,4,0.275514,0.296275,0
行进(1948),行进,notion,0,1,1,0,1,1,0.004718,4,0.258401,0.266227,0
衙门(1948),衙门,notion,0,1,1,0,1,1,0.008247,4,0.26379,0.27611,0
衝破(1948),衝破,notion,0,1,1,0,1,1,0.016518,4,0.278724,0.3015,0
衝突(1948),衝突,notion,0,2,2,0,2,2,0.019569,4,0.280598,0.30455,1193.220239
衡向(1948),衡向,notion,0,1,1,0,1,1,0.016518,4,0.278724,0.3015,0
衣食(1948),衣食,notion,0,1,1,0,1,1,0.005017,4,0.257497,0.26453,0
补习(1948),补习,notion,0,3,3,0,3,3,0.037987,4,0.314128,0.352156,7349.461704
补发(1948),补发,notion,0,1,1,0,1,1,0.01424,4,0.275514,0.296275,0
补白(1948),补白,notion,0,1,1,0,1,1,0.004718,4,0.258401,0.266227,0
补考(1948),补考,notion,0,1,1,0,1,1,0.007515,4,0.262793,0.274313,0
补贴(1948),补贴,notion,0,1,1,0,1,1,0.01424,4,0.275514,0.296275,0
补遗(1948),补遗,notion,0,1,1,0,1,1,0.01022,4,0.267243,0.282233,0
表兄(1948),表兄,notion,0,1,1,0,1,1,0.009751,4,0.267186,0.282133,0
表演赛(1948),表演赛,notion,0,1,1,0,1,1,0.016518,4,0.278724,0.3015,0
表现(1948),表现,notion,0,1,1,0,1,1,0.009751,4,0.267186,0.282133,0
表示(1948),表示,notion,0,4,4,0,5,5,0.03969,4,0.311342,0.348651,6947.742587
表裏(1948),表裏,notion,0,1,1,0,1,1,0.016518,4,0.278724,0.3015,0
表面(1948),表面,notion,0,1,1,0,1,1,0.008247,4,0.26379,0.27611,0
衰翁(1948),衰翁,notion,0,1,1,0,1,1,0.016518,4,0.278724,0.3015,0
袁世凯(1948),袁世凯,notion,0,3,3,0,4,4,0.040785,4,0.318577,0.357713,7036.648398
袁先生(1948),袁先生,notion,0,1,1,0,1,1,0.016752,4,0.279138,0.302165,0
袁头(1948),袁头,notion,0,1,1,0,1,1,0.016518,4,0.278724,0.3015,0
袁浦(1948),袁浦,notion,0,1,1,0,1,1,0.004718,4,0.258401,0.266227,0
被俘(1948),被俘,notion,0,1,1,0,1,1,0.01022,4,0.267243,0.282233,0
被捕(1948),被捕,notion,0,4,4,0,8,8,0.052534,4,0.337133,0.379365,12409.239858
被欧(1948),被欧,notion,0,1,1,0,1,1,0.01022,4,0.267243,0.282233,0
被迫(1948),被迫,notion,0,1,1,0,1,1,0.005017,4,0.257497,0.26453,0
袭击(1948),袭击,notion,0,1,1,0,1,1,0.01022,4,0.267243,0.282233,0
裁併(1948),裁併,notion,0,1,1,0,1,1,0.011322,4,0.269061,0.285394,0
裁员(1948),裁员,notion,0,2,2,0,2,2,0.024461,4,0.291756,0.321587,2304.72473
装订(1948),装订,notion,0,1,1,0,1,1,0.009739,4,0.265806,0.279704,0
装进(1948),装进,notion,0,1,1,0,1,1,0.016752,4,0.279138,0.302165,0
製造(1948),製造,notion,0,2,2,0,3,3,0.027839,4,0.295962,0.327676,1920.33989
褚辅成(1948),褚辅成,notion,0,1,1,0,1,1,0.016752,4,0.279138,0.302165,0
襄樊(1948),襄樊,notion,0,1,1,0,1,1,0.01022,4,0.267243,0.282233,0
襄阳(1948),襄阳,notion,0,1,1,0,1,1,0.01022,4,0.267243,0.282233,0
西北(1948),西北,notion,0,5,5,0,9,9,0.05972,4,0.343577,0.386375,14526.390885
西北部(1948),西北部,notion,0,1,1,0,1,1,0.007515,4,0.262793,0.274313,0
西医(1948),西医,notion,0,1,1,0,1,1,0.007515,4,0.262793,0.274313,0
西南(1948),西南,notion,0,6,6,0,6,6,0.063808,4,0.355443,0.398576,27737.813077
西国(1948),西国,notion,0,1,1,0,1,1,0.009739,4,0.265806,0.279704,0
西夏(1948),西夏,notion,0,1,1,0,1,1,0.007515,4,0.262793,0.274313,0
西山(1948),西山,notion,0,1,1,0,1,1,0.016752,4,0.279138,0.302165,0
西康(1948),西康,notion,0,1,1,0,1,1,0.01022,4,0.267243,0.282233,0
西德(1948),西德,notion,0,3,3,0,4,4,0.024883,4,0.288197,0.316352,3347.063457
西昌(1948),西昌,notion,0,1,1,0,1,1,0.01424,4,0.275514,0.296275,0
西欧(1948),西欧,notion,0,6,6,0,13,13,0.059886,4,0.343138,0.385964,20162.502232
西欧联盟(1948),西欧联盟,notion,0,5,5,0,5,5,0.060063,4,0.351321,0.394394,18282.564453
西江(1948),西江,notion,0,1,1,0,2,2,0.009751,4,0.267186,0.282133,0
西洋镜(1948),西洋镜,notion,0,1,1,0,1,1,0.009755,4,0.266617,0.281135,0
西突厥(1948),西突厥,notion,0,1,1,0,1,1,0.01424,4,0.275514,0.296275,0
西藏(1948),西藏,notion,0,1,1,0,1,1,0.011322,4,0.269061,0.285394,0
西装店(1948),西装店,notion,0,1,1,0,1,1,0.01424,4,0.275514,0.296275,0
西贡(1948),西贡,notion,0,2,2,0,3,3,0.026257,4,0.292073,0.322053,1522.40889
要书读(1948),要书读,notion,0,2,2,0,2,2,0.026491,4,0.291937,0.321853,1403.825067
要命(1948),要命,notion,0,1,1,0,1,1,0.016518,4,0.278724,0.3015,0
要图(1948),要图,notion,0,1,1,0,1,1,0.01424,4,0.275514,0.296275,0
要素(1948),要素,notion,0,1,1,0,2,2,0.011322,4,0.269061,0.285394,0
要紧(1948),要紧,notion,0,1,1,0,1,1,0.016752,4,0.279138,0.302165,0
覆亡(1948),覆亡,notion,0,1,1,0,1,1,0.007515,4,0.262793,0.274313,0
覆信(1948),覆信,notion,0,1,1,0,1,1,0.009755,4,0.266617,0.281135,0
覆电(1948),覆电,notion,0,1,1,0,1,1,0.016518,4,0.278724,0.3015,0
覆败(1948),覆败,notion,0,1,1,0,1,1,0.01022,4,0.267243,0.282233,0
见到(1948),见到,notion,0,1,1,0,1,1,0.005389,4,0.25849,0.266394,0
见诸报端(1948),见诸报端,notion,0,1,1,0,1,1,0.016752,4,0.279138,0.302165,0
见闻录(1948),见闻录,notion,0,5,5,0,5,5,0.059048,4,0.345536,0.388438,19253.091462
观众(1948),观众,notion,0,1,1,0,1,1,0.009751,4,0.267186,0.282133,0
观后感(1948),观后感,notion,0,1,1,0,1,1,0.016518,4,0.278724,0.3015,0
观念(1948),观念,notion,0,4,4,0,5,5,0.041731,4,0.319743,0.3592,11948.587317
观战(1948),观战,notion,0,1,1,0,1,1,0.007515,4,0.262793,0.274313,0
观测(1948),观测,notion,0,1,1,0,1,1,0.011322,4,0.269061,0.285394,0
观点(1948),观点,notion,0,6,6,0,6,6,0.055075,4,0.340803,0.383469,25993.044905
观记(1948),观记,notion,0,1,1,0,1,1,0.004718,4,0.258401,0.266227,0
规定(1948),规定,notion,0,1,1,0,1,1,0.008247,4,0.26379,0.27611,0
规律(1948),规律,notion,0,2,2,0,2,2,0.033269,4,0.305692,0.34112,2297.98609
规模(1948),规模,notion,0,1,1,0,1,1,0.016752,4,0.279138,0.302165,0
规避(1948),规避,notion,0,1,1,0,1,1,0.01424,4,0.275514,0.296275,0
觉悟(1948),觉悟,notion,0,6,6,0,6,6,0.057443,4,0.338836,0.381339,18631.210982
觉醒(1948),觉醒,notion,0,2,2,0,2,2,0.016339,4,0.275312,0.295998,876.896283
角逐(1948),角逐,notion,0,1,1,0,1,1,0.01022,4,0.267243,0.282233,0
解决(1948),解决,notion,0,9,9,0,13,13,0.086266,4,0.392303,0.431785,51521.381863
解决不了(1948),解决不了,notion,0,1,1,0,1,1,0.01424,4,0.275514,0.296275,0
解决问题(1948),解决问题,notion,0,1,1,0,1,1,0.01424,4,0.275514,0.296275,0
解冻(1948),解冻,notion,0,1,1,0,1,1,0.009751,4,0.267186,0.282133,0
解开(1948),解开,notion,0,1,1,0,1,1,0.002332,4,0.253398,0.256677,0
解放出来(1948),解放出来,notion,0,1,1,0,1,1,0.009751,4,0.267186,0.282133,0
解救(1948),解救,notion,0,1,1,0,1,1,0.007515,4,0.262793,0.274313,0
解散(1948),解散,notion,0,4,4,0,5,5,0.04623,4,0.325478,0.366088,10193.819465
解聘(1948),解聘,notion,0,1,1,0,1,1,0.016752,4,0.279138,0.302165,0
解脱(1948),解脱,notion,0,1,1,0,1,1,0.016752,4,0.279138,0.302165,0
解说(1948),解说,notion,0,1,1,0,1,1,0.016518,4,0.278724,0.3015,0
解释权(1948),解释权,notion,0,1,1,0,1,1,0.008247,4,0.26379,0.27611,0
解铃还须系铃人(1948),解铃还须系铃人,notion,0,1,1,0,1,1,0.016752,4,0.279138,0.302165,0
解除(1948),解除,notion,0,3,3,0,3,3,0.02932,4,0.297368,0.329728,5332.953297
言不由衷(1948),言不由衷,notion,0,1,1,0,1,1,0.008247,4,0.26379,0.27611,0
言论(1948),言论,notion,0,3,3,0,6,6,0.034212,4,0.309393,0.346067,7715.939213
言论自由(1948),言论自由,notion,0,2,2,0,2,2,0.022488,4,0.288152,0.31623,2102.825587
詹姆士(1948),詹姆士,notion,0,1,1,0,1,1,0.008247,4,0.26379,0.27611,0
誓愿(1948),誓愿,notion,0,1,1,0,1,1,0.009751,4,0.267186,0.282133,0
譁衆(1948),譁衆,notion,0,1,1,0,1,1,0.01424,4,0.275514,0.296275,0
證券(1948),證券,notion,0,1,1,0,1,1,0.008247,4,0.26379,0.27611,0
證明(1948),證明,notion,0,1,1,0,2,2,0.008247,4,0.26379,0.27611,0
警卫(1948),警卫,notion,0,1,1,0,1,1,0.009755,4,0.266617,0.281135,0
警告(1948),警告,notion,0,1,1,0,1,1,0.009739,4,0.265806,0.279704,0
警备(1948),警备,notion,0,1,1,0,1,1,0.005389,4,0.25849,0.266394,0
警察(1948),警察,notion,0,3,3,0,3,3,0.03806,4,0.311162,0.348363,5324.627604
警惕(1948),警惕,notion,0,4,4,0,5,5,0.052527,4,0.337345,0.379598,11365.251801
警戒(1948),警戒,notion,0,1,1,0,1,1,0.016518,4,0.278724,0.3015,0
警觉(1948),警觉,notion,0,2,2,0,2,2,0.009735,4,0.265411,0.279061,1057.973644
计划经济(1948),计划经济,notion,0,1,1,0,1,1,0.008247,4,0.26379,0.27611,0
订货(1948),订货,notion,0,1,1,0,1,1,0.008247,4,0.26379,0.27611,0
讣文(1948),讣文,notion,0,1,1,0,1,1,0.005017,4,0.257497,0.26453,0
讣闻(1948),讣闻,notion,0,1,1,0,1,1,0.016518,4,0.278724,0.3015,0
认为(1948),认为,notion,0,1,1,0,1,1,0.007515,4,0.262793,0.274313,0
认得(1948),认得,notion,0,1,1,0,1,1,0.016518,4,0.278724,0.3015,0
认清(1948),认清,notion,0,2,2,0,2,2,0.033269,4,0.305692,0.34112,2297.98609
讨论(1948),讨论,notion,0,5,5,0,15,15,0.049208,4,0.330576,0.372066,18953.04324
讨论会(1948),讨论会,notion,0,2,2,0,3,3,0.021076,4,0.284616,0.310839,1735.877057
训导(1948),训导,notion,0,1,1,0,1,1,0.01022,4,0.267243,0.282233,0
训练(1948),训练,notion,0,1,1,0,1,1,0.008247,4,0.26379,0.27611,0
训育(1948),训育,notion,0,2,2,0,2,2,0.024267,4,0.290987,0.320456,2179.633602
训话(1948),训话,notion,0,1,1,0,1,1,0.016518,4,0.278724,0.3015,0
议会(1948),议会,notion,0,2,2,0,2,2,0.015238,4,0.27323,0.292537,773.838752
议会制(1948),议会制,notion,0,1,1,0,1,1,0.009755,4,0.266617,0.281135,0
记五(1948),记五,notion,0,1,1,0,1,1,0.009751,4,0.267186,0.282133,0
记住(1948),记住,notion,0,1,1,0,1,1,0.016518,4,0.278724,0.3015,0
记实(1948),记实,notion,0,1,1,0,1,1,0.01424,4,0.275514,0.296275,0
记曾(1948),记曾,notion,0,1,1,0,1,1,0.005017,4,0.257497,0.26453,0
记朱佩弦(1948),记朱佩弦,notion,0,2,2,0,2,2,0.008698,4,0.258507,0.266483,0.569098
记者(1948),记者,notion,0,5,5,0,6,6,0.060279,4,0.346813,0.389769,17978.906183
记者团(1948),记者团,notion,0,1,1,0,1,1,0.009739,4,0.265806,0.279704,0
记者节(1948),记者节,notion,0,1,1,0,1,1,0.016752,4,0.279138,0.302165,0
记行(1948),记行,notion,0,1,1,0,1,1,0.004718,4,0.258401,0.266227,0
记详(1948),记详,notion,0,1,1,0,1,1,0.005017,4,0.257497,0.26453,0
记载(1948),记载,notion,0,1,1,0,1,1,0.01424,4,0.275514,0.296275,0
讲于(1948),讲于,notion,0,1,1,0,1,1,0.007515,4,0.262793,0.274313,0
讲古(1948),讲古,notion,0,1,1,0,1,1,0.009751,4,0.267186,0.282133,0
讲学(1948),讲学,notion,0,1,1,0,1,1,0.007515,4,0.262793,0.274313,0
讲座(1948),讲座,notion,0,1,1,0,1,1,0.009739,4,0.265806,0.279704,0
讲法(1948),讲法,notion,0,2,2,0,2,2,0.008698,4,0.258507,0.266483,0.569098
讲演会(1948),讲演会,notion,0,1,1,0,1,1,0.002332,4,0.253398,0.256677,0
讲演稿(1948),讲演稿,notion,0,1,1,0,1,1,0.005389,4,0.25849,0.266394,0
讲稿(1948),讲稿,notion,0,1,1,0,1,1,0.005389,4,0.25849,0.266394,0
讲者(1948),讲者,notion,0,1,1,0,1,1,0.016752,4,0.279138,0.302165,0
讲词(1948),讲词,notion,0,2,2,0,2,2,0.009848,4,0.265524,0.27926,689.820462
许勇(1948),许勇,notion,0,1,1,0,1,1,0.011322,4,0.269061,0.285394,0
许多(1948),许多,notion,0,1,1,0,1,1,0.008247,4,0.26379,0.27611,0
许季(1948),许季,notion,0,1,1,0,1,1,0.011322,4,0.269061,0.285394,0
许寿裳(1948),许寿裳,notion,0,1,1,0,1,1,0.01022,4,0.267243,0.282233,0
许昂(1948),许昂,notion,0,1,1,0,1,1,0.009755,4,0.266617,0.281135,0
论坛(1948),论坛,notion,0,2,2,0,13,13,0.017999,4,0.280116,0.303785,1897.286008
论战(1948),论战,notion,0,1,1,0,11,11,0.01424,4,0.275514,0.296275,0
论文(1948),论文,notion,0,4,4,0,4,4,0.047811,4,0.327578,0.36855,11741.436734
设置(1948),设置,notion,0,1,1,0,1,1,0.011322,4,0.269061,0.285394,0
设计(1948),设计,notion,0,2,2,0,2,2,0.019506,4,0.282731,0.307911,1903.779982
设防(1948),设防,notion,0,1,1,0,1,1,0.009739,4,0.265806,0.279704,0
访冯(1948),访冯,notion,0,1,1,0,1,1,0.01022,4,0.267243,0.282233,0
访华(1948),访华,notion,0,1,1,0,1,1,0.005017,4,0.257497,0.26453,0
访华团(1948),访华团,notion,0,1,1,0,1,1,0.005017,4,0.257497,0.26453,0
访日(1948),访日,notion,0,2,2,0,3,3,0.021542,4,0.284314,0.310373,1410.419447
访美(1948),访美,notion,0,1,1,0,1,1,0.016518,4,0.278724,0.3015,0
访苏(1948),访苏,notion,0,1,1,0,1,1,0.016752,4,0.279138,0.302165,0
访问(1948),访问,notion,0,7,7,0,9,9,0.066176,4,0.352177,0.39537,28506.330818
访问记(1948),访问记,notion,0,2,2,0,2,2,0.021076,4,0.284616,0.310839,1735.877057
诀窍(1948),诀窍,notion,0,1,1,0,1,1,0.007515,4,0.262793,0.274313,0
证据(1948),证据,notion,0,1,1,0,1,1,0.016752,4,0.279138,0.302165,0
评中美(1948),评中美,notion,0,1,1,0,1,1,0.002332,4,0.253398,0.256677,0
评吕(1948),评吕,notion,0,1,1,0,1,1,0.01022,4,0.267243,0.282233,0
评对(1948),评对,notion,0,1,1,0,1,1,0.011322,4,0.269061,0.285394,0
评美(1948),评美,notion,0,1,1,0,1,1,0.016752,4,0.279138,0.302165,0
评萧(1948),评萧,notion,0,1,1,0,1,1,0.01022,4,0.267243,0.282233,0
评论(1948),评论,notion,0,3,3,0,6,6,0.037828,4,0.311575,0.348895,5613.568801
评论家(1948),评论家,notion,0,1,1,0,1,1,0.01424,4,0.275514,0.296275,0
识要(1948),识要,notion,0,1,1,0,1,1,0.007515,4,0.262793,0.274313,0
诈欺(1948),诈欺,notion,0,1,1,0,1,1,0.007515,4,0.262793,0.274313,0
诉苦(1948),诉苦,notion,0,1,1,0,2,2,0.009751,4,0.267186,0.282133,0
诉说(1948),诉说,notion,0,1,1,0,1,1,0.016752,4,0.279138,0.302165,0
诉请(1948),诉请,notion,0,1,1,0,1,1,0.008247,4,0.26379,0.27611,0
诊断(1948),诊断,notion,0,2,2,0,2,2,0.01058,4,0.266674,0.28129,814.96844
试一下(1948),试一下,notion,0,1,1,0,1,1,0.01424,4,0.275514,0.296275,0
试再(1948),试再,notion,0,1,1,0,1,1,0.009751,4,0.267186,0.282133,0
试答(1948),试答,notion,0,1,1,0,1,1,0.009751,4,0.267186,0.282133,0
试金石(1948),试金石,notion,0,1,1,0,1,1,0.011322,4,0.269061,0.285394,0
试题(1948),试题,notion,0,2,2,0,2,2,0.024461,4,0.291756,0.321587,2304.72473
试验(1948),试验,notion,0,1,1,0,2,2,0.004718,4,0.258401,0.266227,0
诗三首(1948),诗三首,notion,0,1,1,0,1,1,0.008247,4,0.26379,0.27611,0
诗以言志(1948),诗以言志,notion,0,1,1,0,1,1,0.01424,4,0.275514,0.296275,0
诗句(1948),诗句,notion,0,1,1,0,1,1,0.01424,4,0.275514,0.296275,0
诗家(1948),诗家,notion,0,1,1,0,1,1,0.011322,4,0.269061,0.285394,0
诗词(1948),诗词,notion,0,1,1,0,1,1,0.01424,4,0.275514,0.296275,0
诗风(1948),诗风,notion,0,1,1,0,1,1,0.016752,4,0.279138,0.302165,0
诚意(1948),诚意,notion,0,1,1,0,1,1,0.008247,4,0.26379,0.27611,0
诚然(1948),诚然,notion,0,2,2,0,2,2,0.008698,4,0.258507,0.266483,0.569098
话家常(1948),话家常,notion,0,1,1,0,1,1,0.004718,4,0.258401,0.266227,0
话川局(1948),话川局,notion,0,1,1,0,1,1,0.009739,4,0.265806,0.279704,0
话川防(1948),话川防,notion,0,1,1,0,1,1,0.008247,4,0.26379,0.27611,0
诞生(1948),诞生,notion,0,1,1,0,1,1,0.004718,4,0.258401,0.266227,0
诞辰(1948),诞辰,notion,0,3,3,0,4,4,0.018453,4,0.274528,0.294756,1725.62382
诡计多端(1948),诡计多端,notion,0,1,1,0,1,1,0.016518,4,0.278724,0.3015,0
诤友(1948),诤友,notion,0,2,2,0,2,2,0.008698,4,0.258507,0.266483,0.569098
该不该(1948),该不该,notion,0,1,1,0,1,1,0.009751,4,0.267186,0.282133,0
该庭(1948),该庭,notion,0,1,1,0,1,1,0.016752,4,0.279138,0.302165,0
详细(1948),详细,notion,0,2,2,0,5,5,0.021542,4,0.284314,0.310373,1410.419447
诬蔑(1948),诬蔑,notion,0,1,1,0,1,1,0.01424,4,0.275514,0.296275,0
语言(1948),语言,notion,0,1,1,0,1,1,0.008247,4,0.26379,0.27611,0
语重心长(1948),语重心长,notion,0,1,1,0,1,1,0.01424,4,0.275514,0.296275,0
说起(1948),说起,notion,0,9,9,0,15,15,0.08429,4,0.380155,0.421603,42257.045926
请假(1948),请假,notion,0,1,1,0,1,1,0.016752,4,0.279138,0.302165,0
请命(1948),请命,notion,0,3,3,0,3,3,0.018919,4,0.274568,0.294822,1295.743183
请教(1948),请教,notion,0,1,1,0,1,1,0.01424,4,0.275514,0.296275,0
请试(1948),请试,notion,0,1,1,0,1,1,0.016518,4,0.278724,0.3015,0
请进(1948),请进,notion,0,1,1,0,1,1,0.016518,4,0.278724,0.3015,0
请问(1948),请问,notion,0,1,1,0,1,1,0.005017,4,0.257497,0.26453,0
请麦帅(1948),请麦帅,notion,0,1,1,0,1,1,0.009739,4,0.265806,0.279704,0
诸位(1948),诸位,notion,0,1,1,0,1,1,0.016518,4,0.278724,0.3015,0
诸君(1948),诸君,notion,0,2,2,0,2,2,0.026491,4,0.291937,0.321853,1403.825067
诸国(1948),诸国,notion,0,1,1,0,1,1,0.005017,4,0.257497,0.26453,0
诸葛(1948),诸葛,notion,0,1,1,0,1,1,0.009751,4,0.267186,0.282133,0
诺夫(1948),诺夫,notion,0,1,1,0,1,1,0.009755,4,0.266617,0.281135,0
诺言(1948),诺言,notion,0,1,1,0,1,1,0.016518,4,0.278724,0.3015,0
诺贝尔奖(1948),诺贝尔奖,notion,0,2,2,0,2,2,0.026507,4,0.294224,0.325181,2012.895914
读万卷书(1948),读万卷书,notion,0,1,1,0,1,1,0.01424,4,0.275514,0.296275,0
读书(1948),读书,notion,0,5,5,0,11,11,0.061805,4,0.354571,0.397655,21413.230174
读书笔记(1948),读书笔记,notion,0,1,1,0,2,2,0.016518,4,0.278724,0.3015,0
读后(1948),读后,notion,0,2,2,0,2,2,0.026503,4,0.295799,0.327444,2668.961321
读后感(1948),读后感,notion,0,5,5,0,7,7,0.044012,4,0.318766,0.358057,12969.900893
读报(1948),读报,notion,0,1,1,0,1,1,0.016752,4,0.279138,0.302165,0
读日边(1948),读日边,notion,0,1,1,0,1,1,0.008247,4,0.26379,0.27611,0
读本(1948),读本,notion,0,1,1,0,1,1,0.009739,4,0.265806,0.279704,0
读金圆(1948),读金圆,notion,0,1,1,0,1,1,0.005389,4,0.25849,0.266394,0
课程(1948),课程,notion,0,1,1,0,1,1,0.01022,4,0.267243,0.282233,0
课题(1948),课题,notion,0,1,1,0,1,1,0.01424,4,0.275514,0.296275,0
调兵遣将(1948),调兵遣将,notion,0,1,1,0,1,1,0.011322,4,0.269061,0.285394,0
调协(1948),调协,notion,0,1,1,0,1,1,0.007515,4,0.262793,0.274313,0
调和(1948),调和,notion,0,2,2,0,2,2,0.026257,4,0.292073,0.322053,1522.40889
调整(1948),调整,notion,0,3,3,0,3,3,0.02469,4,0.291937,0.321909,6376.074128
调查(1948),调查,notion,0,2,2,0,3,3,0.016039,4,0.2771,0.298926,2122.22906
调查团(1948),调查团,notion,0,1,1,0,1,1,0.009739,4,0.265806,0.279704,0
谈之四(1948),谈之四,notion,0,1,1,0,1,1,0.007515,4,0.262793,0.274313,0
谈判(1948),谈判,notion,0,2,2,0,3,3,0.026272,4,0.29319,0.323683,1793.896368
谈到(1948),谈到,notion,0,7,7,0,7,7,0.057818,4,0.342075,0.384888,31864.863205
谈女(1948),谈女,notion,0,1,1,0,1,1,0.009739,4,0.265806,0.279704,0
谈话(1948),谈话,notion,0,3,3,0,4,4,0.038294,4,0.310776,0.347864,5024.657132
谈话录(1948),谈话录,notion,0,1,1,0,1,1,0.009755,4,0.266617,0.281135,0
谈谈(1948),谈谈,notion,0,2,2,0,2,2,0.019491,4,0.281819,0.30648,1649.883746
谈起(1948),谈起,notion,0,4,4,0,4,4,0.046229,4,0.323739,0.364025,10645.796895
谎言(1948),谎言,notion,0,1,1,0,1,1,0.016518,4,0.278724,0.3015,0
谢谢(1948),谢谢,notion,0,1,1,0,1,1,0.01022,4,0.267243,0.282233,0
谢默依(1948),谢默依,notion,0,1,1,0,1,1,0.01424,4,0.275514,0.296275,0
谣言(1948),谣言,notion,0,2,2,0,4,4,0.026257,4,0.292073,0.322053,1522.40889
谣诼(1948),谣诼,notion,0,1,1,0,1,1,0.016752,4,0.279138,0.302165,0
谨致谢意(1948),谨致谢意,notion,0,1,1,0,1,1,0.005389,4,0.25849,0.266394,0
谨防(1948),谨防,notion,0,1,1,0,1,1,0.009751,4,0.267186,0.282133,0
谬论(1948),谬论,notion,0,4,4,0,4,4,0.044959,4,0.319988,0.359499,9352.370932
谭后(1948),谭后,notion,0,1,1,0,1,1,0.009739,4,0.265806,0.279704,0
谰言(1948),谰言,notion,0,1,1,0,2,2,0.01424,4,0.275514,0.296275,0
象县(1948),象县,notion,0,1,1,0,1,1,0.009751,4,0.267186,0.282133,0
象征(1948),象征,notion,0,1,1,0,1,1,0.016752,4,0.279138,0.302165,0
象徵性(1948),象徵性,notion,0,1,1,0,1,1,0.016518,4,0.278724,0.3015,0
豪侠(1948),豪侠,notion,0,1,1,0,1,1,0.01424,4,0.275514,0.296275,0
豪傑(1948),豪傑,notion,0,1,1,0,1,1,0.01424,4,0.275514,0.296275,0
豪华(1948),豪华,notion,0,1,1,0,1,1,0.01424,4,0.275514,0.296275,0
豪门(1948),豪门,notion,0,4,4,0,4,4,0.054812,4,0.338622,0.380995,11236.851379
豫东(1948),豫东,notion,0,2,2,0,2,2,0.024765,4,0.291552,0.321288,2097.245087
豫籍(1948),豫籍,notion,0,1,1,0,1,1,0.01022,4,0.267243,0.282233,0
豫鄂(1948),豫鄂,notion,0,1,1,0,1,1,0.011322,4,0.269061,0.285394,0
贝尔纳斯(1948),贝尔纳斯,notion,0,1,1,0,1,1,0.009755,4,0.266617,0.281135,0
贝文(1948),贝文,notion,0,2,2,0,2,2,0.023995,4,0.291507,0.321221,2493.732085
贝文的籲(1948),贝文的籲,notion,0,1,1,0,1,1,0.01424,4,0.275514,0.296275,0
负担(1948),负担,notion,0,1,1,0,1,1,0.011322,4,0.269061,0.285394,0
负有责任(1948),负有责任,notion,0,1,1,0,1,1,0.01424,4,0.275514,0.296275,0
负责(1948),负责,notion,0,3,3,0,3,3,0.039239,4,0.316724,0.355417,6944.905464
负起(1948),负起,notion,0,1,1,0,1,1,0.002332,4,0.253398,0.256677,0
贡献(1948),贡献,notion,0,4,4,0,4,4,0.051271,4,0.333837,0.375704,11788.550013
贡献力量(1948),贡献力量,notion,0,1,1,0,1,1,0.016752,4,0.279138,0.302165,0
财主(1948),财主,notion,0,1,1,0,1,1,0.009751,4,0.267186,0.282133,0
财产(1948),财产,notion,0,2,2,0,3,3,0.018002,4,0.27945,0.30272,1656.832374
财产税(1948),财产税,notion,0,4,4,0,6,6,0.037305,4,0.30767,0.34386,8664.723193
财务(1948),财务,notion,0,1,1,0,1,1,0.007515,4,0.262793,0.274313,0
财政(1948),财政,notion,0,4,4,0,5,5,0.055757,4,0.345664,0.388515,14152.358344
财政预算(1948),财政预算,notion,0,1,1,0,1,1,0.007515,4,0.262793,0.274313,0
财源(1948),财源,notion,0,1,1,0,1,1,0.009751,4,0.267186,0.282133,0
财经(1948),财经,notion,0,1,1,0,1,1,0.008247,4,0.26379,0.27611,0
责问(1948),责问,notion,0,1,1,0,1,1,0.009739,4,0.265806,0.279704,0
责难(1948),责难,notion,0,1,1,0,1,1,0.016752,4,0.279138,0.302165,0
败事(1948),败事,notion,0,1,1,0,1,1,0.011322,4,0.269061,0.285394,0
败绩(1948),败绩,notion,0,1,1,0,1,1,0.01424,4,0.275514,0.296275,0
败诉(1948),败诉,notion,0,1,1,0,1,1,0.009755,4,0.266617,0.281135,0
败露(1948),败露,notion,0,1,1,0,1,1,0.009751,4,0.267186,0.282133,0
货币(1948),货币,notion,0,1,1,0,3,3,0.009755,4,0.266617,0.281135,0
质疑(1948),质疑,notion,0,1,1,0,1,1,0.007515,4,0.262793,0.274313,0
贩卖(1948),贩卖,notion,0,1,1,0,1,1,0.004718,4,0.258401,0.266227,0
贪污(1948),贪污,notion,0,3,3,0,3,3,0.025983,4,0.291461,0.32121,4592.958268
贪污案(1948),贪污案,notion,0,1,1,0,1,1,0.016752,4,0.279138,0.302165,0
贫农(1948),贫农,notion,0,1,1,0,1,1,0.009751,4,0.267186,0.282133,0
贫病(1948),贫病,notion,0,1,1,0,1,1,0.004718,4,0.258401,0.266227,0
贫苦(1948),贫苦,notion,0,1,1,0,1,1,0.016518,4,0.278724,0.3015,0
贬值(1948),贬值,notion,0,4,4,0,5,5,0.047814,4,0.326666,0.367485,10709.111863
贬质(1948),贬质,notion,0,1,1,0,1,1,0.011322,4,0.269061,0.285394,0
购销(1948),购销,notion,0,1,1,0,1,1,0.004718,4,0.258401,0.266227,0
贯澈(1948),贯澈,notion,0,1,1,0,1,1,0.004718,4,0.258401,0.266227,0
贱买贵卖(1948),贱买贵卖,notion,0,1,1,0,1,1,0.008247,4,0.26379,0.27611,0
贵人(1948),贵人,notion,0,1,1,0,1,1,0.016518,4,0.278724,0.3015,0
贵会(1948),贵会,notion,0,1,1,0,1,1,0.008247,4,0.26379,0.27611,0
贵刊(1948),贵刊,notion,0,2,2,0,4,4,0.027839,4,0.295962,0.327676,1920.33989
贷款(1948),贷款,notion,0,1,1,0,1,1,0.008247,4,0.26379,0.27611,0
贸易(1948),贸易,notion,0,2,2,0,2,2,0.02398,4,0.290133,0.319191,1998.682918
费孝通(1948),费孝通,notion,0,2,2,0,3,3,0.019569,4,0.280598,0.30455,1193.220239
费心(1948),费心,notion,0,1,1,0,1,1,0.01424,4,0.275514,0.296275,0
费斯林(1948),费斯林,notion,0,1,1,0,1,1,0.007515,4,0.262793,0.274313,0
费正清(1948),费正清,notion,0,2,2,0,2,2,0.025562,4,0.293259,0.323783,2167.4723
费用(1948),费用,notion,0,2,2,0,2,2,0.025562,4,0.293259,0.323783,2167.4723
贺电(1948),贺电,notion,0,1,1,0,1,1,0.016518,4,0.278724,0.3015,0
资产(1948),资产,notion,0,1,1,0,1,1,0.011322,4,0.269061,0.285394,0
资本(1948),资本,notion,0,3,3,0,8,8,0.028222,4,0.295752,0.327432,5124.632167
资本家(1948),资本家,notion,0,1,1,0,1,1,0.009755,4,0.266617,0.281135,0
资源(1948),资源,notion,0,1,1,0,1,1,0.016518,4,0.278724,0.3015,0
赏光(1948),赏光,notion,0,1,1,0,1,1,0.016518,4,0.278724,0.3015,0
赔偿(1948),赔偿,notion,0,4,4,0,5,5,0.039198,4,0.312482,0.350115,8778.110862
赔得(1948),赔得,notion,0,1,1,0,1,1,0.011322,4,0.269061,0.285394,0
赚钱(1948),赚钱,notion,0,1,1,0,1,1,0.01424,4,0.275514,0.296275,0
赞同(1948),赞同,notion,0,1,1,0,1,1,0.005017,4,0.257497,0.26453,0
赞成(1948),赞成,notion,0,1,1,0,1,1,0.01424,4,0.275514,0.296275,0
赠给(1948),赠给,notion,0,1,1,0,1,1,0.009751,4,0.267186,0.282133,0
赣边(1948),赣边,notion,0,1,1,0,1,1,0.009751,4,0.267186,0.282133,0
赤祸(1948),赤祸,notion,0,1,1,0,1,1,0.01424,4,0.275514,0.296275,0
赤裸(1948),赤裸,notion,0,1,1,0,1,1,0.016518,4,0.278724,0.3015,0
赫尔(1948),赫尔,notion,0,1,1,0,1,1,0.011322,4,0.269061,0.285394,0
走下坡(1948),走下坡,notion,0,1,1,0,1,1,0.016518,4,0.278724,0.3015,0
走出(1948),走出,notion,0,1,1,0,1,1,0.004718,4,0.258401,0.266227,0
走到(1948),走到,notion,0,1,1,0,1,1,0.011322,4,0.269061,0.285394,0
走势(1948),走势,notion,0,1,1,0,1,1,0.005389,4,0.25849,0.266394,0
走后门(1948),走后门,notion,0,1,1,0,1,1,0.01424,4,0.275514,0.296275,0
走廊(1948),走廊,notion,0,2,2,0,2,2,0.026738,4,0.294408,0.325447,1993.868267
走马(1948),走马,notion,0,1,1,0,1,1,0.01424,4,0.275514,0.296275,0
赴京(1948),赴京,notion,0,1,1,0,1,1,0.01022,4,0.267243,0.282233,0
赴美(1948),赴美,notion,0,1,1,0,1,1,0.007515,4,0.262793,0.274313,0
赵守愚(1948),赵守愚,notion,0,1,1,0,1,1,0.008247,4,0.26379,0.27611,0
赵香(1948),赵香,notion,0,1,1,0,1,1,0.016752,4,0.279138,0.302165,0
赶快(1948),赶快,notion,0,1,1,0,2,2,0.01424,4,0.275514,0.296275,0
赶走(1948),赶走,notion,0,1,1,0,1,1,0.004718,4,0.258401,0.266227,0
起兮哀(1948),起兮哀,notion,0,1,1,0,1,1,0.016752,4,0.279138,0.302165,0
起家(1948),起家,notion,0,1,1,0,1,1,0.007515,4,0.262793,0.274313,0
起来(1948),起来,notion,0,4,4,0,5,5,0.050264,4,0.335687,0.377767,14103.188871
起点(1948),起点,notion,0,2,2,0,2,2,0.012233,4,0.270573,0.288045,1678.569586
起用(1948),起用,notion,0,1,1,0,1,1,0.005017,4,0.257497,0.26453,0
起草(1948),起草,notion,0,1,1,0,1,1,0.007515,4,0.262793,0.274313,0
超山(1948),超山,notion,0,1,1,0,1,1,0.009739,4,0.265806,0.279704,0
超越(1948),超越,notion,0,1,1,0,1,1,0.016752,4,0.279138,0.302165,0
超阶级(1948),超阶级,notion,0,1,1,0,1,1,0.004718,4,0.258401,0.266227,0
越侨(1948),越侨,notion,0,1,1,0,1,1,0.016518,4,0.278724,0.3015,0
越北(1948),越北,notion,0,1,1,0,1,1,0.016518,4,0.278724,0.3015,0
越币(1948),越币,notion,0,1,1,0,1,1,0.01424,4,0.275514,0.296275,0
越来越(1948),越来越,notion,0,1,1,0,1,1,0.016752,4,0.279138,0.302165,0
越级(1948),越级,notion,0,1,1,0,1,1,0.002332,4,0.253398,0.256677,0
趋势(1948),趋势,notion,0,5,5,0,6,6,0.061861,4,0.351946,0.395026,19451.677245
趋向(1948),趋向,notion,0,1,1,0,2,2,0.016752,4,0.279138,0.302165,0
足以(1948),足以,notion,0,1,1,0,1,1,0.011322,4,0.269061,0.285394,0
跃动(1948),跃动,notion,0,1,1,0,1,1,0.009739,4,0.265806,0.279704,0
跃进(1948),跃进,notion,0,2,2,0,2,2,0.026503,4,0.295799,0.327444,2668.961321
跋涉(1948),跋涉,notion,0,1,1,0,1,1,0.016518,4,0.278724,0.3015,0
跌价(1948),跌价,notion,0,2,2,0,2,2,0.030758,4,0.303347,0.337959,2812.221703
跌落(1948),跌落,notion,0,1,1,0,1,1,0.009739,4,0.265806,0.279704,0
跨进(1948),跨进,notion,0,1,1,0,1,1,0.009755,4,0.266617,0.281135,0
跪求(1948),跪求,notion,0,1,1,0,1,1,0.01022,4,0.267243,0.282233,0
路易(1948),路易,notion,0,1,1,0,1,1,0.009755,4,0.266617,0.281135,0
路来(1948),路来,notion,0,1,1,0,1,1,0.004718,4,0.258401,0.266227,0
路过(1948),路过,notion,0,1,1,0,1,1,0.01424,4,0.275514,0.296275,0
跳出(1948),跳出,notion,0,1,1,0,1,1,0.016752,4,0.279138,0.302165,0
踏入(1948),踏入,notion,0,1,1,0,1,1,0.016752,4,0.279138,0.302165,0
踏实(1948),踏实,notion,0,1,1,0,1,1,0.016518,4,0.278724,0.3015,0
身后(1948),身后,notion,0,1,1,0,3,3,0.009755,4,0.266617,0.281135,0
身后事(1948),身后事,notion,0,1,1,0,1,1,0.009751,4,0.267186,0.282133,0
躯壳(1948),躯壳,notion,0,1,1,0,1,1,0.007515,4,0.262793,0.274313,0
车上(1948),车上,notion,0,1,1,0,1,1,0.008247,4,0.26379,0.27611,0
车厢(1948),车厢,notion,0,1,1,0,1,1,0.004718,4,0.258401,0.266227,0
车应立(1948),车应立,notion,0,1,1,0,1,1,0.01424,4,0.275514,0.296275,0
车站(1948),车站,notion,0,1,1,0,1,1,0.004718,4,0.258401,0.266227,0
轩然大波(1948),轩然大波,notion,0,1,1,0,1,1,0.01022,4,0.267243,0.282233,0
转化(1948),转化,notion,0,1,1,0,1,1,0.01022,4,0.267243,0.282233,0
转变(1948),转变,notion,0,5,5,0,5,5,0.041853,4,0.315606,0.354131,14264.287138
转向(1948),转向,notion,0,3,3,0,3,3,0.031495,4,0.301642,0.335685,5382.307293
转形(1948),转形,notion,0,1,1,0,1,1,0.01022,4,0.267243,0.282233,0
转形期(1948),转形期,notion,0,1,1,0,1,1,0.01424,4,0.275514,0.296275,0
转折点(1948),转折点,notion,0,1,1,0,1,1,0.016518,4,0.278724,0.3015,0
转捩点(1948),转捩点,notion,0,2,2,0,2,2,0.028074,4,0.296149,0.327943,1864.79583
转移(1948),转移,notion,0,1,1,0,1,1,0.007515,4,0.262793,0.274313,0
转舵(1948),转舵,notion,0,1,1,0,1,1,0.011322,4,0.269061,0.285394,0
转转(1948),转转,notion,0,1,1,0,1,1,0.009751,4,0.267186,0.282133,0
转载(1948),转载,notion,0,2,2,0,2,2,0.016711,4,0.276081,0.297263,848.405205
转进(1948),转进,notion,0,1,1,0,1,1,0.004718,4,0.258401,0.266227,0
轰传(1948),轰传,notion,0,1,1,0,1,1,0.016752,4,0.279138,0.302165,0
轰炸(1948),轰炸,notion,0,5,5,0,7,7,0.049911,4,0.327179,0.36814,12297.083256
轻儒(1948),轻儒,notion,0,1,1,0,1,1,0.007515,4,0.262793,0.274313,0
轻易(1948),轻易,notion,0,1,1,0,1,1,0.008247,4,0.26379,0.27611,0
轻骑队(1948),轻骑队,notion,0,1,1,0,1,1,0.009751,4,0.267186,0.282133,0
辉煌灿烂(1948),辉煌灿烂,notion,0,1,1,0,1,1,0.016518,4,0.278724,0.3015,0
输日(1948),输日,notion,0,1,1,0,1,1,0.01424,4,0.275514,0.296275,0
辛亥革命(1948),辛亥革命,notion,0,1,1,0,4,4,0.016752,4,0.279138,0.302165,0
辛稼轩(1948),辛稼轩,notion,0,1,1,0,1,1,0.007515,4,0.262793,0.274313,0
辛酸(1948),辛酸,notion,0,2,2,0,2,2,0.026972,4,0.293947,0.324781,1749.441854
辞职(1948),辞职,notion,0,2,2,0,3,3,0.017987,4,0.278331,0.300923,1351.046959
辞职信(1948),辞职信,notion,0,1,1,0,1,1,0.016752,4,0.279138,0.302165,0
辣手(1948),辣手,notion,0,1,1,0,1,1,0.01424,4,0.275514,0.296275,0
辨序(1948),辨序,notion,0,1,1,0,1,1,0.007515,4,0.262793,0.274313,0
辩护(1948),辩护,notion,0,2,2,0,2,2,0.024999,4,0.291484,0.321188,1929.694181
辩白(1948),辩白,notion,0,1,1,0,1,1,0.016752,4,0.279138,0.302165,0
辩论会(1948),辩论会,notion,0,1,1,0,1,1,0.007515,4,0.262793,0.274313,0
边区(1948),边区,notion,0,1,1,0,2,2,0.011322,4,0.269061,0.285394,0
边境(1948),边境,notion,0,2,2,0,2,2,0.024765,4,0.291552,0.321288,2097.245087
边沁(1948),边沁,notion,0,1,1,0,1,1,0.008247,4,0.26379,0.27611,0
边缘(1948),边缘,notion,0,3,3,0,3,3,0.038659,4,0.312924,0.350626,4725.020219
辽西(1948),辽西,notion,0,1,1,0,1,1,0.016518,4,0.278724,0.3015,0
辽阳(1948),辽阳,notion,0,3,3,0,3,3,0.029308,4,0.294593,0.325769,3880.837873
达丽亚(1948),达丽亚,notion,0,1,1,0,1,1,0.009755,4,0.266617,0.281135,0
达官贵人(1948),达官贵人,notion,0,1,1,0,1,1,0.016752,4,0.279138,0.302165,0
迁校(1948),迁校,notion,0,2,2,0,2,2,0.021769,4,0.284983,0.311405,1063.457371
迂迴(1948),迂迴,notion,0,1,1,0,1,1,0.01424,4,0.275514,0.296275,0
迅速(1948),迅速,notion,0,2,2,0,2,2,0.015238,4,0.27323,0.292537,773.838752
过关(1948),过关,notion,0,1,1,0,1,1,0.016518,4,0.278724,0.3015,0
过去(1948),过去,notion,0,5,5,0,5,5,0.052965,4,0.338958,0.381417,20931.262914
过年(1948),过年,notion,0,1,1,0,2,2,0.016518,4,0.278724,0.3015,0
过活(1948),过活,notion,0,1,1,0,1,1,0.004718,4,0.258401,0.266227,0
过渡(1948),过渡,notion,0,1,1,0,1,1,0.01424,4,0.275514,0.296275,0
过目(1948),过目,notion,0,1,1,0,1,1,0.016752,4,0.279138,0.302165,0
过程(1948),过程,notion,0,1,1,0,1,1,0.009751,4,0.267186,0.282133,0
迎接(1948),迎接,notion,0,5,5,0,12,12,0.044251,4,0.320589,0.360287,16192.237463
运用(1948),运用,notion,0,1,1,0,1,1,0.01424,4,0.275514,0.296275,0
运销(1948),运销,notion,0,1,1,0,1,1,0.004718,4,0.258401,0.266227,0
近东(1948),近东,notion,0,1,1,0,1,1,0.016752,4,0.279138,0.302165,0
近事(1948),近事,notion,0,1,1,0,2,2,0.01022,4,0.267243,0.282233,0
近代(1948),近代,notion,0,2,2,0,2,2,0.022488,4,0.288152,0.31623,2102.825587
近况(1948),近况,notion,0,2,2,0,2,2,0.012233,4,0.270573,0.288045,1678.569586
近年来(1948),近年来,notion,0,2,2,0,2,2,0.01996,4,0.281333,0.305715,1305.273912
近忧(1948),近忧,notion,0,1,1,0,1,1,0.011322,4,0.269061,0.285394,0
近情(1948),近情,notion,0,2,2,0,5,5,0.022141,4,0.285959,0.312902,1122.074528
近景(1948),近景,notion,0,1,1,0,1,1,0.008247,4,0.26379,0.27611,0
近状(1948),近状,notion,0,1,1,0,1,1,0.01424,4,0.275514,0.296275,0
近讯(1948),近讯,notion,0,1,1,0,1,1,0.009755,4,0.266617,0.281135,0
近貌(1948),近貌,notion,0,4,4,0,4,4,0.048026,4,0.323348,0.363559,7832.168746
返国(1948),返国,notion,0,3,3,0,3,3,0.037828,4,0.311575,0.348895,5613.568801
返归(1948),返归,notion,0,1,1,0,1,1,0.008247,4,0.26379,0.27611,0
还是(1948),还是,notion,0,6,6,0,9,9,0.062818,4,0.351058,0.394183,24214.826087
还要(1948),还要,notion,0,1,1,0,1,1,0.009739,4,0.265806,0.279704,0
还须(1948),还须,notion,0,2,2,0,2,2,0.030992,4,0.303936,0.338757,2912.385696
还魂(1948),还魂,notion,0,1,1,0,1,1,0.016518,4,0.278724,0.3015,0
这一(1948),这一,notion,0,1,1,0,1,1,0.01022,4,0.267243,0.282233,0
这两项(1948),这两项,notion,0,1,1,0,1,1,0.009751,4,0.267186,0.282133,0
这个(1948),这个,notion,0,6,6,0,7,7,0.059966,4,0.343232,0.386064,19268.500583
这些(1948),这些,notion,0,1,1,0,2,2,0.009751,4,0.267186,0.282133,0
这位(1948),这位,notion,0,1,1,0,1,1,0.01022,4,0.267243,0.282233,0
这儿(1948),这儿,notion,0,1,1,0,1,1,0.009751,4,0.267186,0.282133,0
这是(1948),这是,notion,0,2,2,0,2,2,0.026503,4,0.295799,0.327444,2668.961321
这笔(1948),这笔,notion,0,1,1,0,1,1,0.011322,4,0.269061,0.285394,0
这篇(1948),这篇,notion,0,1,1,0,1,1,0.008247,4,0.26379,0.27611,0
这里(1948),这里,notion,0,1,1,0,1,1,0.009751,4,0.267186,0.282133,0
进一解(1948),进一解,notion,0,4,4,0,4,4,0.039937,4,0.315368,0.353776,11813.091629
进一言(1948),进一言,notion,0,1,1,0,1,1,0.016752,4,0.279138,0.302165,0
进修(1948),进修,notion,0,1,1,0,1,1,0.009739,4,0.265806,0.279704,0
进军(1948),进军,notion,0,2,2,0,2,2,0.026272,4,0.29319,0.323683,1793.896368
进化(1948),进化,notion,0,2,2,0,2,2,0.00735,4,0.260317,0.269843,394.164032
进口货(1948),进口货,notion,0,1,1,0,1,1,0.016752,4,0.279138,0.302165,0
进展(1948),进展,notion,0,1,1,0,1,1,0.004718,4,0.258401,0.266227,0
进必(1948),进必,notion,0,1,1,0,1,1,0.011322,4,0.269061,0.285394,0
进攻(1948),进攻,notion,0,2,2,0,5,5,0.019506,4,0.282731,0.307911,1903.779982
进步人士(1948),进步人士,notion,0,1,1,0,1,1,0.016752,4,0.279138,0.302165,0
进步党(1948),进步党,notion,0,2,2,0,3,3,0.027839,4,0.295962,0.327676,1920.33989
进行(1948),进行,notion,0,3,3,0,7,7,0.035475,4,0.312015,0.349461,8449.733615
进行曲(1948),进行曲,notion,0,1,1,0,1,1,0.009755,4,0.266617,0.281135,0
进路(1948),进路,notion,0,1,1,0,1,1,0.009755,4,0.266617,0.281135,0
进退两难(1948),进退两难,notion,0,1,1,0,1,1,0.005017,4,0.257497,0.26453,0
远见(1948),远见,notion,0,1,1,0,1,1,0.01424,4,0.275514,0.296275,0
违反(1948),违反,notion,0,1,1,0,1,1,0.009739,4,0.265806,0.279704,0
违宪(1948),违宪,notion,0,1,1,0,1,1,0.011322,4,0.269061,0.285394,0
连任(1948),连任,notion,0,1,1,0,1,1,0.009751,4,0.267186,0.282133,0
连县(1948),连县,notion,0,1,1,0,1,1,0.009751,4,0.267186,0.282133,0
连日(1948),连日,notion,0,1,1,0,1,1,0.016752,4,0.279138,0.302165,0
连环(1948),连环,notion,0,1,1,0,1,1,0.01022,4,0.267243,0.282233,0
连续(1948),连续,notion,0,1,1,0,1,1,0.016752,4,0.279138,0.302165,0
迟暮(1948),迟暮,notion,0,1,1,0,2,2,0.016752,4,0.279138,0.302165,0
迟疑(1948),迟疑,notion,0,1,1,0,1,1,0.01424,4,0.275514,0.296275,0
迥忆(1948),迥忆,notion,0,1,1,0,1,1,0.01424,4,0.275514,0.296275,0
迫切(1948),迫切,notion,0,1,1,0,1,1,0.016752,4,0.279138,0.302165,0
迷惑(1948),迷惑,notion,0,1,1,0,1,1,0.01424,4,0.275514,0.296275,0
迷离(1948),迷离,notion,0,1,1,0,1,1,0.011322,4,0.269061,0.285394,0
迷雾(1948),迷雾,notion,0,3,3,0,3,3,0.040785,4,0.318577,0.357713,7036.648398
追悼(1948),追悼,notion,0,1,1,0,1,1,0.016752,4,0.279138,0.302165,0
追悼会(1948),追悼会,notion,0,1,1,0,1,1,0.005017,4,0.257497,0.26453,0
追记(1948),追记,notion,0,1,1,0,1,1,0.016752,4,0.279138,0.302165,0
追问(1948),追问,notion,0,1,1,0,1,1,0.008247,4,0.26379,0.27611,0
退伍(1948),退伍,notion,0,1,1,0,1,1,0.011322,4,0.269061,0.285394,0
退出(1948),退出,notion,0,1,1,0,1,1,0.007515,4,0.262793,0.274313,0
送到(1948),送到,notion,0,1,1,0,1,1,0.009751,4,0.267186,0.282133,0
送走(1948),送走,notion,0,2,2,0,2,2,0.019491,4,0.281819,0.30648,1649.883746
适应(1948),适应,notion,0,1,1,0,1,1,0.016518,4,0.278724,0.3015,0
逃亡(1948),逃亡,notion,0,1,1,0,1,1,0.011322,4,0.269061,0.285394,0
逃兵(1948),逃兵,notion,0,2,2,0,2,2,0.026972,4,0.293947,0.324781,1749.441854
逃出(1948),逃出,notion,0,2,2,0,2,2,0.016339,4,0.275312,0.295998,876.896283
逃到(1948),逃到,notion,0,1,1,0,1,1,0.011322,4,0.269061,0.285394,0
逃来(1948),逃来,notion,0,1,1,0,1,1,0.016518,4,0.278724,0.3015,0
逃难(1948),逃难,notion,0,1,1,0,2,2,0.016752,4,0.279138,0.302165,0
逆流(1948),逆流,notion,0,4,4,0,7,7,0.038342,4,0.312716,0.350415,8111.664392
逆转(1948),逆转,notion,0,2,2,0,2,2,0.033269,4,0.305692,0.34112,2297.98609
选录(1948),选录,notion,0,1,1,0,1,1,0.005389,4,0.25849,0.266394,0
选手(1948),选手,notion,0,1,1,0,1,1,0.011322,4,0.269061,0.285394,0
选民(1948),选民,notion,0,1,1,0,1,1,0.01424,4,0.275514,0.296275,0
选译(1948),选译,notion,0,1,1,0,1,1,0.01424,4,0.275514,0.296275,0
选集(1948),选集,notion,0,1,1,0,1,1,0.011322,4,0.269061,0.285394,0
逊王(1948),逊王,notion,0,1,1,0,1,1,0.01424,4,0.275514,0.296275,0
透视(1948),透视,notion,0,6,6,0,9,9,0.078338,4,0.386889,0.42716,33926.350021
逐渐(1948),逐渐,notion,0,1,1,0,1,1,0.016752,4,0.279138,0.302165,0
逐鹿(1948),逐鹿,notion,0,1,1,0,1,1,0.016752,4,0.279138,0.302165,0
途上(1948),途上,notion,0,1,1,0,1,1,0.009739,4,0.265806,0.279704,0
途中(1948),途中,notion,0,1,1,0,1,1,0.016752,4,0.279138,0.302165,0
通儒(1948),通儒,notion,0,1,1,0,1,1,0.01424,4,0.275514,0.296275,0
通则(1948),通则,notion,0,1,1,0,1,1,0.007515,4,0.262793,0.274313,0
通化(1948),通化,notion,0,1,1,0,1,1,0.008247,4,0.26379,0.27611,0
通告(1948),通告,notion,0,1,1,0,1,1,0.016518,4,0.278724,0.3015,0
通宵(1948),通宵,notion,0,1,1,0,1,1,0.016752,4,0.279138,0.302165,0
通电(1948),通电,notion,0,1,1,0,2,2,0.016518,4,0.278724,0.3015,0
通益(1948),通益,notion,0,1,1,0,1,1,0.004718,4,0.258401,0.266227,0
通缉(1948),通缉,notion,0,1,1,0,1,1,0.01424,4,0.275514,0.296275,0
通讯社(1948),通讯社,notion,0,1,1,0,1,1,0.01022,4,0.267243,0.282233,0
通货(1948),通货,notion,0,1,1,0,1,1,0.007515,4,0.262793,0.274313,0
通货膨胀(1948),通货膨胀,notion,0,3,3,0,4,4,0.021152,4,0.282603,0.307767,3176.639604
通达(1948),通达,notion,0,1,1,0,1,1,0.01424,4,0.275514,0.296275,0
通过(1948),通过,notion,0,1,1,0,1,1,0.009739,4,0.265806,0.279704,0
逝世(1948),逝世,notion,0,5,5,0,8,8,0.052351,4,0.329272,0.370569,12753.323926
逞威(1948),逞威,notion,0,1,1,0,1,1,0.009751,4,0.267186,0.282133,0
造因(1948),造因,notion,0,1,1,0,1,1,0.016752,4,0.279138,0.302165,0
造成(1948),造成,notion,0,1,1,0,2,2,0.01424,4,0.275514,0.296275,0
造极(1948),造极,notion,0,1,1,0,1,1,0.011322,4,0.269061,0.285394,0
造福(1948),造福,notion,0,1,1,0,1,1,0.016752,4,0.279138,0.302165,0
造谣(1948),造谣,notion,0,2,2,0,3,3,0.026738,4,0.294408,0.325447,1993.868267
逮捕(1948),逮捕,notion,0,2,2,0,3,3,0.021769,4,0.284983,0.311405,1063.457371
逻辑(1948),逻辑,notion,0,1,1,0,1,1,0.011322,4,0.269061,0.285394,0
逼近(1948),逼近,notion,0,3,3,0,3,3,0.036478,4,0.30767,0.343804,4821.551069
遇到(1948),遇到,notion,0,1,1,0,1,1,0.016752,4,0.279138,0.302165,0
遇刺(1948),遇刺,notion,0,1,1,0,1,1,0.016518,4,0.278724,0.3015,0
遇险记(1948),遇险记,notion,0,1,1,0,1,1,0.016752,4,0.279138,0.302165,0
遊行(1948),遊行,notion,0,2,2,0,2,2,0.027839,4,0.295962,0.327676,1920.33989
遊资(1948),遊资,notion,0,1,1,0,1,1,0.008247,4,0.26379,0.27611,0
遍地(1948),遍地,notion,0,2,2,0,2,2,0.008698,4,0.258507,0.266483,0.569098
道义(1948),道义,notion,0,1,1,0,1,1,0.01424,4,0.275514,0.296275,0
道席(1948),道席,notion,0,1,1,0,1,1,0.01424,4,0.275514,0.296275,0
道鉴(1948),道鉴,notion,0,1,1,0,1,1,0.01424,4,0.275514,0.296275,0
遗书(1948),遗书,notion,0,1,1,0,1,1,0.011322,4,0.269061,0.285394,0
遗作(1948),遗作,notion,0,1,1,0,1,1,0.016752,4,0.279138,0.302165,0
遗嘱(1948),遗嘱,notion,0,1,1,0,1,1,0.016518,4,0.278724,0.3015,0
遗忘(1948),遗忘,notion,0,3,3,0,3,3,0.018919,4,0.274568,0.294822,1295.743183
遗念(1948),遗念,notion,0,2,2,0,2,2,0.008698,4,0.258507,0.266483,0.569098
遗教(1948),遗教,notion,0,1,1,0,1,1,0.004718,4,0.258401,0.266227,0
遗诗(1948),遗诗,notion,0,1,1,0,1,1,0.01424,4,0.275514,0.296275,0
遥望(1948),遥望,notion,0,1,1,0,1,1,0.01022,4,0.267243,0.282233,0
遥致(1948),遥致,notion,0,1,1,0,1,1,0.005017,4,0.257497,0.26453,0
遭遇(1948),遭遇,notion,0,1,1,0,2,2,0.016752,4,0.279138,0.302165,0
遵守纪律(1948),遵守纪律,notion,0,1,1,0,1,1,0.009751,4,0.267186,0.282133,0
邓初民(1948),邓初民,notion,0,1,1,0,1,1,0.005017,4,0.257497,0.26453,0
邓海魁(1948),邓海魁,notion,0,1,1,0,1,1,0.009751,4,0.267186,0.282133,0
邓特(1948),邓特,notion,0,1,1,0,1,1,0.009739,4,0.265806,0.279704,0
邓颖超(1948),邓颖超,notion,0,1,1,0,1,1,0.016518,4,0.278724,0.3015,0
那斯列琴(1948),那斯列琴,notion,0,1,1,0,1,1,0.016752,4,0.279138,0.302165,0
那趟(1948),那趟,notion,0,1,1,0,1,1,0.008247,4,0.26379,0.27611,0
那里(1948),那里,notion,0,4,4,0,5,5,0.050486,4,0.333186,0.374972,12072.791745
邦交(1948),邦交,notion,0,2,2,0,3,3,0.023995,4,0.291507,0.321221,2493.732085
邮务(1948),邮务,notion,0,1,1,0,1,1,0.011322,4,0.269061,0.285394,0
邮寄(1948),邮寄,notion,0,2,2,0,2,2,0.008698,4,0.258507,0.266483,0.569098
邮局(1948),邮局,notion,0,2,2,0,2,2,0.024461,4,0.291756,0.321587,2304.72473
邮工(1948),邮工,notion,0,1,1,0,1,1,0.016518,4,0.278724,0.3015,0
邮检(1948),邮检,notion,0,1,1,0,1,1,0.011322,4,0.269061,0.285394,0
邮费(1948),邮费,notion,0,1,1,0,1,1,0.011322,4,0.269061,0.285394,0
邮资(1948),邮资,notion,0,2,2,0,2,2,0.021542,4,0.284314,0.310373,1410.419447
邵力子(1948),邵力子,notion,0,1,1,0,1,1,0.01424,4,0.275514,0.296275,0
邻海(1948),邻海,notion,0,1,1,0,1,1,0.01022,4,0.267243,0.282233,0
邻邦(1948),邻邦,notion,0,1,1,0,1,1,0.01424,4,0.275514,0.296275,0
郊县(1948),郊县,notion,0,1,1,0,1,1,0.004718,4,0.258401,0.266227,0
郊外(1948),郊外,notion,0,1,1,0,1,1,0.008247,4,0.26379,0.27611,0
郎中(1948),郎中,notion,0,1,1,0,1,1,0.016752,4,0.279138,0.302165,0
郑兆夏(1948),郑兆夏,notion,0,1,1,0,1,1,0.011322,4,0.269061,0.285394,0
郑州(1948),郑州,notion,0,1,1,0,1,1,0.004718,4,0.258401,0.266227,0
部门(1948),部门,notion,0,1,1,0,1,1,0.004718,4,0.258401,0.266227,0
部队(1948),部队,notion,0,2,2,0,2,2,0.021073,4,0.285785,0.312636,2242.44705
郭子仪(1948),郭子仪,notion,0,1,1,0,1,1,0.007515,4,0.262793,0.274313,0
郭沫若(1948),郭沫若,notion,0,1,1,0,1,1,0.009739,4,0.265806,0.279704,0
都市(1948),都市,notion,0,4,4,0,4,4,0.033697,4,0.29817,0.330915,4720.340464
都江堰(1948),都江堰,notion,0,1,1,0,1,1,0.01424,4,0.275514,0.296275,0
鄂北(1948),鄂北,notion,0,1,1,0,1,1,0.01424,4,0.275514,0.296275,0
鄕村(1948),鄕村,notion,0,1,1,0,1,1,0.011322,4,0.269061,0.285394,0
配上(1948),配上,notion,0,1,1,0,1,1,0.009755,4,0.266617,0.281135,0
配售(1948),配售,notion,0,1,1,0,1,1,0.01424,4,0.275514,0.296275,0
配粮(1948),配粮,notion,0,1,1,0,1,1,0.016518,4,0.278724,0.3015,0
配给(1948),配给,notion,0,3,3,0,3,3,0.035589,4,0.307897,0.344104,5512.554671
酝酿(1948),酝酿,notion,0,1,1,0,4,4,0.016752,4,0.279138,0.302165,0
酬劳(1948),酬劳,notion,0,1,1,0,1,1,0.007515,4,0.262793,0.274313,0
醜剧(1948),醜剧,notion,0,1,1,0,1,1,0.016518,4,0.278724,0.3015,0
醴陵(1948),醴陵,notion,0,1,1,0,1,1,0.016518,4,0.278724,0.3015,0
采取措施(1948),采取措施,notion,0,1,1,0,1,1,0.01424,4,0.275514,0.296275,0
释放(1948),释放,notion,0,1,1,0,1,1,0.009751,4,0.267186,0.282133,0
释疑(1948),释疑,notion,0,1,1,0,1,1,0.005017,4,0.257497,0.26453,0
里亚蒂(1948),里亚蒂,notion,0,1,1,0,1,1,0.016518,4,0.278724,0.3015,0
里夫(1948),里夫,notion,0,1,1,0,1,1,0.009755,4,0.266617,0.281135,0
里里外外(1948),里里外外,notion,0,1,1,0,1,1,0.01022,4,0.267243,0.282233,0
重华(1948),重华,notion,0,1,1,0,1,1,0.007515,4,0.262793,0.274313,0
重压(1948),重压,notion,0,1,1,0,1,1,0.01022,4,0.267243,0.282233,0
重商(1948),重商,notion,0,1,1,0,1,1,0.01022,4,0.267243,0.282233,0
重庆大学(1948),重庆大学,notion,0,1,1,0,1,1,0.007515,4,0.262793,0.274313,0
重建(1948),重建,notion,0,4,4,0,4,4,0.045449,4,0.326269,0.367019,13689.43535
重弹(1948),重弹,notion,0,1,1,0,1,1,0.008247,4,0.26379,0.27611,0
重心(1948),重心,notion,0,2,2,0,2,2,0.030992,4,0.303936,0.338757,2912.385696
重惩(1948),重惩,notion,0,1,1,0,1,1,0.01424,4,0.275514,0.296275,0
重持(1948),重持,notion,0,1,1,0,1,1,0.011322,4,0.269061,0.285394,0
重整(1948),重整,notion,0,1,1,0,1,1,0.016752,4,0.279138,0.302165,0
重施(1948),重施,notion,0,1,1,0,1,1,0.016752,4,0.279138,0.302165,0
重来(1948),重来,notion,0,1,1,0,1,1,0.016518,4,0.278724,0.3015,0
重温(1948),重温,notion,0,2,2,0,2,2,0.026972,4,0.293947,0.324781,1749.441854
重演(1948),重演,notion,0,2,2,0,3,3,0.025562,4,0.293259,0.323783,2167.4723
重点(1948),重点,notion,0,1,1,0,1,1,0.007515,4,0.262793,0.274313,0
重要(1948),重要,notion,0,4,4,0,6,6,0.042308,4,0.320206,0.359765,12705.864362
重视(1948),重视,notion,0,1,1,0,1,1,0.01424,4,0.275514,0.296275,0
重返(1948),重返,notion,0,1,1,0,1,1,0.009755,4,0.266617,0.281135,0
重重(1948),重重,notion,0,2,2,0,2,2,0.026491,4,0.291937,0.321853,1403.825067
重重的(1948),重重的,notion,0,1,1,0,3,3,0.016752,4,0.279138,0.302165,0
野心(1948),野心,notion,0,1,1,0,1,1,0.007515,4,0.262793,0.274313,0
野战军(1948),野战军,notion,0,1,1,0,1,1,0.016518,4,0.278724,0.3015,0
野火(1948),野火,notion,0,1,1,0,1,1,0.016752,4,0.279138,0.302165,0
金元(1948),金元,notion,0,4,4,0,5,5,0.025968,4,0.286111,0.313246,4821.710961
金园券(1948),金园券,notion,0,1,1,0,1,1,0.005389,4,0.25849,0.266394,0
金圆(1948),金圆,notion,0,2,2,0,2,2,0.008698,4,0.258507,0.266483,0.569098
金圆卷(1948),金圆卷,notion,0,1,1,0,2,2,0.005017,4,0.257497,0.26453,0
金多(1948),金多,notion,0,1,1,0,1,1,0.008247,4,0.26379,0.27611,0
金山寺(1948),金山寺,notion,0,1,1,0,1,1,0.01424,4,0.275514,0.296275,0
金币(1948),金币,notion,0,1,1,0,1,1,0.011322,4,0.269061,0.285394,0
金日成(1948),金日成,notion,0,1,1,0,3,3,0.009755,4,0.266617,0.281135,0
金涛(1948),金涛,notion,0,1,1,0,1,1,0.01022,4,0.267243,0.282233,0
金箍(1948),金箍,notion,0,1,1,0,1,1,0.009755,4,0.266617,0.281135,0
金融(1948),金融,notion,0,4,4,0,5,5,0.038918,4,0.314892,0.353177,12623.223835
金融管理(1948),金融管理,notion,0,1,1,0,1,1,0.01022,4,0.267243,0.282233,0
金融资本(1948),金融资本,notion,0,1,1,0,1,1,0.01424,4,0.275514,0.296275,0
金钞(1948),金钞,notion,0,1,1,0,1,1,0.01022,4,0.267243,0.282233,0
金银(1948),金银,notion,0,1,1,0,1,1,0.016752,4,0.279138,0.302165,0
金陵(1948),金陵,notion,0,2,2,0,4,4,0.030758,4,0.303347,0.337959,2812.221703
金风(1948),金风,notion,0,1,1,0,1,1,0.016752,4,0.279138,0.302165,0
金鼓齐鸣(1948),金鼓齐鸣,notion,0,1,1,0,1,1,0.016752,4,0.279138,0.302165,0
鉴往知来(1948),鉴往知来,notion,0,1,1,0,1,1,0.009739,4,0.265806,0.279704,0
鏖战(1948),鏖战,notion,0,1,1,0,1,1,0.016752,4,0.279138,0.302165,0
钞票(1948),钞票,notion,0,1,1,0,1,1,0.016752,4,0.279138,0.302165,0
钢铁(1948),钢铁,notion,0,1,1,0,2,2,0.009751,4,0.267186,0.282133,0
钥匙(1948),钥匙,notion,0,1,1,0,1,1,0.016752,4,0.279138,0.302165,0
钦定(1948),钦定,notion,0,1,1,0,1,1,0.016518,4,0.278724,0.3015,0
钳形攻势(1948),钳形攻势,notion,0,1,1,0,1,1,0.016518,4,0.278724,0.3015,0
铁围(1948),铁围,notion,0,1,1,0,1,1,0.009751,4,0.267186,0.282133,0
铁幕(1948),铁幕,notion,0,2,2,0,2,2,0.025562,4,0.293259,0.323783,2167.4723
铁托(1948),铁托,notion,0,1,1,0,1,1,0.009755,4,0.266617,0.281135,0
铁流(1948),铁流,notion,0,1,1,0,1,1,0.009755,4,0.266617,0.281135,0
铁路(1948),铁路,notion,0,2,2,0,2,2,0.021535,4,0.28397,0.309841,889.229879
铁路工人(1948),铁路工人,notion,0,1,1,0,1,1,0.01424,4,0.275514,0.296275,0
铁蹄(1948),铁蹄,notion,0,1,1,0,1,1,0.01424,4,0.275514,0.296275,0
铁骑(1948),铁骑,notion,0,1,1,0,1,1,0.016752,4,0.279138,0.302165,0
铅山(1948),铅山,notion,0,1,1,0,1,1,0.004718,4,0.258401,0.266227,0
铲除(1948),铲除,notion,0,1,1,0,1,1,0.009751,4,0.267186,0.282133,0
银本位(1948),银本位,notion,0,1,1,0,1,1,0.01022,4,0.267243,0.282233,0
银江乡(1948),银江乡,notion,0,1,1,0,1,1,0.009751,4,0.267186,0.282133,0
银行(1948),银行,notion,0,2,2,0,2,2,0.021235,4,0.286701,0.314033,2523.953101
银行业(1948),银行业,notion,0,1,1,0,1,1,0.008247,4,0.26379,0.27611,0
银行家(1948),银行家,notion,0,1,1,0,1,1,0.009755,4,0.266617,0.281135,0
铸造(1948),铸造,notion,0,1,1,0,1,1,0.011322,4,0.269061,0.285394,0
锁炼(1948),锁炼,notion,0,1,1,0,1,1,0.016752,4,0.279138,0.302165,0
锁钥(1948),锁钥,notion,0,1,1,0,1,1,0.01424,4,0.275514,0.296275,0
锄头(1948),锄头,notion,0,1,1,0,1,1,0.009751,4,0.267186,0.282133,0
锐利武器(1948),锐利武器,notion,0,1,1,0,1,1,0.016518,4,0.278724,0.3015,0
错觉(1948),错觉,notion,0,2,2,0,2,2,0.024765,4,0.291552,0.321288,2097.245087
错误(1948),错误,notion,0,6,6,0,9,9,0.07156,4,0.37206,0.414282,30810.785277
锡兰(1948),锡兰,notion,0,1,1,0,1,1,0.009739,4,0.265806,0.279704,0
锡矿(1948),锡矿,notion,0,1,1,0,1,1,0.008247,4,0.26379,0.27611,0
锡矿山(1948),锡矿山,notion,0,1,1,0,1,1,0.005017,4,0.257497,0.26453,0
锦上添花(1948),锦上添花,notion,0,1,1,0,1,1,0.011322,4,0.269061,0.285394,0
锦城(1948),锦城,notion,0,1,1,0,1,1,0.008247,4,0.26379,0.27611,0
锦州(1948),锦州,notion,0,6,6,0,6,6,0.07281,4,0.370884,0.413217,29053.156304
锦西(1948),锦西,notion,0,1,1,0,1,1,0.016752,4,0.279138,0.302165,0
锻炼(1948),锻炼,notion,0,1,1,0,1,1,0.004718,4,0.258401,0.266227,0
镍币(1948),镍币,notion,0,3,3,0,3,3,0.025216,4,0.286155,0.313257,1882.815007
镜头(1948),镜头,notion,0,1,1,0,1,1,0.01022,4,0.267243,0.282233,0
镣铐(1948),镣铐,notion,0,1,1,0,1,1,0.009755,4,0.266617,0.281135,0
长久(1948),长久,notion,0,1,1,0,1,1,0.008247,4,0.26379,0.27611,0
长于(1948),长于,notion,0,1,1,0,1,1,0.005017,4,0.257497,0.26453,0
长保此(1948),长保此,notion,0,1,1,0,1,1,0.008247,4,0.26379,0.27611,0
长城(1948),长城,notion,0,2,2,0,2,2,0.024461,4,0.291756,0.321587,2304.72473
长春(1948),长春,notion,0,4,4,0,8,8,0.028267,4,0.287425,0.315242,3567.203068
长春市(1948),长春市,notion,0,1,1,0,1,1,0.008247,4,0.26379,0.27611,0
长期(1948),长期,notion,0,1,1,0,1,1,0.01022,4,0.267243,0.282233,0
长江(1948),长江,notion,0,4,4,0,4,4,0.042101,4,0.313892,0.351912,7393.477202
长者(1948),长者,notion,0,1,1,0,1,1,0.01424,4,0.275514,0.296275,0
閒话(1948),閒话,notion,0,1,1,0,1,1,0.01424,4,0.275514,0.296275,0
闢谣(1948),闢谣,notion,0,1,1,0,1,1,0.01424,4,0.275514,0.296275,0
门侧(1948),门侧,notion,0,1,1,0,1,1,0.016752,4,0.279138,0.302165,0
门前(1948),门前,notion,0,1,1,0,1,1,0.016752,4,0.279138,0.302165,0
门外(1948),门外,notion,0,1,1,0,1,1,0.01022,4,0.267243,0.282233,0
闭幕(1948),闭幕,notion,0,2,2,0,2,2,0.019491,4,0.281819,0.30648,1649.883746
问世(1948),问世,notion,0,1,1,0,1,1,0.008247,4,0.26379,0.27611,0
问关(1948),问关,notion,0,1,1,0,1,1,0.011322,4,0.269061,0.285394,0
问卦(1948),问卦,notion,0,1,1,0,1,1,0.016518,4,0.278724,0.3015,0
问君(1948),问君,notion,0,1,1,0,1,1,0.009751,4,0.267186,0.282133,0
问答(1948),问答,notion,0,2,2,0,2,2,0.018837,4,0.280346,0.304151,1468.125238
闰位(1948),闰位,notion,0,1,1,0,1,1,0.007515,4,0.262793,0.274313,0
闲话(1948),闲话,notion,0,2,2,0,2,2,0.008698,4,0.258507,0.266483,0.569098
闷葫芦(1948),闷葫芦,notion,0,1,1,0,1,1,0.01022,4,0.267243,0.282233,0
闺女(1948),闺女,notion,0,1,1,0,1,1,0.009751,4,0.267186,0.282133,0
闻一多(1948),闻一多,notion,0,2,2,0,3,3,0.016339,4,0.275312,0.295998,876.896283
闽粤(1948),闽粤,notion,0,2,2,0,3,3,0.026269,4,0.293695,0.324415,1931.353166
阅读(1948),阅读,notion,0,1,1,0,1,1,0.011322,4,0.269061,0.285394,0
阆州(1948),阆州,notion,0,1,1,0,1,1,0.008247,4,0.26379,0.27611,0
阎傅(1948),阎傅,notion,0,1,1,0,1,1,0.01022,4,0.267243,0.282233,0
阎锡山(1948),阎锡山,notion,0,2,2,0,2,2,0.027839,4,0.295962,0.327676,1920.33989
阐明(1948),阐明,notion,0,1,1,0,1,1,0.005017,4,0.257497,0.26453,0
阔步(1948),阔步,notion,0,1,1,0,1,1,0.011322,4,0.269061,0.285394,0
队伍(1948),队伍,notion,0,4,4,0,7,7,0.046244,4,0.325619,0.366254,11720.617531
队大(1948),队大,notion,0,1,1,0,1,1,0.016518,4,0.278724,0.3015,0
队长(1948),队长,notion,0,1,1,0,1,1,0.004718,4,0.258401,0.266227,0
防制(1948),防制,notion,0,1,1,0,1,1,0.01424,4,0.275514,0.296275,0
防务(1948),防务,notion,0,1,1,0,1,1,0.016752,4,0.279138,0.302165,0
防匪(1948),防匪,notion,0,1,1,0,1,1,0.01424,4,0.275514,0.296275,0
防止(1948),防止,notion,0,3,3,0,3,3,0.031495,4,0.301642,0.335685,5382.307293
防线(1948),防线,notion,0,2,2,0,2,2,0.014757,4,0.271708,0.289975,655.261449
阳云(1948),阳云,notion,0,1,1,0,1,1,0.01424,4,0.275514,0.296275,0
阳光(1948),阳光,notion,0,1,1,0,1,1,0.009755,4,0.266617,0.281135,0
阴云(1948),阴云,notion,0,1,1,0,1,1,0.01022,4,0.267243,0.282233,0
阴关(1948),阴关,notion,0,1,1,0,1,1,0.01424,4,0.275514,0.296275,0
阴影(1948),阴影,notion,0,1,1,0,1,1,0.01022,4,0.267243,0.282233,0
阴谋(1948),阴谋,notion,0,6,6,0,17,17,0.059028,4,0.341547,0.384267,21374.90082
阴谋诡计(1948),阴谋诡计,notion,0,1,1,0,1,1,0.009751,4,0.267186,0.282133,0
阴霾(1948),阴霾,notion,0,1,1,0,1,1,0.007515,4,0.262793,0.274313,0
阵线(1948),阵线,notion,0,2,2,0,4,4,0.019494,4,0.280535,0.30445,1251.270065
阵雨(1948),阵雨,notion,0,1,1,0,1,1,0.016752,4,0.279138,0.302165,0
阶段(1948),阶段,notion,0,9,9,0,16,16,0.096692,4,0.424823,0.456176,70387.012736
阶级(1948),阶级,notion,0,3,3,0,3,3,0.034985,4,0.307418,0.343471,5704.202313
阶级意识(1948),阶级意识,notion,0,1,1,0,1,1,0.016752,4,0.279138,0.302165,0
阻挠(1948),阻挠,notion,0,2,2,0,2,2,0.025562,4,0.293259,0.323783,2167.4723
阻止(1948),阻止,notion,0,1,1,0,1,1,0.016752,4,0.279138,0.302165,0
阻碍(1948),阻碍,notion,0,1,1,0,1,1,0.002332,4,0.253398,0.256677,0
阿Q(1948),阿Q,notion,0,1,1,0,1,1,0.016752,4,0.279138,0.302165,0
阿兰(1948),阿兰,notion,0,1,1,0,1,1,0.009751,4,0.267186,0.282133,0
阿刺伯(1948),阿刺伯,notion,0,1,1,0,1,1,0.009755,4,0.266617,0.281135,0
阿尔勃(1948),阿尔勃,notion,0,1,1,0,1,1,0.007515,4,0.262793,0.274313,0
阿尔卑斯山(1948),阿尔卑斯山,notion,0,1,1,0,1,1,0.01424,4,0.275514,0.296275,0
阿山(1948),阿山,notion,0,2,2,0,2,2,0.008698,4,0.258507,0.266483,0.569098
阿拉伯(1948),阿拉伯,notion,0,1,1,0,1,1,0.009755,4,0.266617,0.281135,0
阿拉贡(1948),阿拉贡,notion,0,1,1,0,1,1,0.009755,4,0.266617,0.281135,0
阿斗(1948),阿斗,notion,0,1,1,0,1,1,0.007515,4,0.262793,0.274313,0
阿根廷(1948),阿根廷,notion,0,1,1,0,1,1,0.007515,4,0.262793,0.274313,0
附录(1948),附录,notion,0,1,1,0,1,1,0.01022,4,0.267243,0.282233,0
附近(1948),附近,notion,0,2,2,0,2,2,0.026507,4,0.294224,0.325181,2012.895914
陆丰(1948),陆丰,notion,0,1,1,0,1,1,0.009751,4,0.267186,0.282133,0
陆志章(1948),陆志章,notion,0,1,1,0,1,1,0.011322,4,0.269061,0.285394,0
陆志韦(1948),陆志韦,notion,0,1,1,0,1,1,0.016752,4,0.279138,0.302165,0
陆懋德(1948),陆懋德,notion,0,1,1,0,1,1,0.016752,4,0.279138,0.302165,0
陆濠(1948),陆濠,notion,0,1,1,0,1,1,0.009739,4,0.265806,0.279704,0
陆濠们(1948),陆濠们,notion,0,1,1,0,1,1,0.009739,4,0.265806,0.279704,0
陇东(1948),陇东,notion,0,1,1,0,1,1,0.01022,4,0.267243,0.282233,0
陇海(1948),陇海,notion,0,1,1,0,1,1,0.01022,4,0.267243,0.282233,0
陈云(1948),陈云,notion,0,1,1,0,1,1,0.016518,4,0.278724,0.3015,0
陈公洽(1948),陈公洽,notion,0,1,1,0,1,1,0.01424,4,0.275514,0.296275,0
陈嘉庚(1948),陈嘉庚,notion,0,1,1,0,3,3,0.01424,4,0.275514,0.296275,0
陈棺(1948),陈棺,notion,0,1,1,0,1,1,0.009751,4,0.267186,0.282133,0
陈毅(1948),陈毅,notion,0,1,1,0,1,1,0.016518,4,0.278724,0.3015,0
陈涉(1948),陈涉,notion,0,1,1,0,1,1,0.009751,4,0.267186,0.282133,0
陈祖武(1948),陈祖武,notion,0,1,1,0,1,1,0.009751,4,0.267186,0.282133,0
陈纳德(1948),陈纳德,notion,0,1,1,0,1,1,0.016752,4,0.279138,0.302165,0
陈诉(1948),陈诉,notion,0,2,2,0,2,2,0.013654,4,0.271629,0.289842,747.864247
陈诚(1948),陈诚,notion,0,1,1,0,1,1,0.016752,4,0.279138,0.302165,0
陈赓(1948),陈赓,notion,0,1,1,0,1,1,0.016518,4,0.278724,0.3015,0
陈述(1948),陈述,notion,0,1,1,0,1,1,0.01424,4,0.275514,0.296275,0
陈雪屏(1948),陈雪屏,notion,0,1,1,0,1,1,0.01022,4,0.267243,0.282233,0
限价(1948),限价,notion,0,5,5,0,6,6,0.042225,4,0.31651,0.355262,14349.644783
限制(1948),限制,notion,0,1,1,0,1,1,0.01424,4,0.275514,0.296275,0
限度(1948),限度,notion,0,1,1,0,1,1,0.01022,4,0.267243,0.282233,0
限於(1948),限於,notion,0,1,1,0,1,1,0.008247,4,0.26379,0.27611,0
限期(1948),限期,notion,0,1,1,0,1,1,0.01424,4,0.275514,0.296275,0
限田(1948),限田,notion,0,1,1,0,1,1,0.01424,4,0.275514,0.296275,0
限租(1948),限租,notion,0,1,1,0,1,1,0.016518,4,0.278724,0.3015,0
限购(1948),限购,notion,0,1,1,0,1,1,0.007515,4,0.262793,0.274313,0
陕北(1948),陕北,notion,0,2,2,0,4,4,0.021535,4,0.28397,0.309841,889.229879
陕晋(1948),陕晋,notion,0,1,1,0,1,1,0.01022,4,0.267243,0.282233,0
陕西(1948),陕西,notion,0,2,2,0,2,2,0.024999,4,0.291484,0.321188,1929.694181
陜北(1948),陜北,notion,0,1,1,0,1,1,0.016518,4,0.278724,0.3015,0
陡涨(1948),陡涨,notion,0,1,1,0,1,1,0.01022,4,0.267243,0.282233,0
院内(1948),院内,notion,0,1,1,0,1,1,0.011322,4,0.269061,0.285394,0
院士(1948),院士,notion,0,3,3,0,3,3,0.033463,4,0.302687,0.337116,3835.275563
院长(1948),院长,notion,0,2,2,0,3,3,0.024999,4,0.291484,0.321188,1929.694181
除了(1948),除了,notion,0,1,1,0,1,1,0.009739,4,0.265806,0.279704,0
除夕(1948),除夕,notion,0,1,1,0,1,1,0.009739,4,0.265806,0.279704,0
险局(1948),险局,notion,0,1,1,0,1,1,0.01022,4,0.267243,0.282233,0
陪都(1948),陪都,notion,0,1,1,0,1,1,0.01022,4,0.267243,0.282233,0
陶端予(1948),陶端予,notion,0,1,1,0,1,1,0.009751,4,0.267186,0.282133,0
陷落(1948),陷落,notion,0,1,1,0,1,1,0.009739,4,0.265806,0.279704,0
隆克区(1948),隆克区,notion,0,1,1,0,1,1,0.009739,4,0.265806,0.279704,0
随声附和(1948),随声附和,notion,0,1,1,0,1,1,0.008247,4,0.26379,0.27611,0
随着(1948),随着,notion,0,1,1,0,1,1,0.009739,4,0.265806,0.279704,0
随笔(1948),随笔,notion,0,5,5,0,5,5,0.043449,4,0.315739,0.354297,11059.670332
隐伏(1948),隐伏,notion,0,1,1,0,1,1,0.01424,4,0.275514,0.296275,0
隐士(1948),隐士,notion,0,1,1,0,1,1,0.008247,4,0.26379,0.27611,0
隐忧(1948),隐忧,notion,0,1,1,0,1,1,0.007515,4,0.262793,0.274313,0
隔阂(1948),隔阂,notion,0,1,1,0,1,1,0.01424,4,0.275514,0.296275,0
隙缝(1948),隙缝,notion,0,1,1,0,1,1,0.016752,4,0.279138,0.302165,0
障碍(1948),障碍,notion,0,1,1,0,1,1,0.009751,4,0.267186,0.282133,0
难产(1948),难产,notion,0,1,1,0,1,1,0.008247,4,0.26379,0.27611,0
难关(1948),难关,notion,0,1,1,0,1,1,0.007515,4,0.262793,0.274313,0
难战(1948),难战,notion,0,2,2,0,2,2,0.015129,4,0.273409,0.292837,905.025109
难民(1948),难民,notion,0,2,2,0,3,3,0.012553,4,0.269796,0.286714,703.533419
难道(1948),难道,notion,0,1,1,0,1,1,0.016518,4,0.278724,0.3015,0
难题(1948),难题,notion,0,1,1,0,1,1,0.009739,4,0.265806,0.279704,0
雄圣(1948),雄圣,notion,0,1,1,0,1,1,0.011322,4,0.269061,0.285394,0
雅典(1948),雅典,notion,0,4,4,0,5,5,0.050486,4,0.333186,0.374972,12072.791745
集会(1948),集会,notion,0,3,3,0,3,3,0.024508,4,0.287513,0.31532,3347.867302
集会自由(1948),集会自由,notion,0,1,1,0,1,1,0.009739,4,0.265806,0.279704,0
集体主义(1948),集体主义,notion,0,1,1,0,1,1,0.009751,4,0.267186,0.282133,0
集体领导(1948),集体领导,notion,0,1,1,0,1,1,0.016518,4,0.278724,0.3015,0
集团(1948),集团,notion,0,6,6,0,6,6,0.072021,4,0.367654,0.410256,25268.797927
集外(1948),集外,notion,0,1,1,0,1,1,0.007515,4,0.262793,0.274313,0
雏型(1948),雏型,notion,0,1,1,0,1,1,0.011322,4,0.269061,0.285394,0
雕刻(1948),雕刻,notion,0,1,1,0,1,1,0.009755,4,0.266617,0.281135,0
雪莱(1948),雪莱,notion,0,1,1,0,1,1,0.007515,4,0.262793,0.274313,0
雷厉风行(1948),雷厉风行,notion,0,2,2,0,2,2,0.008698,4,0.258507,0.266483,0.569098
雾之浦(1948),雾之浦,notion,0,1,1,0,1,1,0.009739,4,0.265806,0.279704,0
雾幕(1948),雾幕,notion,0,1,1,0,1,1,0.016518,4,0.278724,0.3015,0
雾里(1948),雾里,notion,0,2,2,0,2,2,0.012905,4,0.270573,0.288045,1024.740512
需要(1948),需要,notion,0,10,10,0,13,13,0.104661,4,0.436777,0.464284,79295.972696
震动(1948),震动,notion,0,1,1,0,1,1,0.016752,4,0.279138,0.302165,0
震撼(1948),震撼,notion,0,3,3,0,4,4,0.031756,4,0.29943,0.332623,3656.936897
霍夫(1948),霍夫,notion,0,1,1,0,1,1,0.009755,4,0.266617,0.281135,0
霓裳(1948),霓裳,notion,0,1,1,0,1,1,0.009751,4,0.267186,0.282133,0
露出(1948),露出,notion,0,3,3,0,3,3,0.04751,4,0.331714,0.373253,8022.59349
青年人(1948),青年人,notion,0,1,1,0,1,1,0.009751,4,0.267186,0.282133,0
青年会(1948),青年会,notion,0,1,1,0,1,1,0.007515,4,0.262793,0.274313,0
青年党(1948),青年党,notion,0,2,2,0,2,2,0.018837,4,0.280346,0.304151,1468.125238
青年节(1948),青年节,notion,0,1,1,0,1,1,0.016752,4,0.279138,0.302165,0
青春(1948),青春,notion,0,1,1,0,1,1,0.016752,4,0.279138,0.302165,0
靖康(1948),靖康,notion,0,1,1,0,1,1,0.01022,4,0.267243,0.282233,0
静静的(1948),静静的,notion,0,1,1,0,1,1,0.01424,4,0.275514,0.296275,0
非常(1948),非常,notion,0,1,1,0,1,1,0.009739,4,0.265806,0.279704,0
非法(1948),非法,notion,0,1,1,0,1,1,0.005017,4,0.257497,0.26453,0
非法组织(1948),非法组织,notion,0,1,1,0,1,1,0.007515,4,0.262793,0.274313,0
非美(1948),非美,notion,0,1,1,0,1,1,0.009739,4,0.265806,0.279704,0
面具(1948),面具,notion,0,2,2,0,2,2,0.026257,4,0.292073,0.322053,1522.40889
面前(1948),面前,notion,0,1,1,0,1,1,0.011322,4,0.269061,0.285394,0
面包(1948),面包,notion,0,2,2,0,2,2,0.017736,4,0.278993,0.301988,1631.559673
面向(1948),面向,notion,0,2,2,0,2,2,0.026269,4,0.293695,0.324415,1931.353166
面向全国(1948),面向全国,notion,0,1,1,0,1,1,0.016518,4,0.278724,0.3015,0
面向农村(1948),面向农村,notion,0,1,1,0,1,1,0.009751,4,0.267186,0.282133,0
面孔(1948),面孔,notion,0,1,1,0,1,1,0.016518,4,0.278724,0.3015,0
面对(1948),面对,notion,0,2,2,0,2,2,0.012072,4,0.268484,0.284451,677.642529
面目(1948),面目,notion,0,3,3,0,5,5,0.04208,4,0.32089,0.360542,6900.033893
面面观(1948),面面观,notion,0,1,1,0,1,1,0.009755,4,0.266617,0.281135,0
革命事业(1948),革命事业,notion,0,1,1,0,1,1,0.004718,4,0.258401,0.266227,0
革命力量(1948),革命力量,notion,0,2,2,0,2,2,0.026269,4,0.293695,0.324415,1931.353166
革命史(1948),革命史,notion,0,1,1,0,1,1,0.016752,4,0.279138,0.302165,0
革命性(1948),革命性,notion,0,2,2,0,2,2,0.023995,4,0.291507,0.321221,2493.732085
革命战争(1948),革命战争,notion,0,1,1,0,1,1,0.016518,4,0.278724,0.3015,0
革命政权(1948),革命政权,notion,0,1,1,0,1,1,0.004718,4,0.258401,0.266227,0
革命者(1948),革命者,notion,0,1,1,0,1,1,0.002332,4,0.253398,0.256677,0
革命胜利(1948),革命胜利,notion,0,1,1,0,1,1,0.016518,4,0.278724,0.3015,0
革命行动(1948),革命行动,notion,0,1,1,0,1,1,0.016518,4,0.278724,0.3015,0
革新派(1948),革新派,notion,0,1,1,0,1,1,0.01022,4,0.267243,0.282233,0
革新运动(1948),革新运动,notion,0,3,3,0,3,3,0.035313,4,0.311059,0.34823,7578.124919
靴底(1948),靴底,notion,0,1,1,0,1,1,0.011322,4,0.269061,0.285394,0
鞋子(1948),鞋子,notion,0,1,1,0,1,1,0.009751,4,0.267186,0.282133,0
鞍山(1948),鞍山,notion,0,1,1,0,1,1,0.009739,4,0.265806,0.279704,0
韦伯(1948),韦伯,notion,0,1,1,0,1,1,0.011322,4,0.269061,0.285394,0
韩侨(1948),韩侨,notion,0,1,1,0,1,1,0.016752,4,0.279138,0.302165,0
韩国(1948),韩国,notion,0,3,3,0,3,3,0.038508,4,0.316031,0.354552,7136.780743
韩大载(1948),韩大载,notion,0,1,1,0,1,1,0.007515,4,0.262793,0.274313,0
韩江(1948),韩江,notion,0,1,1,0,3,3,0.009751,4,0.267186,0.282133,0
韩着(1948),韩着,notion,0,1,1,0,1,1,0.009739,4,0.265806,0.279704,0
音乐作品(1948),音乐作品,notion,0,1,1,0,1,1,0.011322,4,0.269061,0.285394,0
音响(1948),音响,notion,0,1,1,0,6,6,0.004718,4,0.258401,0.266227,0
顺利完成(1948),顺利完成,notion,0,1,1,0,1,1,0.009739,4,0.265806,0.279704,0
顾问(1948),顾问,notion,0,2,2,0,3,3,0.028074,4,0.296149,0.327943,1864.79583
颁布(1948),颁布,notion,0,1,1,0,1,1,0.009739,4,0.265806,0.279704,0
颂歌(1948),颂歌,notion,0,1,1,0,1,1,0.009755,4,0.266617,0.281135,0
预备(1948),预备,notion,0,1,1,0,1,1,0.008247,4,0.26379,0.27611,0
预言(1948),预言,notion,0,3,3,0,3,3,0.04751,4,0.331714,0.373253,8022.59349
预言家(1948),预言家,notion,0,1,1,0,1,1,0.016518,4,0.278724,0.3015,0
预谋(1948),预谋,notion,0,1,1,0,1,1,0.008247,4,0.26379,0.27611,0
领事(1948),领事,notion,0,1,1,0,1,1,0.016752,4,0.279138,0.302165,0
领事馆(1948),领事馆,notion,0,1,1,0,1,1,0.01424,4,0.275514,0.296275,0
领土(1948),领土,notion,0,2,2,0,2,2,0.026738,4,0.294408,0.325447,1993.868267
领导(1948),领导,notion,0,5,5,0,8,8,0.056272,4,0.346717,0.389669,22259.058027
领导人(1948),领导人,notion,0,1,1,0,1,1,0.009755,4,0.266617,0.281135,0
领导权(1948),领导权,notion,0,2,2,0,2,2,0.021535,4,0.28397,0.309841,889.229879
领悟(1948),领悟,notion,0,1,1,0,1,1,0.009751,4,0.267186,0.282133,0
题写(1948),题写,notion,0,1,1,0,1,1,0.009739,4,0.265806,0.279704,0
题词(1948),题词,notion,0,1,1,0,1,1,0.01424,4,0.275514,0.296275,0
题辞(1948),题辞,notion,0,1,1,0,1,1,0.016752,4,0.279138,0.302165,0
颠沛流离(1948),颠沛流离,notion,0,1,1,0,1,1,0.01022,4,0.267243,0.282233,0
风云(1948),风云,notion,0,3,3,0,3,3,0.027475,4,0.292756,0.323107,4275.696516
风云人物(1948),风云人物,notion,0,1,1,0,1,1,0.01022,4,0.267243,0.282233,0
风俗(1948),风俗,notion,0,1,1,0,1,1,0.007515,4,0.262793,0.274313,0
风声(1948),风声,notion,0,2,2,0,2,2,0.028074,4,0.296149,0.327943,1864.79583
风度(1948),风度,notion,0,3,3,0,3,3,0.035782,4,0.309037,0.345601,5882.616477
风暴(1948),风暴,notion,0,4,4,0,6,6,0.03906,4,0.311911,0.349383,8254.499658
风格(1948),风格,notion,0,2,2,0,2,2,0.023992,4,0.29271,0.322985,3168.205568
风波(1948),风波,notion,0,4,4,0,4,4,0.048033,4,0.323822,0.364124,9070.326786
风浪(1948),风浪,notion,0,1,1,0,1,1,0.011322,4,0.269061,0.285394,0
风满楼(1948),风满楼,notion,0,1,1,0,1,1,0.005389,4,0.25849,0.266394,0
风物(1948),风物,notion,0,1,1,0,1,1,0.01424,4,0.275514,0.296275,0
风调雨顺(1948),风调雨顺,notion,0,1,1,0,1,1,0.009739,4,0.265806,0.279704,0
风起云涌(1948),风起云涌,notion,0,1,1,0,1,1,0.009751,4,0.267186,0.282133,0
风雅(1948),风雅,notion,0,1,1,0,1,1,0.011322,4,0.269061,0.285394,0
风雨(1948),风雨,notion,0,2,2,0,3,3,0.026491,4,0.291937,0.321853,1403.825067
飞快(1948),飞快,notion,0,1,1,0,1,1,0.01424,4,0.275514,0.296275,0
飞机(1948),飞机,notion,0,2,2,0,2,2,0.017999,4,0.280116,0.303785,1897.286008
飞涨(1948),飞涨,notion,0,1,1,0,1,1,0.016752,4,0.279138,0.302165,0
飞渡(1948),飞渡,notion,0,1,1,0,1,1,0.01424,4,0.275514,0.296275,0
飞虎(1948),飞虎,notion,0,1,1,0,1,1,0.016752,4,0.279138,0.302165,0
飞虎队(1948),飞虎队,notion,0,1,1,0,1,1,0.016752,4,0.279138,0.302165,0
飞跃发展(1948),飞跃发展,notion,0,1,1,0,1,1,0.009751,4,0.267186,0.282133,0
飞鸟(1948),飞鸟,notion,0,1,1,0,1,1,0.009751,4,0.267186,0.282133,0
食亏(1948),食亏,notion,0,1,1,0,1,1,0.009751,4,0.267186,0.282133,0
食堂(1948),食堂,notion,0,1,1,0,1,1,0.016752,4,0.279138,0.302165,0
食相(1948),食相,notion,0,1,1,0,1,1,0.016752,4,0.279138,0.302165,0
食糠妇(1948),食糠妇,notion,0,1,1,0,1,1,0.016752,4,0.279138,0.302165,0
饯席(1948),饯席,notion,0,1,1,0,1,1,0.007515,4,0.262793,0.274313,0
饿民(1948),饿民,notion,0,1,1,0,1,1,0.011322,4,0.269061,0.285394,0
饿肚皮(1948),饿肚皮,notion,0,1,1,0,1,1,0.01022,4,0.267243,0.282233,0
饿饭(1948),饿饭,notion,0,1,1,0,1,1,0.01022,4,0.267243,0.282233,0
首任(1948),首任,notion,0,1,1,0,1,1,0.01424,4,0.275514,0.296275,0
首先(1948),首先,notion,0,1,1,0,1,1,0.016752,4,0.279138,0.302165,0
首创者(1948),首创者,notion,0,1,1,0,1,1,0.009739,4,0.265806,0.279704,0
首善之区(1948),首善之区,notion,0,1,1,0,1,1,0.01022,4,0.267243,0.282233,0
首奖(1948),首奖,notion,0,1,1,0,1,1,0.016752,4,0.279138,0.302165,0
首届(1948),首届,notion,0,1,1,0,1,1,0.016752,4,0.279138,0.302165,0
首度(1948),首度,notion,0,1,1,0,1,1,0.004718,4,0.258401,0.266227,0
首相(1948),首相,notion,0,1,1,0,1,1,0.009739,4,0.265806,0.279704,0
首都(1948),首都,notion,0,1,1,0,5,5,0.016752,4,0.279138,0.302165,0
首长(1948),首长,notion,0,1,1,0,2,2,0.009755,4,0.266617,0.281135,0
香料(1948),香料,notion,0,1,1,0,1,1,0.008247,4,0.26379,0.27611,0
香饵(1948),香饵,notion,0,1,1,0,1,1,0.016752,4,0.279138,0.302165,0
马克思(1948),马克思,notion,0,3,3,0,3,3,0.031297,4,0.29998,0.333389,5001.007338
马克思主义(1948),马克思主义,notion,0,2,2,0,2,2,0.019506,4,0.282731,0.307911,1903.779982
马克斯(1948),马克斯,notion,0,1,1,0,1,1,0.011322,4,0.269061,0.285394,0
马兴惠(1948),马兴惠,notion,0,1,1,0,1,1,0.009751,4,0.267186,0.282133,0
马列主义(1948),马列主义,notion,0,2,2,0,3,3,0.026272,4,0.29319,0.323683,1793.896368
马前卒(1948),马前卒,notion,0,1,1,0,1,1,0.009755,4,0.266617,0.281135,0
马匹(1948),马匹,notion,0,1,1,0,1,1,0.009755,4,0.266617,0.281135,0
马又壮(1948),马又壮,notion,0,1,1,0,1,1,0.016518,4,0.278724,0.3015,0
马奇诺(1948),马奇诺,notion,0,1,1,0,1,1,0.009739,4,0.265806,0.279704,0
马宏(1948),马宏,notion,0,1,1,0,1,1,0.009739,4,0.265806,0.279704,0
马思聪(1948),马思聪,notion,0,1,1,0,1,1,0.016752,4,0.279138,0.302165,0
马恩列(1948),马恩列,notion,0,1,1,0,1,1,0.009755,4,0.266617,0.281135,0
马戈斯(1948),马戈斯,notion,0,1,1,0,1,1,0.009755,4,0.266617,0.281135,0
马来人(1948),马来人,notion,0,1,1,0,1,1,0.009739,4,0.265806,0.279704,0
马脚(1948),马脚,notion,0,2,2,0,2,2,0.026507,4,0.294224,0.325181,2012.895914
马萨里克(1948),马萨里克,notion,0,1,1,0,1,1,0.016752,4,0.279138,0.302165,0
马蒂亚(1948),马蒂亚,notion,0,1,1,0,1,1,0.009755,4,0.266617,0.281135,0
马路(1948),马路,notion,0,2,2,0,2,2,0.026491,4,0.291937,0.321853,1403.825067
马里克(1948),马里克,notion,0,1,1,0,1,1,0.009755,4,0.266617,0.281135,0
驰名(1948),驰名,notion,0,1,1,0,1,1,0.01424,4,0.275514,0.296275,0
驳复(1948),驳复,notion,0,1,1,0,1,1,0.016752,4,0.279138,0.302165,0
驳斥(1948),驳斥,notion,0,1,1,0,2,2,0.016752,4,0.279138,0.302165,0
驻义(1948),驻义,notion,0,1,1,0,1,1,0.009739,4,0.265806,0.279704,0
驻日(1948),驻日,notion,0,2,2,0,2,2,0.026972,4,0.293947,0.324781,1749.441854
骂人(1948),骂人,notion,0,1,1,0,1,1,0.01022,4,0.267243,0.282233,0
骄傲(1948),骄傲,notion,0,1,1,0,1,1,0.016518,4,0.278724,0.3015,0
骄横(1948),骄横,notion,0,1,1,0,1,1,0.009755,4,0.266617,0.281135,0
骑兵团(1948),骑兵团,notion,0,1,1,0,1,1,0.016518,4,0.278724,0.3015,0
骗局(1948),骗局,notion,0,2,2,0,2,2,0.017999,4,0.280116,0.303785,1897.286008
骨头(1948),骨头,notion,0,1,1,0,1,1,0.016518,4,0.278724,0.3015,0
高中(1948),高中,notion,0,1,1,0,1,1,0.016752,4,0.279138,0.302165,0
高举(1948),高举,notion,0,1,1,0,1,1,0.016518,4,0.278724,0.3015,0
高压政策(1948),高压政策,notion,0,1,1,0,1,1,0.01022,4,0.267243,0.282233,0
高尔基(1948),高尔基,notion,0,3,3,0,4,4,0.036258,4,0.311059,0.34823,6585.637217
高峯(1948),高峯,notion,0,1,1,0,1,1,0.01424,4,0.275514,0.296275,0
高棉(1948),高棉,notion,0,1,1,0,1,1,0.01424,4,0.275514,0.296275,0
高歌(1948),高歌,notion,0,1,1,0,1,1,0.016752,4,0.279138,0.302165,0
高涨(1948),高涨,notion,0,1,1,0,1,1,0.016518,4,0.278724,0.3015,0
高潮(1948),高潮,notion,0,1,1,0,1,1,0.016752,4,0.279138,0.302165,0
高级干部(1948),高级干部,notion,0,1,1,0,1,1,0.016752,4,0.279138,0.302165,0
高调(1948),高调,notion,0,2,2,0,2,2,0.008698,4,0.258507,0.266483,0.569098
高高(1948),高高,notion,0,1,1,0,1,1,0.009755,4,0.266617,0.281135,0
高鹤(1948),高鹤,notion,0,1,1,0,1,1,0.009751,4,0.267186,0.282133,0
鬥争(1948),鬥争,notion,0,3,3,0,13,13,0.04208,4,0.32089,0.360542,6900.033893
鬥争者(1948),鬥争者,notion,0,1,1,0,1,1,0.011322,4,0.269061,0.285394,0
鬥法(1948),鬥法,notion,0,1,1,0,1,1,0.01424,4,0.275514,0.296275,0
鬼把戏(1948),鬼把戏,notion,0,2,2,0,2,2,0.026272,4,0.29319,0.323683,1793.896368
鬼神(1948),鬼神,notion,0,1,1,0,1,1,0.01424,4,0.275514,0.296275,0
鬼胎(1948),鬼胎,notion,0,1,1,0,1,1,0.01424,4,0.275514,0.296275,0
魏德迈(1948),魏德迈,notion,0,1,1,0,1,1,0.009739,4,0.265806,0.279704,0
魔影(1948),魔影,notion,0,1,1,0,1,1,0.01424,4,0.275514,0.296275,0
魔手(1948),魔手,notion,0,1,1,0,1,1,0.01424,4,0.275514,0.296275,0
魔术(1948),魔术,notion,0,1,1,0,1,1,0.011322,4,0.269061,0.285394,0
魔笛(1948),魔笛,notion,0,1,1,0,1,1,0.01424,4,0.275514,0.296275,0
魔鬼(1948),魔鬼,notion,0,1,1,0,1,1,0.016518,4,0.278724,0.3015,0
鲁尔(1948),鲁尔,notion,0,1,1,0,1,1,0.009755,4,0.266617,0.281135,0
鲍尔温(1948),鲍尔温,notion,0,1,1,0,1,1,0.007515,4,0.262793,0.274313,0
鲜明(1948),鲜明,notion,0,2,2,0,2,2,0.026507,4,0.294224,0.325181,2012.895914
鸟瞰(1948),鸟瞰,notion,0,2,2,0,2,2,0.016711,4,0.276081,0.297263,848.405205
鸦片(1948),鸦片,notion,0,1,1,0,1,1,0.01022,4,0.267243,0.282233,0
鸦片烟(1948),鸦片烟,notion,0,2,2,0,2,2,0.008698,4,0.258507,0.266483,0.569098
鸵鸟(1948),鸵鸟,notion,0,1,1,0,1,1,0.008247,4,0.26379,0.27611,0
鹤泪(1948),鹤泪,notion,0,1,1,0,1,1,0.016752,4,0.279138,0.302165,0
麦克(1948),麦克,notion,0,1,1,0,1,1,0.009739,4,0.265806,0.279704,0
麦克阿瑟(1948),麦克阿瑟,notion,0,2,2,0,2,2,0.02398,4,0.290133,0.319191,1998.682918
麦克风(1948),麦克风,notion,0,1,1,0,1,1,0.004718,4,0.258401,0.266227,0
麦帅(1948),麦帅,notion,0,2,2,0,3,3,0.030992,4,0.303936,0.338757,2912.385696
麻木(1948),麻木,notion,0,1,1,0,1,1,0.007515,4,0.262793,0.274313,0
黄世仁(1948),黄世仁,notion,0,1,1,0,1,1,0.009751,4,0.267186,0.282133,0
黄仲则句(1948),黄仲则句,notion,0,1,1,0,1,1,0.009739,4,0.265806,0.279704,0
黄伯樵(1948),黄伯樵,notion,0,1,1,0,1,1,0.009739,4,0.265806,0.279704,0
黄山(1948),黄山,notion,0,1,1,0,1,1,0.01424,4,0.275514,0.296275,0
黄昏(1948),黄昏,notion,0,1,1,0,1,1,0.016752,4,0.279138,0.302165,0
黄村(1948),黄村,notion,0,1,1,0,1,1,0.009739,4,0.265806,0.279704,0
黄梅(1948),黄梅,notion,0,1,1,0,1,1,0.01022,4,0.267243,0.282233,0
黄河(1948),黄河,notion,0,2,2,0,3,3,0.021907,4,0.286133,0.313168,1304.9596
黄浦(1948),黄浦,notion,0,2,2,0,2,2,0.030758,4,0.303347,0.337959,2812.221703
黄色(1948),黄色,notion,0,3,3,0,3,3,0.031976,4,0.30347,0.33818,5981.045848
黄金(1948),黄金,notion,0,1,1,0,1,1,0.007515,4,0.262793,0.274313,0
黄金海岸(1948),黄金海岸,notion,0,1,1,0,1,1,0.009739,4,0.265806,0.279704,0
黄霉(1948),黄霉,notion,0,1,1,0,1,1,0.016752,4,0.279138,0.302165,0
黄麻(1948),黄麻,notion,0,1,1,0,1,1,0.004718,4,0.258401,0.266227,0
黎明(1948),黎明,notion,0,1,1,0,1,1,0.016518,4,0.278724,0.3015,0
黎明前(1948),黎明前,notion,0,1,1,0,1,1,0.016518,4,0.278724,0.3015,0
黑人(1948),黑人,notion,0,1,1,0,1,1,0.01022,4,0.267243,0.282233,0
黑单(1948),黑单,notion,0,1,1,0,1,1,0.009755,4,0.266617,0.281135,0
黑夜(1948),黑夜,notion,0,1,1,0,1,1,0.016518,4,0.278724,0.3015,0
黑手(1948),黑手,notion,0,1,1,0,1,1,0.009755,4,0.266617,0.281135,0
黑旗军(1948),黑旗军,notion,0,1,1,0,1,1,0.01424,4,0.275514,0.296275,0
黑暗(1948),黑暗,notion,0,1,1,0,3,3,0.016518,4,0.278724,0.3015,0
黑暗面(1948),黑暗面,notion,0,1,1,0,1,1,0.01424,4,0.275514,0.296275,0
黑浪(1948),黑浪,notion,0,1,1,0,1,1,0.016518,4,0.278724,0.3015,0
黑票(1948),黑票,notion,0,1,1,0,1,1,0.01424,4,0.275514,0.296275,0
黑衫(1948),黑衫,notion,0,1,1,0,1,1,0.009755,4,0.266617,0.281135,0
黔驴技穷(1948),黔驴技穷,notion,0,1,1,0,1,1,0.016518,4,0.278724,0.3015,0
黛绿年华(1948),黛绿年华,notion,0,1,1,0,1,1,0.009739,4,0.265806,0.279704,0
鼓动(1948),鼓动,notion,0,1,1,0,1,1,0.016752,4,0.279138,0.302165,0
鼓声(1948),鼓声,notion,0,1,1,0,1,1,0.016752,4,0.279138,0.302165,0
鼓而思(1948),鼓而思,notion,0,1,1,0,1,1,0.016752,4,0.279138,0.302165,0
鼓舞(1948),鼓舞,notion,0,1,1,0,1,1,0.009751,4,0.267186,0.282133,0
齐人(1948),齐人,notion,0,2,2,0,2,2,0.008698,4,0.258507,0.266483,0.569098
齐名(1948),齐名,notion,0,1,1,0,1,1,0.009755,4,0.266617,0.281135,0
齐头并进(1948),齐头并进,notion,0,1,1,0,1,1,0.01424,4,0.275514,0.296275,0
齐振杞(1948),齐振杞,notion,0,2,2,0,4,4,0.008698,4,0.258507,0.266483,0.569098
齐来(1948),齐来,notion,0,1,1,0,1,1,0.009751,4,0.267186,0.282133,0
龙套(1948),龙套,notion,0,1,1,0,1,1,0.011322,4,0.269061,0.285394,0
龙潭虎穴(1948),龙潭虎穴,notion,0,1,1,0,1,1,0.005017,4,0.257497,0.26453,0
龙舟(1948),龙舟,notion,0,1,1,0,2,2,0.009751,4,0.267186,0.282133,0
龚德柏(1948),龚德柏,notion,0,1,1,0,1,1,0.016752,4,0.279138,0.302165,0
