Id,Label,type,indegree,outdegree,Degree,weighted indegree,weighted outdegree,Weighted Degree,eigencentrality,Eccentricity,closnesscentrality,harmonicclosnesscentrality,betweenesscentrality
《中央周刊》,《中央周刊》,journal,1278,0,1278,2407,0,2407,0.910876,3,0.391755,0.481997,4528973.687063
《时代杂志》,《时代杂志》,journal,948,0,948,2419,0,2419,0.672407,3,0.374894,0.443729,3117915.210426
《国讯》,《国讯》,journal,195,0,195,250,0,250,0.159324,3,0.341369,0.35641,404504.765435
《民主(上海)》,《民主(上海)》,journal,923,0,923,1609,0,1609,0.70854,3,0.373676,0.44083,2752234.402468
《周报(上海1945)》,《周报(上海1945)》,journal,973,0,973,1461,0,1461,0.70722,3,0.37612,0.446628,3148071.245119
《民主周刊(昆明)》,《民主周刊(昆明)》,journal,345,0,345,488,0,488,0.292833,3,0.347561,0.373804,735404.935321
《文萃》,《文萃》,journal,1325,0,1325,2331,0,2331,1,3,0.39428,0.487447,4462973.741254
《民主(重庆)》,《民主(重庆)》,journal,242,0,242,342,0,342,0.181249,3,0.343285,0.36186,594310.498308
《再生》,《再生》,journal,663,0,663,1207,0,1207,0.505774,3,0.361459,0.41068,1875743.30087
《中华论坛》,《中华论坛》,journal,294,0,294,404,0,404,0.239289,3,0.345431,0.36789,700906.732575
国际(1946),国际,notion,0,12,12,0,96,96,0.11722,4,0.456596,0.476982,74110.648221
评论(1946),评论,notion,0,2,2,0,35,35,0.018564,4,0.2792,0.302313,744.038498
巴黎和会(1946),巴黎和会,notion,0,6,6,0,28,28,0.065467,4,0.352505,0.395706,16219.441621
内幕(1946),内幕,notion,0,7,7,0,31,31,0.085992,4,0.395582,0.434394,30647.127376
美国(1946),美国,notion,0,15,15,0,217,217,0.131716,4,0.480806,0.490984,98215.108953
东北(1946),东北,notion,0,12,12,0,76,76,0.116492,4,0.45115,0.473677,68438.264123
国内(1946),国内,notion,0,11,11,0,32,32,0.104098,4,0.423936,0.455818,55446.742273
国外(1946),国外,notion,0,2,2,0,15,15,0.014214,4,0.272194,0.29079,872.497436
时事(1946),时事,notion,0,10,10,0,163,163,0.101024,4,0.425694,0.456964,57027.351693
风云(1946),风云,notion,0,2,2,0,15,15,0.016203,4,0.276115,0.297313,650.123339
概况(1946),概况,notion,0,3,3,0,15,15,0.036034,4,0.312361,0.349916,5975.926118
民族(1946),民族,notion,0,7,7,0,31,31,0.085513,4,0.392718,0.43209,26459.964204
苏联(1946),苏联,notion,0,8,8,0,136,136,0.091021,4,0.414761,0.449078,45841.091059
世界(1946),世界,notion,0,10,10,0,83,83,0.096516,4,0.406548,0.443135,43105.968065
每周(1946),每周,notion,0,1,1,0,11,11,0.013378,4,0.272039,0.290456,0
舆论(1946),舆论,notion,0,3,3,0,21,21,0.041908,4,0.31393,0.351916,3405.961451
遭难(1946),遭难,notion,0,3,3,0,13,13,0.03417,4,0.301011,0.334826,2938.323304
前后(1946),前后,notion,0,7,7,0,23,23,0.057908,4,0.33103,0.372775,12881.22692
民主(1946),民主,notion,0,15,15,0,194,194,0.131716,4,0.480806,0.490984,98215.108953
研究(1946),研究,notion,0,6,6,0,61,61,0.063242,4,0.355293,0.39849,17896.488729
高尔基(1946),高尔基,notion,0,3,3,0,124,124,0.04563,4,0.325889,0.366528,5468.00943
中国(1946),中国,notion,0,17,17,0,244,244,0.138517,2,0.50074,0.501479,128415.328832
《观察》,《观察》,journal,334,0,334,553,0,553,0.221936,3,0.347099,0.372529,966295.099388
人民(1946),人民,notion,0,17,17,0,127,127,0.138517,2,0.50074,0.501479,128415.328832
《正报》,《正报》,journal,642,0,642,900,0,900,0.395783,3,0.360507,0.408245,2136869.13284
内政(1946),内政,notion,0,4,4,0,13,13,0.04211,4,0.310606,0.347727,4828.053991
子弟兵(1946),子弟兵,notion,0,1,1,0,9,9,0.00826,4,0.264992,0.278237,0
建築(1946),建築,notion,0,1,1,0,9,9,0.017626,4,0.281496,0.305894,0
抗战史(1946),抗战史,notion,0,1,1,0,9,9,0.00826,4,0.264992,0.278237,0
新世界(1946),新世界,notion,0,4,4,0,13,13,0.039798,4,0.313827,0.351858,6225.704025
珠江三角洲(1946),珠江三角洲,notion,0,1,1,0,9,9,0.00826,4,0.264992,0.278237,0
纪行(1946),纪行,notion,0,3,3,0,15,15,0.021508,4,0.28507,0.311605,3197.533186
共和国(1946),共和国,notion,0,2,2,0,11,11,0.030729,4,0.302946,0.337407,2092.27198
周评(1946),周评,notion,0,1,1,0,80,80,0.018893,4,0.282798,0.307938,0
待续(1946),待续,notion,0,3,3,0,10,10,0.040367,4,0.316105,0.354656,4607.99901
苏维埃(1946),苏维埃,notion,0,1,1,0,15,15,0.013103,4,0.272684,0.291543,0
问题(1946),问题,notion,0,17,17,0,221,221,0.138517,2,0.50074,0.501479,128415.328832
刑场(1946),刑场,notion,0,1,1,0,7,7,0.013103,4,0.272684,0.291543,0
将来(1946),将来,notion,0,3,3,0,9,9,0.027848,4,0.294172,0.325172,3712.120941
工作(1946),工作,notion,0,8,8,0,77,77,0.085863,4,0.403524,0.440685,42474.770444
《中建》,《中建》,journal,414,0,414,908,0,908,0.247252,3,0.350485,0.381806,1333556.566877
康熙帝(1946),康熙帝,notion,0,1,1,0,7,7,0.017626,4,0.281496,0.305894,0
流动(1946),流动,notion,0,1,1,0,7,7,0.013103,4,0.272684,0.291543,0
精神(1946),精神,notion,0,10,10,0,23,23,0.098734,4,0.420956,0.453659,54027.981279
上海(1946),上海,notion,0,11,11,0,39,39,0.111133,4,0.444522,0.469473,64018.755705
五五宪草(1946),五五宪草,notion,0,6,6,0,16,16,0.057351,4,0.338316,0.380834,12308.337658
会议(1946),会议,notion,0,11,11,0,48,48,0.111156,4,0.444522,0.469473,65998.596184
俄罗斯(1946),俄罗斯,notion,0,1,1,0,9,9,0.013103,4,0.272684,0.291543,0
先生(1946),先生,notion,0,16,16,0,148,148,0.133212,4,0.48315,0.492318,105912.929324
历史(1946),历史,notion,0,12,12,0,31,31,0.099351,4,0.405059,0.442149,53261.449791
名着(1946),名着,notion,0,2,2,0,7,7,0.025886,4,0.296968,0.329101,2935.752997
宪法(1946),宪法,notion,0,11,11,0,35,35,0.10513,4,0.420771,0.453601,47432.787716
小传(1946),小传,notion,0,1,1,0,6,6,0.018893,4,0.282798,0.307938,0
杂感(1946),杂感,notion,0,8,8,0,30,30,0.081537,4,0.374747,0.416899,25666.058288
柯诺华洛夫(1946),柯诺华洛夫,notion,0,1,1,0,6,6,0.013103,4,0.272684,0.291543,0
检查(1946),检查,notion,0,2,2,0,20,20,0.018938,4,0.282437,0.307445,1861.68946
社会主义(1946),社会主义,notion,0,2,2,0,21,21,0.02274,4,0.286006,0.312967,1109.932808
社论(1946),社论,notion,0,1,1,0,30,30,0.017626,4,0.281496,0.305894,0
联邦(1946),联邦,notion,0,2,2,0,8,8,0.017667,4,0.277985,0.300357,781.701364
萧红(1946),萧红,notion,0,1,1,0,6,6,0.018893,4,0.282798,0.307938,0
西班牙(1946),西班牙,notion,0,5,5,0,16,16,0.064721,4,0.355821,0.398939,13114.902258
过去(1946),过去,notion,0,5,5,0,14,14,0.063584,4,0.352851,0.395982,14971.026709
连载(1946),连载,notion,0,2,2,0,7,7,0.025886,4,0.296968,0.329101,2935.752997
週览(1946),週览,notion,0,1,1,0,6,6,0.017626,4,0.281496,0.305894,0
中华民国(1946),中华民国,notion,0,6,6,0,16,16,0.071172,4,0.362644,0.405621,16766.7005
亡友(1946),亡友,notion,0,1,1,0,6,6,0.013378,4,0.272039,0.290456,0
前途(1946),前途,notion,0,13,13,0,26,26,0.122198,4,0.469805,0.484751,90794.782949
十讲(1946),十讲,notion,0,2,2,0,6,6,0.023015,4,0.2849,0.311272,897.577022
印象(1946),印象,notion,0,4,4,0,8,8,0.040576,4,0.316627,0.355381,10309.990298
和平(1946),和平,notion,0,16,16,0,92,92,0.13702,4,0.498223,0.500145,119299.077234
小事(1946),小事,notion,0,3,3,0,7,7,0.022985,4,0.288445,0.316736,4423.955406
嵊泗(1946),嵊泗,notion,0,1,1,0,5,5,0.005304,4,0.259537,0.268322,0
当前(1946),当前,notion,0,13,13,0,43,43,0.11142,4,0.433723,0.462617,72335.675618
戏剧(1946),戏剧,notion,0,2,2,0,11,11,0.008185,4,0.262715,0.274222,672.198195
时评(1946),时评,notion,0,2,2,0,19,19,0.012497,4,0.270554,0.288007,774.807195
未来(1946),未来,notion,0,3,3,0,8,8,0.027592,4,0.291576,0.321389,2927.844705
献给(1946),献给,notion,0,4,4,0,8,8,0.030432,4,0.298541,0.331463,6309.301061
罗斯福(1946),罗斯福,notion,0,4,4,0,10,10,0.05926,4,0.34976,0.392778,10218.766352
讲话(1946),讲话,notion,0,4,4,0,8,8,0.033276,4,0.300225,0.333812,5648.258203
鲁迅(1946),鲁迅,notion,0,4,4,0,23,23,0.052532,4,0.331335,0.372905,7406.479149
一问一答(1946),一问一答,notion,0,1,1,0,4,4,0.013103,4,0.272684,0.291543,0
上吉山典(1946),上吉山典,notion,0,1,1,0,8,8,0.017626,4,0.281496,0.305894,0
与汇(1946),与汇,notion,0,1,1,0,4,4,0.004577,4,0.257676,0.264843,0
之战(1946),之战,notion,0,5,5,0,8,8,0.071516,4,0.378947,0.420377,21363.139634
乐记(1946),乐记,notion,0,1,1,0,8,8,0.017626,4,0.281496,0.305894,0
人事(1946),人事,notion,0,3,3,0,7,7,0.032568,4,0.30426,0.339262,5067.955291
人民团体(1946),人民团体,notion,0,1,1,0,4,4,0.00826,4,0.264992,0.278237,0
以后(1946),以后,notion,0,13,13,0,34,34,0.111479,4,0.435761,0.463965,70195.661471
伊朗(1946),伊朗,notion,0,5,5,0,24,24,0.048928,4,0.325004,0.365629,8860.69923
侵略者(1946),侵略者,notion,0,2,2,0,6,6,0.026481,4,0.292853,0.323187,1408.34579
农业(1946),农业,notion,0,5,5,0,14,14,0.051785,4,0.333953,0.375935,11574.957706
凯旋(1946),凯旋,notion,0,1,1,0,4,4,0.007159,4,0.261235,0.271453,0
《民主:桂林版》,《民主:桂林版》,journal,486,0,486,664,0,664,0.373976,3,0.353589,0.390155,1302989.96963
初访(1946),初访,notion,0,2,2,0,5,5,0.027011,4,0.292079,0.322056,1114.922273
势力(1946),势力,notion,0,3,3,0,6,6,0.036118,4,0.305392,0.340784,3415.855619
南京(1946),南京,notion,0,11,11,0,30,30,0.116207,4,0.455872,0.476474,67481.206565
卫国战争(1946),卫国战争,notion,0,1,1,0,6,6,0.013103,4,0.272684,0.291543,0
古事(1946),古事,notion,0,1,1,0,5,5,0.013378,4,0.272039,0.290456,0
台湾(1946),台湾,notion,0,4,4,0,12,12,0.032144,4,0.299724,0.333116,4945.810042
周末(1946),周末,notion,0,2,2,0,7,7,0.020792,4,0.283021,0.308358,1062.761034
国民大会(1946),国民大会,notion,0,9,9,0,25,25,0.099577,4,0.413627,0.448324,37866.63797
外长(1946),外长,notion,0,5,5,0,16,16,0.057352,4,0.341775,0.384502,12239.252027
大战(1946),大战,notion,0,1,1,0,4,4,0.017626,4,0.281496,0.305894,0
心理(1946),心理,notion,0,4,4,0,9,9,0.041142,4,0.320618,0.360295,10602.006673
战后(1946),战后,notion,0,8,8,0,23,23,0.084761,4,0.387686,0.428031,30351.999321
文学(1946),文学,notion,0,3,3,0,23,23,0.035307,4,0.309669,0.346437,4718.549721
新谈(1946),新谈,notion,0,1,1,0,5,5,0.013378,4,0.272039,0.290456,0
日本(1946),日本,notion,0,10,10,0,51,51,0.105671,4,0.42919,0.459355,49809.63642
昆明(1946),昆明,notion,0,9,9,0,29,29,0.076019,4,0.364854,0.407926,31551.555274
朋友(1946),朋友,notion,0,5,5,0,10,10,0.056983,4,0.342467,0.385241,12439.822969
朝鲜(1946),朝鲜,notion,0,3,3,0,9,9,0.044107,4,0.323833,0.364092,5334.345912
法国(1946),法国,notion,0,6,6,0,15,15,0.066034,4,0.353894,0.397098,17109.215323
演说(1946),演说,notion,0,8,8,0,18,18,0.086186,4,0.388577,0.42877,28712.441513
物资(1946),物资,notion,0,5,5,0,8,8,0.066693,4,0.356793,0.399896,13115.320353
特稿(1946),特稿,notion,0,1,1,0,34,34,0.018893,4,0.282798,0.307938,0
现在(1946),现在,notion,0,3,3,0,8,8,0.041633,4,0.316488,0.355134,4230.538536
生活(1946),生活,notion,0,10,10,0,87,87,0.107395,4,0.445141,0.469792,66121.391879
的信(1946),的信,notion,0,1,1,0,5,5,0.017626,4,0.281496,0.305894,0
知道(1946),知道,notion,0,4,4,0,7,7,0.042027,4,0.317011,0.355859,6864.540129
秘密(1946),秘密,notion,0,3,3,0,11,11,0.036374,4,0.308373,0.344741,4309.87484
经济(1946),经济,notion,0,15,15,0,77,77,0.128975,4,0.477849,0.489375,98847.556912
职工(1946),职工,notion,0,2,2,0,9,9,0.026481,4,0.292853,0.323187,1408.34579
艺术(1946),艺术,notion,0,4,4,0,23,23,0.039574,4,0.318487,0.357685,11107.185024
莎士比亚(1946),莎士比亚,notion,0,1,1,0,5,5,0.004577,4,0.257676,0.264843,0
贡献(1946),贡献,notion,0,2,2,0,5,5,0.018564,4,0.2792,0.302313,744.038498
迫害(1946),迫害,notion,0,1,1,0,4,4,0.013378,4,0.272039,0.290456,0
逸话(1946),逸话,notion,0,1,1,0,4,4,0.017626,4,0.281496,0.305894,0
邱吉尔(1946),邱吉尔,notion,0,5,5,0,9,9,0.032408,4,0.297398,0.329927,6516.44662
集体(1946),集体,notion,0,2,2,0,6,6,0.016711,4,0.277341,0.299313,944.999925
青年(1946),青年,notion,0,10,10,0,24,24,0.096227,4,0.405745,0.442526,43105.734788
音乐(1946),音乐,notion,0,4,4,0,21,21,0.049356,4,0.337165,0.379428,12647.478688
一次(1946),一次,notion,0,6,6,0,18,18,0.064272,4,0.36019,0.403273,22218.219694
一週(1946),一週,notion,0,1,1,0,3,3,0.003608,4,0.255568,0.260842,0
一首(1946),一首,notion,0,1,1,0,3,3,0.009637,4,0.265506,0.27915,0
两位(1946),两位,notion,0,1,1,0,4,4,0.013634,4,0.273332,0.292631,0
个人(1946),个人,notion,0,2,2,0,10,10,0.009868,4,0.265801,0.279744,898.961745
中山(1946),中山,notion,0,5,5,0,7,7,0.048082,4,0.329286,0.37063,12209.276225
之行(1946),之行,notion,0,2,2,0,4,4,0.030729,4,0.302946,0.337407,2092.27198
之间(1946),之间,notion,0,6,6,0,9,9,0.071441,4,0.37465,0.416667,23041.068669
书报(1946),书报,notion,0,1,1,0,7,7,0.017626,4,0.281496,0.305894,0
事件(1946),事件,notion,0,8,8,0,20,20,0.085234,4,0.392236,0.431771,33576.473366
人性(1946),人性,notion,0,3,3,0,5,5,0.046157,4,0.327001,0.367832,5132.843559
《民主周刊(北平)》,《民主周刊(北平)》,journal,270,0,270,347,0,347,0.222316,3,0.344437,0.365107,523683.256161
人民共和国(1946),人民共和国,notion,0,1,1,0,8,8,0.013103,4,0.272684,0.291543,0
人物(1946),人物,notion,0,5,5,0,11,11,0.048334,4,0.332293,0.374065,15083.952135
人生(1946),人生,notion,0,2,2,0,14,14,0.022931,4,0.290456,0.319664,2102.663893
今日(1946),今日,notion,0,10,10,0,24,24,0.105442,4,0.432744,0.461747,54707.314532
介绍(1946),介绍,notion,0,8,8,0,16,16,0.076631,4,0.372224,0.414637,25880.688622
《解放》,《解放》,journal,92,0,92,108,0,108,0.069442,3,0.337244,0.344466,176522.317737
伦敦(1946),伦敦,notion,0,3,3,0,6,6,0.026977,4,0.290721,0.320128,2226.154388
作用(1946),作用,notion,0,3,3,0,5,5,0.023246,4,0.285949,0.312953,3071.785795
俄国(1946),俄国,notion,0,2,2,0,5,5,0.02274,4,0.286006,0.312967,1109.932808
克劳(1946),克劳,notion,0,1,1,0,3,3,0.013103,4,0.272684,0.291543,0
全国(1946),全国,notion,0,4,4,0,8,8,0.038879,4,0.311852,0.349336,7858.474981
共党(1946),共党,notion,0,1,1,0,3,3,0.017626,4,0.281496,0.305894,0
内战(1946),内战,notion,0,13,13,0,89,89,0.110482,4,0.425253,0.456877,67672.59473
冒险(1946),冒险,notion,0,1,1,0,3,3,0.009637,4,0.265506,0.27915,0
《光明报》,《光明报》,journal,291,0,291,387,0,387,0.233403,3,0.345306,0.367542,668869.138529
加盟(1946),加盟,notion,0,1,1,0,6,6,0.013103,4,0.272684,0.291543,0
劳动英雄(1946),劳动英雄,notion,0,1,1,0,3,3,0.013378,4,0.272039,0.290456,0
十六(1946),十六,notion,0,1,1,0,4,4,0.013103,4,0.272684,0.291543,0
协会(1946),协会,notion,0,4,4,0,8,8,0.049937,4,0.32756,0.368557,6838.12785
印度(1946),印度,notion,0,7,7,0,17,17,0.084616,4,0.392933,0.432264,27253.260333
反动(1946),反动,notion,0,4,4,0,8,8,0.039476,4,0.31607,0.354685,8574.849269
发展(1946),发展,notion,0,8,8,0,26,26,0.077469,4,0.374845,0.416986,28390.942744
哲学(1946),哲学,notion,0,3,3,0,6,6,0.035568,4,0.307318,0.34335,3533.059203
四大家族(1946),四大家族,notion,0,1,1,0,4,4,0.00826,4,0.264992,0.278237,0
国庆(1946),国庆,notion,0,1,1,0,15,15,0.005304,4,0.259537,0.268322,0
国民经济(1946),国民经济,notion,0,1,1,0,4,4,0.013103,4,0.272684,0.291543,0
国父(1946),国父,notion,0,3,3,0,7,7,0.036721,4,0.309735,0.346524,3702.674167
国防(1946),国防,notion,0,5,5,0,8,8,0.052865,4,0.33477,0.376848,10328.266912
地位(1946),地位,notion,0,5,5,0,11,11,0.058467,4,0.350613,0.393721,18308.550791
塞维支(1946),塞维支,notion,0,1,1,0,3,3,0.013103,4,0.272684,0.291543,0
复兴(1946),复兴,notion,0,4,4,0,10,10,0.043467,4,0.319265,0.358642,6494.894596
大会(1946),大会,notion,0,7,7,0,16,16,0.074958,4,0.370258,0.412782,22694.47694
大学(1946),大学,notion,0,9,9,0,21,21,0.098428,4,0.416624,0.450499,41993.881773
失踪(1946),失踪,notion,0,1,1,0,3,3,0.013378,4,0.272039,0.290456,0
孔子(1946),孔子,notion,0,2,2,0,4,4,0.022204,4,0.287896,0.315838,1406.192172
学习(1946),学习,notion,0,7,7,0,29,29,0.080172,4,0.392236,0.431698,35633.850369
学说(1946),学说,notion,0,1,1,0,3,3,0.013103,4,0.272684,0.291543,0
实施(1946),实施,notion,0,5,5,0,18,18,0.06236,4,0.353676,0.396808,15993.47202
宪政(1946),宪政,notion,0,5,5,0,8,8,0.043456,4,0.313109,0.351018,6937.936817
寒山(1946),寒山,notion,0,1,1,0,3,3,0.009637,4,0.265506,0.27915,0
山水(1946),山水,notion,0,3,3,0,7,7,0.026471,4,0.295654,0.327303,5742.405477
工潮(1946),工潮,notion,0,4,4,0,8,8,0.039474,4,0.311616,0.349032,6138.300596
庐山(1946),庐山,notion,0,6,6,0,8,8,0.056857,4,0.337165,0.379573,14785.670866
应该(1946),应该,notion,0,5,5,0,11,11,0.048615,4,0.325778,0.366542,11442.458053
建设(1946),建设,notion,0,8,8,0,30,30,0.078023,4,0.387948,0.428248,41481.903353
开国元勋(1946),开国元勋,notion,0,1,1,0,3,3,0.013634,4,0.273332,0.292631,0
异端(1946),异端,notion,0,1,1,0,3,3,0.004577,4,0.257676,0.264843,0
弗朗哥(1946),弗朗哥,notion,0,3,3,0,7,7,0.049622,4,0.336297,0.378399,6466.151599
徐州(1946),徐州,notion,0,2,2,0,11,11,0.031004,4,0.302277,0.336493,1833.728143
思想(1946),思想,notion,0,11,11,0,21,21,0.111132,4,0.436489,0.464298,55438.563228
惨案(1946),惨案,notion,0,7,7,0,15,15,0.059413,4,0.336888,0.379341,17737.299206
成功(1946),成功,notion,0,6,6,0,10,10,0.068507,4,0.362005,0.405012,19400.389059
成钢(1946),成钢,notion,0,1,1,0,3,3,0.001496,4,0.252204,0.25432,0
战争(1946),战争,notion,0,11,11,0,26,26,0.111542,4,0.435629,0.463733,53142.455714
战斗(1946),战斗,notion,0,2,2,0,6,6,0.027153,4,0.296784,0.32884,1981.441549
抗议(1946),抗议,notion,0,4,4,0,10,10,0.051365,4,0.327075,0.367992,5913.184584
报告书(1946),报告书,notion,0,2,2,0,5,5,0.017857,4,0.277314,0.299269,662.879703
报载(1946),报载,notion,0,1,1,0,3,3,0.007159,4,0.261235,0.271453,0
拾得(1946),拾得,notion,0,1,1,0,3,3,0.009637,4,0.265506,0.27915,0
指导(1946),指导,notion,0,2,2,0,5,5,0.036519,4,0.313896,0.3518,2490.161613
改造(1946),改造,notion,0,6,6,0,10,10,0.0488,4,0.325335,0.366093,13188.03623
政府(1946),政府,notion,0,11,11,0,38,38,0.106456,4,0.425002,0.456558,54617.674455
政治(1946),政治,notion,0,13,13,0,76,76,0.118977,4,0.447916,0.471749,69110.421747
政治协商会议(1946),政治协商会议,notion,0,9,9,0,31,31,0.085051,4,0.377157,0.419102,28858.144943
政策(1946),政策,notion,0,11,11,0,42,42,0.115336,4,0.455222,0.476083,68934.42371
散记(1946),散记,notion,0,5,5,0,8,8,0.059937,4,0.352375,0.395504,16120.416436
文化(1946),文化,notion,0,11,11,0,39,39,0.115179,4,0.463218,0.480823,79470.095901
文化史(1946),文化史,notion,0,1,1,0,3,3,0.004577,4,0.257676,0.264843,0
旅行(1946),旅行,notion,0,1,1,0,5,5,0.005304,4,0.259537,0.268322,0
时局(1946),时局,notion,0,14,14,0,51,51,0.123456,4,0.455366,0.476387,76685.530264
春秋(1946),春秋,notion,0,1,1,0,7,7,0.017626,4,0.281496,0.305894,0
晋察冀边区(1946),晋察冀边区,notion,0,1,1,0,3,3,0.001496,4,0.252204,0.25432,0
机器(1946),机器,notion,0,1,1,0,3,3,0.009637,4,0.265506,0.27915,0
机构(1946),机构,notion,0,6,6,0,14,14,0.055295,4,0.337402,0.379834,13962.675319
杂记(1946),杂记,notion,0,5,5,0,12,12,0.072893,4,0.375188,0.417073,17233.09946
李闻(1946),李闻,notion,0,6,6,0,10,10,0.061831,4,0.345805,0.388836,14885.868808
法西斯(1946),法西斯,notion,0,7,7,0,16,16,0.068136,4,0.3501,0.393344,16519.335939
波澜(1946),波澜,notion,0,1,1,0,3,3,0.017626,4,0.281496,0.305894,0
流亡(1946),流亡,notion,0,2,2,0,5,5,0.032271,4,0.301168,0.334971,1271.496707
浦熙修(1946),浦熙修,notion,0,1,1,0,3,3,0.013634,4,0.273332,0.292631,0
满洲(1946),满洲,notion,0,2,2,0,6,6,0.021894,4,0.287839,0.315751,2020.708436
烟台(1946),烟台,notion,0,2,2,0,4,4,0.027153,4,0.296784,0.32884,1981.441549
爸爸(1946),爸爸,notion,0,3,3,0,6,6,0.039685,4,0.312463,0.350046,3732.208643
片断(1946),片断,notion,0,3,3,0,41,41,0.025566,4,0.291369,0.321085,4028.809984
甚么(1946),甚么,notion,0,7,7,0,9,9,0.073185,4,0.35938,0.402563,18275.463888
真相(1946),真相,notion,0,6,6,0,12,12,0.058548,4,0.343203,0.386096,17534.942992
社会(1946),社会,notion,0,6,6,0,19,19,0.073138,4,0.381006,0.422233,27663.125916
社会主义国家(1946),社会主义国家,notion,0,1,1,0,3,3,0.013103,4,0.272684,0.291543,0
稿篇(1946),稿篇,notion,0,1,1,0,3,3,0.004564,4,0.256755,0.263104,0
章太炎(1946),章太炎,notion,0,1,1,0,3,3,0.013634,4,0.273332,0.292631,0
笔下(1946),笔下,notion,0,1,1,0,3,3,0.013378,4,0.272039,0.290456,0
第二次世界大战(1946),第二次世界大战,notion,0,1,1,0,6,6,0.013103,4,0.272684,0.291543,0
纪念(1946),纪念,notion,0,11,11,0,46,46,0.110793,4,0.438153,0.465385,57423.739747
纵横谈(1946),纵横谈,notion,0,2,2,0,6,6,0.012497,4,0.270554,0.288007,774.807195
纽约(1946),纽约,notion,0,5,5,0,11,11,0.061633,4,0.35057,0.393677,13952.399153
美学观(1946),美学观,notion,0,1,1,0,3,3,0.013103,4,0.272684,0.291543,0
美苏(1946),美苏,notion,0,4,4,0,10,10,0.05072,4,0.33237,0.37408,7667.008121
老怕性(1946),老怕性,notion,0,1,1,0,3,3,0.018893,4,0.282798,0.307938,0
联合国(1946),联合国,notion,0,6,6,0,23,23,0.061422,4,0.347183,0.390271,16307.910463
联总(1946),联总,notion,0,3,3,0,7,7,0.039429,4,0.309669,0.346437,3086.693105
苏维埃共和国(1946),苏维埃共和国,notion,0,1,1,0,3,3,0.013103,4,0.272684,0.291543,0
英国(1946),英国,notion,0,11,11,0,34,34,0.112511,4,0.439425,0.466212,56421.509341
英雄(1946),英雄,notion,0,6,6,0,11,11,0.060224,4,0.343901,0.386835,15904.520323
蒙古(1946),蒙古,notion,0,3,3,0,11,11,0.049622,4,0.336297,0.378399,6466.151599
解放区(1946),解放区,notion,0,5,5,0,14,14,0.050513,4,0.335786,0.377979,12494.830369
读报(1946),读报,notion,0,4,4,0,7,7,0.051266,4,0.333256,0.37508,8533.450998
谈判(1946),谈判,notion,0,6,6,0,10,10,0.074652,4,0.37612,0.417971,20094.076515
资本主义国家(1946),资本主义国家,notion,0,1,1,0,9,9,0.013103,4,0.272684,0.291543,0
边区(1946),边区,notion,0,2,2,0,4,4,0.032271,4,0.301168,0.334971,1271.496707
还乡(1946),还乡,notion,0,5,5,0,7,7,0.059851,4,0.346096,0.389068,10902.677009
这个(1946),这个,notion,0,4,4,0,6,6,0.053063,4,0.330573,0.372036,6879.26762
透视(1946),透视,notion,0,5,5,0,7,7,0.0524,4,0.330118,0.371586,10226.346842
铁路(1946),铁路,notion,0,2,2,0,4,4,0.021363,4,0.287407,0.315098,2175.293762
长春(1946),长春,notion,0,4,4,0,6,6,0.053745,4,0.337046,0.379298,8747.649964
随笔(1946),随笔,notion,0,1,1,0,6,6,0.018893,4,0.282798,0.307938,0
领袖(1946),领袖,notion,0,4,4,0,10,10,0.043718,4,0.317817,0.356859,6101.341401
黑格尔(1946),黑格尔,notion,0,1,1,0,3,3,0.013103,4,0.272684,0.291543,0
一九五(1946),一九五,notion,0,1,1,0,2,2,0.013103,4,0.272684,0.291543,0
一二(1946),一二,notion,0,2,2,0,5,5,0.027153,4,0.296784,0.32884,1981.441549
一件(1946),一件,notion,0,3,3,0,15,15,0.037575,4,0.310942,0.34809,5120.881642
一切(1946),一切,notion,0,7,7,0,9,9,0.073139,4,0.369497,0.412086,29324.3597
一段(1946),一段,notion,0,2,2,0,3,3,0.025886,4,0.296968,0.329101,2935.752997
一瞥(1946),一瞥,notion,0,2,2,0,4,4,0.026737,4,0.295411,0.326883,1969.400217
一页(1946),一页,notion,0,3,3,0,9,9,0.036565,4,0.313417,0.351264,6163.85322
三人(1946),三人,notion,0,2,2,0,4,4,0.032271,4,0.301168,0.334971,1271.496707
上海滩(1946),上海滩,notion,0,2,2,0,3,3,0.023088,4,0.287867,0.315794,912.175655
下手(1946),下手,notion,0,1,1,0,2,2,0.009637,4,0.265506,0.27915,0
不得(1946),不得,notion,0,2,2,0,4,4,0.018113,4,0.278577,0.301313,749.731439
不得了(1946),不得了,notion,0,2,2,0,3,3,0.032271,4,0.301168,0.334971,1271.496707
东欧各国(1946),东欧各国,notion,0,1,1,0,2,2,0.007159,4,0.261235,0.271453,0
两大(1946),两大,notion,0,2,2,0,5,5,0.027264,4,0.294896,0.326144,1405.794223
严正(1946),严正,notion,0,1,1,0,2,2,0.004564,4,0.256755,0.263104,0
中国共产党(1946),中国共产党,notion,0,1,1,0,3,3,0.00826,4,0.264992,0.278237,0
中国民主社会党(1946),中国民主社会党,notion,0,1,1,0,4,4,0.009637,4,0.265506,0.27915,0
中建(1946),中建,notion,0,1,1,0,14,14,0.005304,4,0.259537,0.268322,0
中立(1946),中立,notion,0,3,3,0,5,5,0.017809,4,0.275375,0.296167,1632.65233
中苏关系(1946),中苏关系,notion,0,4,4,0,6,6,0.059007,4,0.344602,0.38743,9262.774199
中西(1946),中西,notion,0,1,1,0,2,2,0.017626,4,0.281496,0.305894,0
主义(1946),主义,notion,0,6,6,0,15,15,0.074953,4,0.374796,0.416797,22760.898753
主席(1946),主席,notion,0,4,4,0,5,5,0.055011,4,0.335551,0.377645,7807.958054
主角(1946),主角,notion,0,1,1,0,2,2,0.013378,4,0.272039,0.290456,0
之游(1946),之游,notion,0,1,1,0,2,2,0.013103,4,0.272684,0.291543,0
之道(1946),之道,notion,0,1,1,0,3,3,0.017626,4,0.281496,0.305894,0
乌克兰(1946),乌克兰,notion,0,1,1,0,2,2,0.013103,4,0.272684,0.291543,0
乌鸦(1946),乌鸦,notion,0,1,1,0,2,2,0.013378,4,0.272039,0.290456,0
九年(1946),九年,notion,0,2,2,0,3,3,0.022204,4,0.287896,0.315838,1406.192172
书后(1946),书后,notion,0,1,1,0,2,2,0.009637,4,0.265506,0.27915,0
事业(1946),事业,notion,0,6,6,0,14,14,0.063613,4,0.353154,0.396359,19697.311531
五个(1946),五个,notion,0,1,1,0,2,2,0.013103,4,0.272684,0.291543,0
五年计划(1946),五年计划,notion,0,1,1,0,14,14,0.013103,4,0.272684,0.291543,0
人们(1946),人们,notion,0,3,3,0,4,4,0.045904,4,0.321478,0.361266,4001.310187
人力(1946),人力,notion,0,1,1,0,3,3,0.013103,4,0.272684,0.291543,0
人民军队(1946),人民军队,notion,0,1,1,0,3,3,0.00826,4,0.264992,0.278237,0
人生观(1946),人生观,notion,0,2,2,0,3,3,0.021894,4,0.287839,0.315751,2020.708436
代表(1946),代表,notion,0,9,9,0,31,31,0.091038,4,0.392075,0.431713,32147.544857
伊克昭盟(1946),伊克昭盟,notion,0,1,1,0,2,2,0.017626,4,0.281496,0.305894,0
伏士(1946),伏士,notion,0,1,1,0,2,2,0.013103,4,0.272684,0.291543,0
伟大(1946),伟大,notion,0,7,7,0,18,18,0.078989,4,0.37795,0.419653,26891.151822
传记(1946),传记,notion,0,2,2,0,6,6,0.030729,4,0.302946,0.337407,2092.27198
作物(1946),作物,notion,0,1,1,0,2,2,0.017626,4,0.281496,0.305894,0
侨胞(1946),侨胞,notion,0,3,3,0,6,6,0.02088,4,0.281993,0.306821,2537.822068
保障(1946),保障,notion,0,5,5,0,11,11,0.054336,4,0.333102,0.374978,9331.267086
修正案(1946),修正案,notion,0,2,2,0,6,6,0.027264,4,0.294896,0.326144,1405.794223
停战(1946),停战,notion,0,10,10,0,20,20,0.103635,4,0.425568,0.456877,49018.072208
偶记(1946),偶记,notion,0,1,1,0,2,2,0.013378,4,0.272039,0.290456,0
元帅(1946),元帅,notion,0,3,3,0,5,5,0.049622,4,0.336297,0.378399,6466.151599
光绪(1946),光绪,notion,0,1,1,0,2,2,0.013378,4,0.272039,0.290456,0
光荣(1946),光荣,notion,0,3,3,0,4,4,0.027355,4,0.293631,0.32439,3423.091206
兜奇(1946),兜奇,notion,0,1,1,0,2,2,0.009637,4,0.265506,0.27915,0
全文(1946),全文,notion,0,3,3,0,5,5,0.031,4,0.301294,0.335218,5051.102313
全面(1946),全面,notion,0,6,6,0,13,13,0.078419,4,0.385193,0.425799,25288.380142
八天(1946),八天,notion,0,3,3,0,4,4,0.040898,4,0.317677,0.356613,4835.835906
八年(1946),八年,notion,0,3,3,0,14,14,0.041824,4,0.323942,0.364223,6881.110907
公仆(1946),公仆,notion,0,2,2,0,3,3,0.023271,4,0.287177,0.31475,1230.541816
公平(1946),公平,notion,0,1,1,0,2,2,0.003608,4,0.255568,0.260842,0
公路(1946),公路,notion,0,2,2,0,3,3,0.022931,4,0.290456,0.319664,2102.663893
兰州(1946),兰州,notion,0,2,2,0,3,3,0.020727,4,0.284759,0.311054,789.620977
共产党(1946),共产党,notion,0,2,2,0,5,5,0.027264,4,0.294896,0.326144,1405.794223
共同纲领(1946),共同纲领,notion,0,1,1,0,10,10,0.003608,4,0.255568,0.260842,0
关向应(1946),关向应,notion,0,1,1,0,2,2,0.00826,4,0.264992,0.278237,0
关系(1946),关系,notion,0,4,4,0,12,12,0.039218,4,0.308572,0.345075,5067.786909
内外(1946),内外,notion,0,2,2,0,3,3,0.026737,4,0.295411,0.326883,1969.400217
写作(1946),写作,notion,0,1,1,0,2,2,0.018893,4,0.282798,0.307938,0
军事(1946),军事,notion,0,6,6,0,12,12,0.068649,4,0.368644,0.411231,23440.417875
军事法庭(1946),军事法庭,notion,0,1,1,0,5,5,0.013103,4,0.272684,0.291543,0
军队(1946),军队,notion,0,5,5,0,8,8,0.041415,4,0.311514,0.348974,7612.202604
农村(1946),农村,notion,0,7,7,0,21,21,0.07626,4,0.378947,0.420522,29095.570879
农科(1946),农科,notion,0,1,1,0,2,2,0.017626,4,0.281496,0.305894,0
冯玉祥(1946),冯玉祥,notion,0,2,2,0,3,3,0.02853,4,0.295746,0.327361,1236.887723
冼星海(1946),冼星海,notion,0,2,2,0,3,3,0.032271,4,0.301168,0.334971,1271.496707
几个(1946),几个,notion,0,4,4,0,5,5,0.042872,4,0.322851,0.362991,9701.076593
出版(1946),出版,notion,0,6,6,0,11,11,0.055485,4,0.34304,0.385922,20475.467209
刀兵(1946),刀兵,notion,0,1,1,0,2,2,0.013378,4,0.272039,0.290456,0
列宁(1946),列宁,notion,0,1,1,0,15,15,0.013103,4,0.272684,0.291543,0
制度(1946),制度,notion,0,10,10,0,19,19,0.106177,4,0.433985,0.462573,56636.260311
努力(1946),努力,notion,0,5,5,0,9,9,0.049183,4,0.324344,0.364846,9369.551992
北平(1946),北平,notion,0,9,9,0,19,19,0.076026,4,0.367701,0.410579,30504.440694
北碚(1946),北碚,notion,0,1,1,0,2,2,0.017626,4,0.281496,0.305894,0
十五年(1946),十五年,notion,0,1,1,0,2,2,0.00826,4,0.264992,0.278237,0
华北(1946),华北,notion,0,4,4,0,6,6,0.046218,4,0.323723,0.364034,5916.363516
华莱士(1946),华莱士,notion,0,6,6,0,11,11,0.064054,4,0.346138,0.389184,13891.953007
南通(1946),南通,notion,0,6,6,0,14,14,0.069263,4,0.357236,0.400403,17980.413271
南部(1946),南部,notion,0,1,1,0,2,2,0.013103,4,0.272684,0.291543,0
卢敬珂(1946),卢敬珂,notion,0,1,1,0,4,4,0.013103,4,0.272684,0.291543,0
原子(1946),原子,notion,0,3,3,0,5,5,0.045374,4,0.322561,0.36257,4563.560502
原子能(1946),原子能,notion,0,4,4,0,5,5,0.040768,4,0.316035,0.354641,7005.938857
参观(1946),参观,notion,0,1,1,0,2,2,0.005304,4,0.259537,0.268322,0
友好(1946),友好,notion,0,1,1,0,2,2,0.018893,4,0.282798,0.307938,0
双十节(1946),双十节,notion,0,5,5,0,13,13,0.05443,4,0.335316,0.377457,11679.238809
反对(1946),反对,notion,0,10,10,0,22,22,0.089701,4,0.383088,0.424306,36822.466707
叛徒(1946),叛徒,notion,0,1,1,0,2,2,0.004564,4,0.256755,0.263104,0
召开(1946),召开,notion,0,9,9,0,12,12,0.080175,4,0.368172,0.411014,27219.357596
可能(1946),可能,notion,0,3,3,0,5,5,0.024839,4,0.28888,0.317389,3093.603845
史大林(1946),史大林,notion,0,2,2,0,12,12,0.017582,4,0.278308,0.300878,864.242178
合作(1946),合作,notion,0,9,9,0,13,13,0.100873,4,0.419604,0.452629,42146.074326
合肥(1946),合肥,notion,0,1,1,0,2,2,0.017626,4,0.281496,0.305894,0
名教(1946),名教,notion,0,1,1,0,2,2,0.004564,4,0.256755,0.263104,0
否决权(1946),否决权,notion,0,5,5,0,9,9,0.070159,4,0.366716,0.409376,15233.383725
周未(1946),周未,notion,0,1,1,0,2,2,0.007159,4,0.261235,0.271453,0
呼吁(1946),呼吁,notion,0,3,3,0,7,7,0.030112,4,0.295442,0.326999,2400.730101
商约(1946),商约,notion,0,2,2,0,3,3,0.012739,4,0.270758,0.288354,795.473237
四起(1946),四起,notion,0,1,1,0,2,2,0.003608,4,0.255568,0.260842,0
回忆(1946),回忆,notion,0,5,5,0,9,9,0.049304,4,0.335199,0.377326,16714.516988
回顾(1946),回顾,notion,0,6,6,0,8,8,0.050721,4,0.328871,0.370224,16035.65475
团体(1946),团体,notion,0,2,2,0,3,3,0.013564,4,0.274324,0.294356,2085.288442
国共合作(1946),国共合作,notion,0,1,1,0,2,2,0.009637,4,0.265506,0.27915,0
国共谈判(1946),国共谈判,notion,0,2,2,0,3,3,0.03126,4,0.304035,0.338885,2199.499867
国大(1946),国大,notion,0,11,11,0,36,36,0.107328,4,0.425442,0.456862,53060.244083
国家(1946),国家,notion,0,9,9,0,20,20,0.093174,4,0.401158,0.438931,37393.902901
国家化(1946),国家化,notion,0,4,4,0,5,5,0.033155,4,0.297521,0.330028,3131.167736
国家计划委员会(1946),国家计划委员会,notion,0,1,1,0,2,2,0.013103,4,0.272684,0.291543,0
国是(1946),国是,notion,0,2,2,0,3,3,0.016986,4,0.276434,0.297834,735.895741
国民(1946),国民,notion,0,3,3,0,5,5,0.036465,4,0.30801,0.344263,3283.387915
国民党(1946),国民党,notion,0,10,10,0,28,28,0.108709,4,0.436688,0.464356,52014.659997
国际联盟(1946),国际联盟,notion,0,1,1,0,2,2,0.013103,4,0.272684,0.291543,0
土地改革(1946),土地改革,notion,0,3,3,0,6,6,0.039155,4,0.312599,0.35022,3965.996655
土耳其(1946),土耳其,notion,0,3,3,0,5,5,0.049622,4,0.336297,0.378399,6466.151599
地理(1946),地理,notion,0,2,2,0,6,6,0.030729,4,0.302946,0.337407,2092.27198
埃斯特(1946),埃斯特,notion,0,1,1,0,4,4,0.013103,4,0.272684,0.291543,0
基本(1946),基本,notion,0,10,10,0,13,13,0.094322,4,0.404432,0.441526,44451.07341
壬午(1946),壬午,notion,0,1,1,0,2,2,0.013378,4,0.272039,0.290456,0
夏丐尊(1946),夏丐尊,notion,0,3,3,0,6,6,0.045904,4,0.321478,0.361266,4001.310187
外交(1946),外交,notion,0,10,10,0,19,19,0.106978,4,0.428422,0.458833,46774.98794
外交政策(1946),外交政策,notion,0,7,7,0,11,11,0.077819,4,0.375973,0.417913,25335.11541
外交部长(1946),外交部长,notion,0,1,1,0,2,2,0.013103,4,0.272684,0.291543,0
外汇(1946),外汇,notion,0,5,5,0,7,7,0.066949,4,0.361005,0.403983,14459.57241
外海(1946),外海,notion,0,1,1,0,2,2,0.005304,4,0.259537,0.268322,0
多恼(1946),多恼,notion,0,1,1,0,2,2,0.013103,4,0.272684,0.291543,0
夜话(1946),夜话,notion,0,1,1,0,2,2,0.018893,4,0.282798,0.307938,0
夜里(1946),夜里,notion,0,1,1,0,2,2,0.018893,4,0.282798,0.307938,0
大合唱(1946),大合唱,notion,0,1,1,0,2,2,0.018893,4,0.282798,0.307938,0
太平洋(1946),太平洋,notion,0,3,3,0,5,5,0.025811,4,0.292734,0.323085,3292.415755
妇女(1946),妇女,notion,0,9,9,0,12,12,0.102231,4,0.420771,0.453456,39689.424085
威胁(1946),威胁,notion,0,3,3,0,5,5,0.040999,4,0.319194,0.358483,4429.485077
婚姻(1946),婚姻,notion,0,1,1,0,3,3,0.017626,4,0.281496,0.305894,0
婚姻关系(1946),婚姻关系,notion,0,1,1,0,2,2,0.013103,4,0.272684,0.291543,0
学术(1946),学术,notion,0,5,5,0,7,7,0.052921,4,0.335826,0.378022,11804.767507
学校(1946),学校,notion,0,4,4,0,6,6,0.033373,4,0.30269,0.337204,7839.329734
学生(1946),学生,notion,0,8,8,0,20,20,0.087664,4,0.390054,0.429988,27885.811803
完全相同(1946),完全相同,notion,0,1,1,0,2,2,0.013103,4,0.272684,0.291543,0
官僚(1946),官僚,notion,0,2,2,0,4,4,0.023271,4,0.287177,0.31475,1230.541816
实行(1946),实行,notion,0,5,5,0,9,9,0.051793,4,0.334575,0.376631,14412.197706
审判(1946),审判,notion,0,2,2,0,7,7,0.030729,4,0.302946,0.337407,2092.27198
客座(1946),客座,notion,0,1,1,0,2,2,0.004577,4,0.257676,0.264843,0
宪草(1946),宪草,notion,0,5,5,0,34,34,0.041441,4,0.309902,0.346886,6431.566348
对华政策(1946),对华政策,notion,0,10,10,0,24,24,0.106555,4,0.426452,0.457485,44908.044205
对於(1946),对於,notion,0,1,1,0,21,21,0.017626,4,0.281496,0.305894,0
对策(1946),对策,notion,0,3,3,0,4,4,0.040898,4,0.317677,0.356613,4835.835906
将军(1946),将军,notion,0,8,8,0,26,26,0.090083,4,0.402788,0.44012,36742.353883
局面(1946),局面,notion,0,3,3,0,4,4,0.041908,4,0.31393,0.351916,3405.961451
展望(1946),展望,notion,0,7,7,0,14,14,0.083109,4,0.382578,0.423653,22777.562037
工业(1946),工业,notion,0,5,5,0,7,7,0.060903,4,0.346931,0.389937,12700.490735
工人(1946),工人,notion,0,2,2,0,4,4,0.021363,4,0.287407,0.315098,2175.293762
工程(1946),工程,notion,0,1,1,0,4,4,0.017626,4,0.281496,0.305894,0
工运(1946),工运,notion,0,2,2,0,3,3,0.021894,4,0.287839,0.315751,2020.708436
已经(1946),已经,notion,0,2,2,0,4,4,0.02853,4,0.295746,0.327361,1236.887723
巴黎(1946),巴黎,notion,0,4,4,0,12,12,0.040266,4,0.311751,0.349206,6484.788276
巴黎公社(1946),巴黎公社,notion,0,1,1,0,2,2,0.013103,4,0.272684,0.291543,0
希望(1946),希望,notion,0,10,10,0,21,21,0.098411,4,0.412973,0.447918,53837.171641
希特勒(1946),希特勒,notion,0,4,4,0,10,10,0.045576,4,0.319549,0.35899,6365.189539
帝国(1946),帝国,notion,0,1,1,0,2,2,0.013103,4,0.272684,0.291543,0
席上(1946),席上,notion,0,1,1,0,10,10,0.013103,4,0.272684,0.291543,0
干些(1946),干些,notion,0,3,3,0,4,4,0.039155,4,0.312599,0.35022,3965.996655
干训团(1946),干训团,notion,0,1,1,0,3,3,0.005304,4,0.259537,0.268322,0
广州(1946),广州,notion,0,8,8,0,23,23,0.089008,4,0.399541,0.437598,35057.599394
广播(1946),广播,notion,0,3,3,0,4,4,0.036374,4,0.308373,0.344741,4309.87484
应负(1946),应负,notion,0,2,2,0,3,3,0.031004,4,0.302277,0.336493,1833.728143
底蕴(1946),底蕴,notion,0,1,1,0,2,2,0.013634,4,0.273332,0.292631,0
延安(1946),延安,notion,0,5,5,0,9,9,0.067794,4,0.364114,0.40694,17484.997873
建国(1946),建国,notion,0,12,12,0,26,26,0.111169,4,0.437486,0.465023,68396.962236
建议(1946),建议,notion,0,7,7,0,11,11,0.071547,4,0.366342,0.409173,24768.350112
开封(1946),开封,notion,0,3,3,0,4,4,0.035241,4,0.306924,0.342828,3234.62651
张学良(1946),张学良,notion,0,3,3,0,5,5,0.045904,4,0.321478,0.361266,4001.310187
归来(1946),归来,notion,0,5,5,0,7,7,0.05283,4,0.33677,0.379066,14463.448587
德国(1946),德国,notion,0,4,4,0,11,11,0.054001,4,0.340278,0.38282,10007.44091
总危机(1946),总危机,notion,0,1,1,0,2,2,0.013103,4,0.272684,0.291543,0
总结(1946),总结,notion,0,5,5,0,6,6,0.035029,4,0.305522,0.341103,11090.411571
总结报告(1946),总结报告,notion,0,1,1,0,4,4,0.013103,4,0.272684,0.291543,0
恋爱(1946),恋爱,notion,0,2,2,0,5,5,0.03126,4,0.304035,0.338885,2199.499867
悲哀(1946),悲哀,notion,0,2,2,0,4,4,0.032271,4,0.301168,0.334971,1271.496707
悼念(1946),悼念,notion,0,5,5,0,10,10,0.058728,4,0.342549,0.385328,12998.285134
意义(1946),意义,notion,0,7,7,0,15,15,0.084373,4,0.389948,0.429828,27860.967641
意见(1946),意见,notion,0,6,6,0,31,31,0.078473,4,0.382324,0.423363,24668.736057
慢谈(1946),慢谈,notion,0,1,1,0,2,2,0.017626,4,0.281496,0.305894,0
成就(1946),成就,notion,0,3,3,0,5,5,0.025304,4,0.291133,0.320737,2657.975957
成都(1946),成都,notion,0,3,3,0,5,5,0.040756,4,0.318451,0.357569,4060.15998
我国(1946),我国,notion,0,5,5,0,11,11,0.064098,4,0.352202,0.39533,12281.534508
战士(1946),战士,notion,0,5,5,0,13,13,0.044534,4,0.315273,0.353757,7400.8666
战局(1946),战局,notion,0,4,4,0,10,10,0.053889,4,0.342019,0.38469,11645.453176
战线(1946),战线,notion,0,1,1,0,2,2,0.013103,4,0.272684,0.291543,0
所谓(1946),所谓,notion,0,8,8,0,15,15,0.079007,4,0.38136,0.422682,28841.796079
托管制度(1946),托管制度,notion,0,1,1,0,2,2,0.013103,4,0.272684,0.291543,0
扬州(1946),扬州,notion,0,1,1,0,2,2,0.018893,4,0.282798,0.307938,0
批判(1946),批判,notion,0,4,4,0,7,7,0.063531,4,0.355777,0.398823,10524.699811
抗建(1946),抗建,notion,0,1,1,0,2,2,0.017626,4,0.281496,0.305894,0
抗战(1946),抗战,notion,0,6,6,0,15,15,0.069708,4,0.365085,0.407926,18016.989001
抗敌(1946),抗敌,notion,0,1,1,0,2,2,0.013378,4,0.272039,0.290456,0
报告(1946),报告,notion,0,5,5,0,15,15,0.052399,4,0.333024,0.374891,12857.390547
拆穿(1946),拆穿,notion,0,2,2,0,4,4,0.032271,4,0.301168,0.334971,1271.496707
挨打(1946),挨打,notion,0,3,3,0,4,4,0.031531,4,0.302308,0.336609,5017.125996
控制(1946),控制,notion,0,3,3,0,5,5,0.022474,4,0.287292,0.314997,4750.988532
控诉(1946),控诉,notion,0,5,5,0,23,23,0.051363,4,0.331641,0.373326,9822.406034
措施(1946),措施,notion,0,2,2,0,3,3,0.036519,4,0.313896,0.3518,2490.161613
提督(1946),提督,notion,0,1,1,0,3,3,0.017626,4,0.281496,0.305894,0
摘记(1946),摘记,notion,0,1,1,0,2,2,0.013103,4,0.272684,0.291543,0
改组(1946),改组,notion,0,7,7,0,18,18,0.082237,4,0.381562,0.422784,23444.103318
政制(1946),政制,notion,0,2,2,0,3,3,0.03126,4,0.304035,0.338885,2199.499867
政协(1946),政协,notion,0,8,8,0,18,18,0.074137,4,0.35697,0.400287,20800.280051
政局(1946),政局,notion,0,5,5,0,10,10,0.068461,4,0.36269,0.405592,13956.812142
政纲(1946),政纲,notion,0,1,1,0,2,2,0.009637,4,0.265506,0.27915,0
救济(1946),救济,notion,0,7,7,0,14,14,0.06355,4,0.351642,0.394909,19574.850391
教育(1946),教育,notion,0,14,14,0,44,44,0.127964,4,0.478087,0.489433,94744.51894
文化教育(1946),文化教育,notion,0,2,2,0,5,5,0.022501,4,0.28712,0.314663,997.953629
文灏(1946),文灏,notion,0,1,1,0,2,2,0.013634,4,0.273332,0.292631,0
文艺(1946),文艺,notion,0,6,6,0,12,12,0.058122,4,0.340037,0.382704,15363.344022
文艺界(1946),文艺界,notion,0,1,1,0,2,2,0.013378,4,0.272039,0.290456,0
斗争(1946),斗争,notion,0,7,7,0,26,26,0.059138,4,0.341005,0.38382,19891.038248
新闻自由(1946),新闻自由,notion,0,4,4,0,5,5,0.059007,4,0.344602,0.38743,9262.774199
方案(1946),方案,notion,0,5,5,0,8,8,0.048235,4,0.325372,0.366064,8885.606395
方法(1946),方法,notion,0,5,5,0,6,6,0.045392,4,0.326221,0.367064,15320.259312
旅途(1946),旅途,notion,0,2,2,0,6,6,0.026737,4,0.295411,0.326883,1969.400217
无线电(1946),无线电,notion,0,1,1,0,2,2,0.013103,4,0.272684,0.291543,0
无边(1946),无边,notion,0,1,1,0,2,2,0.018893,4,0.282798,0.307938,0
日记(1946),日记,notion,0,4,4,0,5,5,0.040698,4,0.313348,0.351249,5892.09011
时代(1946),时代,notion,0,9,9,0,22,22,0.093286,4,0.408629,0.444628,46447.157569
时速(1946),时速,notion,0,1,1,0,2,2,0.013378,4,0.272039,0.290456,0
明代(1946),明代,notion,0,2,2,0,3,3,0.02219,4,0.287062,0.314576,1087.606545
明日(1946),明日,notion,0,2,2,0,7,7,0.031004,4,0.302277,0.336493,1833.728143
明治维新(1946),明治维新,notion,0,1,1,0,3,3,0.017626,4,0.281496,0.305894,0
昭和(1946),昭和,notion,0,1,1,0,3,3,0.017626,4,0.281496,0.305894,0
最后(1946),最后,notion,0,8,8,0,17,17,0.084604,4,0.379297,0.420899,26296.842506
最新(1946),最新,notion,0,1,1,0,2,2,0.013103,4,0.272684,0.291543,0
最高(1946),最高,notion,0,1,1,0,2,2,0.013103,4,0.272684,0.291543,0
有序(1946),有序,notion,0,1,1,0,2,2,0.004577,4,0.257676,0.264843,0
未完待续(1946),未完待续,notion,0,2,2,0,5,5,0.012738,4,0.268934,0.285224,447.151269
机关(1946),机关,notion,0,4,4,0,5,5,0.044678,4,0.319123,0.358468,6808.368984
杂咏(1946),杂咏,notion,0,1,1,0,2,2,0.017626,4,0.281496,0.305894,0
权利(1946),权利,notion,0,5,5,0,8,8,0.044566,4,0.31831,0.35754,8168.428191
李公朴(1946),李公朴,notion,0,5,5,0,23,23,0.059779,4,0.339194,0.381719,9574.925148
李卓吾(1946),李卓吾,notion,0,1,1,0,2,2,0.004564,4,0.256755,0.263104,0
概要(1946),概要,notion,0,1,1,0,2,2,0.013103,4,0.272684,0.291543,0
欧洲(1946),欧洲,notion,0,8,8,0,13,13,0.089821,4,0.394064,0.433249,29191.096357
武器(1946),武器,notion,0,3,3,0,5,5,0.035271,4,0.306957,0.342871,4801.912862
殖民地(1946),殖民地,notion,0,2,2,0,3,3,0.021363,4,0.287407,0.315098,2175.293762
母亲(1946),母亲,notion,0,2,2,0,6,6,0.031996,4,0.303907,0.338711,1883.718005
民主化(1946),民主化,notion,0,6,6,0,10,10,0.060894,4,0.34993,0.393097,15725.208202
民意(1946),民意,notion,0,5,5,0,10,10,0.058401,4,0.341775,0.384502,12250.817293
民权(1946),民权,notion,0,3,3,0,4,4,0.036649,4,0.305197,0.340523,3243.041111
法兰西(1946),法兰西,notion,0,2,2,0,3,3,0.030729,4,0.302946,0.337407,2092.27198
洋兵(1946),洋兵,notion,0,1,1,0,2,2,0.018893,4,0.282798,0.307938,0
海上(1946),海上,notion,0,1,1,0,2,2,0.004564,4,0.256755,0.263104,0
海军(1946),海军,notion,0,2,2,0,4,4,0.030729,4,0.302946,0.337407,2092.27198
海外(1946),海外,notion,0,3,3,0,5,5,0.044363,4,0.326555,0.36731,6261.172064
渔村(1946),渔村,notion,0,1,1,0,2,2,0.005304,4,0.259537,0.268322,0
温州(1946),温州,notion,0,1,1,0,2,2,0.004479,4,0.256686,0.262973,0
游心影(1946),游心影,notion,0,1,1,0,2,2,0.005304,4,0.259537,0.268322,0
游记(1946),游记,notion,0,2,2,0,5,5,0.026481,4,0.292853,0.323187,1408.34579
演词(1946),演词,notion,0,2,2,0,5,5,0.017582,4,0.278308,0.300878,864.242178
演辞(1946),演辞,notion,0,1,1,0,3,3,0.013103,4,0.272684,0.291543,0
瀚海(1946),瀚海,notion,0,1,1,0,2,2,0.018893,4,0.282798,0.307938,0
烦恼(1946),烦恼,notion,0,2,2,0,3,3,0.009056,4,0.263776,0.276135,639.601266
烽火(1946),烽火,notion,0,2,2,0,3,3,0.009868,4,0.265801,0.279744,898.961745
爱恨(1946),爱恨,notion,0,1,1,0,2,2,0.017626,4,0.281496,0.305894,0
物价(1946),物价,notion,0,4,4,0,10,10,0.05439,4,0.341045,0.383646,8455.474829
物力(1946),物力,notion,0,1,1,0,3,3,0.013103,4,0.272684,0.291543,0
特写(1946),特写,notion,0,2,2,0,5,5,0.02853,4,0.295746,0.327361,1236.887723
特务(1946),特务,notion,0,7,7,0,16,16,0.061225,4,0.342876,0.385821,18443.979846
特征(1946),特征,notion,0,1,1,0,2,2,0.013103,4,0.272684,0.291543,0
特港(1946),特港,notion,0,1,1,0,2,2,0.009637,4,0.265506,0.27915,0
特里(1946),特里,notion,0,2,2,0,5,5,0.02274,4,0.286006,0.312967,1109.932808
独立(1946),独立,notion,0,6,6,0,14,14,0.074678,4,0.378298,0.419885,24620.113534
猎书(1946),猎书,notion,0,1,1,0,2,2,0.013378,4,0.272039,0.290456,0
献言(1946),献言,notion,0,1,1,0,2,2,0.003608,4,0.255568,0.260842,0
现代战争(1946),现代战争,notion,0,1,1,0,3,3,0.013103,4,0.272684,0.291543,0
现实(1946),现实,notion,0,5,5,0,7,7,0.059504,4,0.355205,0.39833,18408.563475
生平(1946),生平,notion,0,1,1,0,3,3,0.017626,4,0.281496,0.305894,0
生日(1946),生日,notion,0,1,1,0,2,2,0.004577,4,0.257676,0.264843,0
生讲(1946),生讲,notion,0,1,1,0,2,2,0.017626,4,0.281496,0.305894,0
电影学院(1946),电影学院,notion,0,1,1,0,2,2,0.018893,4,0.282798,0.307938,0
电钮(1946),电钮,notion,0,1,1,0,2,2,0.018893,4,0.282798,0.307938,0
痛悼(1946),痛悼,notion,0,3,3,0,12,12,0.045904,4,0.321478,0.361266,4001.310187
白俄罗斯(1946),白俄罗斯,notion,0,1,1,0,2,2,0.013103,4,0.272684,0.291543,0
白沙(1946),白沙,notion,0,1,1,0,2,2,0.017626,4,0.281496,0.305894,0
知行(1946),知行,notion,0,1,1,0,2,2,0.004577,4,0.257676,0.264843,0
研究生(1946),研究生,notion,0,1,1,0,2,2,0.017626,4,0.281496,0.305894,0
破裂(1946),破裂,notion,0,2,2,0,3,3,0.027153,4,0.296784,0.32884,1981.441549
社会史(1946),社会史,notion,0,1,1,0,2,2,0.017626,4,0.281496,0.305894,0
祖先(1946),祖先,notion,0,1,1,0,3,3,0.013103,4,0.272684,0.291543,0
科学家(1946),科学家,notion,0,1,1,0,2,2,0.013103,4,0.272684,0.291543,0
立国(1946),立国,notion,0,1,1,0,2,2,0.017626,4,0.281496,0.305894,0
立场(1946),立场,notion,0,6,6,0,9,9,0.041756,4,0.304099,0.339262,6847.946284
立法权(1946),立法权,notion,0,1,1,0,2,2,0.013378,4,0.272039,0.290456,0
笔画(1946),笔画,notion,0,1,1,0,2,2,0.018893,4,0.282798,0.307938,0
第一届(1946),第一届,notion,0,1,1,0,2,2,0.013103,4,0.272684,0.291543,0
第六(1946),第六,notion,0,1,1,0,2,2,0.013378,4,0.272039,0.290456,0
第四次(1946),第四次,notion,0,1,1,0,7,7,0.013103,4,0.272684,0.291543,0
等待(1946),等待,notion,0,2,2,0,3,3,0.02853,4,0.295746,0.327361,1236.887723
答问(1946),答问,notion,0,2,2,0,3,3,0.032271,4,0.301168,0.334971,1271.496707
管制(1946),管制,notion,0,4,4,0,9,9,0.04388,4,0.319549,0.35899,6606.390027
素描(1946),素描,notion,0,5,5,0,9,9,0.068561,4,0.372031,0.414246,20283.571889
絮语(1946),絮语,notion,0,1,1,0,2,2,0.004564,4,0.256755,0.263104,0
红军(1946),红军,notion,0,1,1,0,4,4,0.013103,4,0.272684,0.291543,0
纳粹(1946),纳粹,notion,0,3,3,0,8,8,0.044107,4,0.323833,0.364092,5334.345912
纽伦堡(1946),纽伦堡,notion,0,4,4,0,9,9,0.046197,4,0.321802,0.36173,6458.797917
组织(1946),组织,notion,0,8,8,0,18,18,0.068166,4,0.357503,0.400809,28130.859106
经济危机(1946),经济危机,notion,0,10,10,0,20,20,0.108032,4,0.432288,0.461443,49964.742457
统一(1946),统一,notion,0,8,8,0,19,19,0.085832,4,0.390159,0.430075,32383.508202
续完(1946),续完,notion,0,8,8,0,25,25,0.088937,4,0.396237,0.434989,32865.503083
维新(1946),维新,notion,0,1,1,0,3,3,0.017626,4,0.281496,0.305894,0
罪状(1946),罪状,notion,0,2,2,0,5,5,0.030729,4,0.302946,0.337407,2092.27198
美军(1946),美军,notion,0,6,6,0,14,14,0.075739,4,0.380401,0.421711,24000.41128
美帝国主义(1946),美帝国主义,notion,0,2,2,0,3,3,0.027153,4,0.296784,0.32884,1981.441549
群众(1946),群众,notion,0,1,1,0,4,4,0.00826,4,0.264992,0.278237,0
群魔(1946),群魔,notion,0,1,1,0,4,4,0.013103,4,0.272684,0.291543,0
老百姓(1946),老百姓,notion,0,6,6,0,9,9,0.05938,4,0.343696,0.386618,15442.347795
考验(1946),考验,notion,0,5,5,0,12,12,0.054528,4,0.328646,0.36989,8182.51139
而已(1946),而已,notion,0,4,4,0,5,5,0.049323,4,0.325999,0.36673,6953.373866
聂辛斯基(1946),聂辛斯基,notion,0,1,1,0,2,2,0.013103,4,0.272684,0.291543,0
联合国大会(1946),联合国大会,notion,0,4,4,0,8,8,0.044846,4,0.321694,0.361599,7144.200138
胜利(1946),胜利,notion,0,12,12,0,52,52,0.11744,4,0.458709,0.478243,75989.453198
自己(1946),自己,notion,0,9,9,0,16,16,0.076365,4,0.365643,0.408665,31556.265632
自由(1946),自由,notion,0,12,12,0,42,42,0.116617,4,0.451433,0.473851,72577.549586
舌战(1946),舌战,notion,0,1,1,0,2,2,0.003608,4,0.255568,0.260842,0
舟中(1946),舟中,notion,0,1,1,0,2,2,0.004577,4,0.257676,0.264843,0
航空(1946),航空,notion,0,1,1,0,2,2,0.013103,4,0.272684,0.291543,0
航讯(1946),航讯,notion,0,3,3,0,5,5,0.03962,4,0.317256,0.356091,4143.541638
航路(1946),航路,notion,0,1,1,0,3,3,0.013103,4,0.272684,0.291543,0
舰队(1946),舰队,notion,0,1,1,0,2,2,0.018893,4,0.282798,0.307938,0
苏北(1946),苏北,notion,0,8,8,0,17,17,0.098768,4,0.423374,0.45521,40874.596949
苏联最高苏维埃(1946),苏联最高苏维埃,notion,0,1,1,0,2,2,0.013103,4,0.272684,0.291543,0
苦难(1946),苦难,notion,0,2,2,0,3,3,0.027153,4,0.296784,0.32884,1981.441549
英伦(1946),英伦,notion,0,1,1,0,2,2,0.009637,4,0.265506,0.27915,0
英美(1946),英美,notion,0,5,5,0,11,11,0.063837,4,0.357414,0.400504,15438.856534
莫洛托夫(1946),莫洛托夫,notion,0,3,3,0,5,5,0.041633,4,0.316488,0.355134,4230.538536
菲列滨(1946),菲列滨,notion,0,1,1,0,2,2,0.017626,4,0.281496,0.305894,0
蒋主席(1946),蒋主席,notion,0,6,6,0,19,19,0.071428,4,0.366762,0.409492,18197.804293
薪津(1946),薪津,notion,0,2,2,0,3,3,0.022204,4,0.287896,0.315838,1406.192172
血案(1946),血案,notion,0,4,4,0,7,7,0.044768,4,0.320154,0.359729,6919.371603
袁世凯(1946),袁世凯,notion,0,3,3,0,4,4,0.045904,4,0.321478,0.361266,4001.310187
被捕(1946),被捕,notion,0,1,1,0,2,2,0.017626,4,0.281496,0.305894,0
裁兵(1946),裁兵,notion,0,2,2,0,3,3,0.022501,4,0.28712,0.314663,997.953629
西安(1946),西安,notion,0,3,3,0,5,5,0.036764,4,0.307845,0.344045,2893.036981
西江月(1946),西江月,notion,0,1,1,0,2,2,0.004577,4,0.257676,0.264843,0
观察(1946),观察,notion,0,2,2,0,8,8,0.014214,4,0.272194,0.29079,872.497436
观念(1946),观念,notion,0,4,4,0,5,5,0.032282,4,0.30035,0.333986,6345.685177
解决(1946),解决,notion,0,12,12,0,31,31,0.095438,4,0.403524,0.440975,61409.466854
言论(1946),言论,notion,0,4,4,0,7,7,0.053745,4,0.337046,0.379298,8747.649964
警员(1946),警员,notion,0,1,1,0,3,3,0.013378,4,0.272039,0.290456,0
警察(1946),警察,notion,0,3,3,0,7,7,0.037988,4,0.308903,0.345437,2989.281487
警管区(1946),警管区,notion,0,5,5,0,10,10,0.0627,4,0.344396,0.387285,10998.009864
计划经济(1946),计划经济,notion,0,1,1,0,2,2,0.013103,4,0.272684,0.291543,0
认识(1946),认识,notion,0,10,10,0,16,16,0.107381,4,0.441314,0.467357,60853.656427
讨论会(1946),讨论会,notion,0,1,1,0,2,2,0.013103,4,0.272684,0.291543,0
议院(1946),议院,notion,0,1,1,0,2,2,0.013103,4,0.272684,0.291543,0
记录(1946),记录,notion,0,2,2,0,7,7,0.018407,4,0.281634,0.306184,1780.990245
记言(1946),记言,notion,0,1,1,0,2,2,0.004577,4,0.257676,0.264843,0
设计(1946),设计,notion,0,3,3,0,5,5,0.032316,4,0.301294,0.335218,4537.711267
诗词(1946),诗词,notion,0,3,3,0,6,6,0.025811,4,0.292734,0.323085,3292.415755
诚意(1946),诚意,notion,0,4,4,0,6,6,0.045205,4,0.320403,0.360034,6401.846997
语文(1946),语文,notion,0,1,1,0,2,2,0.017626,4,0.281496,0.305894,0
语言(1946),语言,notion,0,2,2,0,3,3,0.018211,4,0.280617,0.304575,1609.081689
说起(1946),说起,notion,0,9,9,0,23,23,0.10337,4,0.422193,0.454456,39816.638858
诸君(1946),诸君,notion,0,2,2,0,3,3,0.018839,4,0.277904,0.300226,537.484117
读书(1946),读书,notion,0,2,2,0,13,13,0.022931,4,0.290456,0.319664,2102.663893
读的书(1946),读的书,notion,0,1,1,0,3,3,0.017626,4,0.281496,0.305894,0
调整(1946),调整,notion,0,4,4,0,5,5,0.030933,4,0.296417,0.328463,3791.731699
调解(1946),调解,notion,0,1,1,0,2,2,0.013634,4,0.273332,0.292631,0
财政(1946),财政,notion,0,4,4,0,5,5,0.041496,4,0.317677,0.356685,7309.921791
责任(1946),责任,notion,0,5,5,0,8,8,0.073168,4,0.370258,0.412637,15295.500594
贺莎菲(1946),贺莎菲,notion,0,1,1,0,2,2,0.004577,4,0.257676,0.264843,0
资本主义(1946),资本主义,notion,0,5,5,0,8,8,0.049179,4,0.323687,0.364063,8348.844328
趋势(1946),趋势,notion,0,3,3,0,5,5,0.025723,4,0.288387,0.316649,2201.972732
路线(1946),路线,notion,0,3,3,0,4,4,0.028833,4,0.293631,0.32439,1900.302815
迁居(1946),迁居,notion,0,1,1,0,2,2,0.005304,4,0.259537,0.268322,0
运动(1946),运动,notion,0,11,11,0,40,40,0.115081,4,0.459295,0.478518,73889.828905
运动史(1946),运动史,notion,0,1,1,0,2,2,0.004479,4,0.256686,0.262973,0
近况(1946),近况,notion,0,2,2,0,3,3,0.026737,4,0.295411,0.326883,1969.400217
进步(1946),进步,notion,0,5,5,0,10,10,0.047947,4,0.326258,0.367107,11982.317974
退出(1946),退出,notion,0,3,3,0,7,7,0.040531,4,0.315723,0.354178,4919.220408
逆流(1946),逆流,notion,0,7,7,0,14,14,0.085774,4,0.396729,0.435308,29881.77229
选举(1946),选举,notion,0,9,9,0,22,22,0.100775,4,0.416806,0.450629,38273.9226
通讯社(1946),通讯社,notion,0,2,2,0,3,3,0.01734,4,0.277877,0.300183,713.880954
通车(1946),通车,notion,0,2,2,0,3,3,0.022931,4,0.290456,0.319664,2102.663893
通过(1946),通过,notion,0,2,2,0,3,3,0.030729,4,0.302946,0.337407,2092.27198
逝世(1946),逝世,notion,0,5,5,0,8,8,0.057096,4,0.336494,0.378762,10153.54841
逻辑(1946),逻辑,notion,0,3,3,0,4,4,0.022421,4,0.281966,0.306778,1559.289231
道德(1946),道德,notion,0,3,3,0,5,5,0.023358,4,0.286177,0.313301,3033.789989
道路(1946),道路,notion,0,5,5,0,8,8,0.064312,4,0.355601,0.398722,16754.838839
那里(1946),那里,notion,0,10,10,0,18,18,0.086746,4,0.377107,0.419131,36853.829517
部长(1946),部长,notion,0,2,2,0,3,3,0.027011,4,0.292079,0.322056,1114.922273
释义(1946),释义,notion,0,1,1,0,2,2,0.009637,4,0.265506,0.27915,0
里外(1946),里外,notion,0,1,1,0,2,2,0.018893,4,0.282798,0.307938,0
重庆(1946),重庆,notion,0,7,7,0,17,17,0.072589,4,0.363838,0.406824,18945.320647
重要性(1946),重要性,notion,0,2,2,0,3,3,0.013245,4,0.269995,0.28705,596.681008
钟山(1946),钟山,notion,0,1,1,0,2,2,0.007159,4,0.261235,0.271453,0
错误(1946),错误,notion,0,2,2,0,3,3,0.031996,4,0.303907,0.338711,1883.718005
长沙(1946),长沙,notion,0,3,3,0,6,6,0.03009,4,0.300664,0.334348,4733.504223
闻一多(1946),闻一多,notion,0,7,7,0,20,20,0.069719,4,0.349632,0.392865,15498.135378
队伍(1946),队伍,notion,0,1,1,0,2,2,0.013378,4,0.272039,0.290456,0
阴谋(1946),阴谋,notion,0,4,4,0,8,8,0.053889,4,0.342019,0.38469,11645.453176
陪都(1946),陪都,notion,0,5,5,0,11,11,0.052612,4,0.329701,0.371108,9176.232675
障碍(1946),障碍,notion,0,1,1,0,2,2,0.003608,4,0.255568,0.260842,0
雅斯(1946),雅斯,notion,0,1,1,0,2,2,0.007159,4,0.261235,0.271453,0
雕像(1946),雕像,notion,0,1,1,0,3,3,0.013103,4,0.272684,0.291543,0
需要(1946),需要,notion,0,6,6,0,14,14,0.05167,4,0.325741,0.366571,11984.099044
青海(1946),青海,notion,0,1,1,0,2,2,0.004577,4,0.257676,0.264843,0
青铜时代(1946),青铜时代,notion,0,1,1,0,2,2,0.018893,4,0.282798,0.307938,0
非常(1946),非常,notion,0,1,1,0,2,2,0.017626,4,0.281496,0.305894,0
革命(1946),革命,notion,0,5,5,0,23,23,0.066418,4,0.360055,0.40307,14465.523526
风度(1946),风度,notion,0,2,2,0,3,3,0.017955,4,0.278848,0.301748,1157.770247
首席(1946),首席,notion,0,1,1,0,4,4,0.013103,4,0.272684,0.291543,0
首次(1946),首次,notion,0,2,2,0,3,3,0.020727,4,0.284759,0.311054,789.620977
马歇尔(1946),马歇尔,notion,0,8,8,0,19,19,0.088888,4,0.391488,0.431162,28118.925219
鬼声(1946),鬼声,notion,0,1,1,0,2,2,0.003608,4,0.255568,0.260842,0
鸽子(1946),鸽子,notion,0,2,2,0,3,3,0.017941,4,0.27702,0.298791,611.724515
麦克阿瑟(1946),麦克阿瑟,notion,0,3,3,0,6,6,0.043678,4,0.323323,0.363484,4955.460855
BEAT(1946),BEAT,notion,0,1,1,0,1,1,0.013634,4,0.273332,0.292631,0
CC(1946),CC,notion,0,1,1,0,2,2,0.018893,4,0.282798,0.307938,0
DDT(1946),DDT,notion,0,1,1,0,1,1,0.017626,4,0.281496,0.305894,0
Hudson(1946),Hudson,notion,0,1,1,0,1,1,0.017626,4,0.281496,0.305894,0
Jackson(1946),Jackson,notion,0,1,1,0,1,1,0.004577,4,0.257676,0.264843,0
NICOLSON(1946),NICOLSON,notion,0,1,1,0,1,1,0.017626,4,0.281496,0.305894,0
OKOROMOK(1946),OKOROMOK,notion,0,1,1,0,1,1,0.013634,4,0.273332,0.292631,0
POST(1946),POST,notion,0,1,1,0,1,1,0.013634,4,0.273332,0.292631,0
RAYON(1946),RAYON,notion,0,1,1,0,1,1,0.013634,4,0.273332,0.292631,0
REVIER(1946),REVIER,notion,0,1,1,0,1,1,0.013634,4,0.273332,0.292631,0
VIS(1946),VIS,notion,0,1,1,0,1,1,0.004479,4,0.256686,0.262973,0
XX(1946),XX,notion,0,1,1,0,1,1,0.018893,4,0.282798,0.307938,0
一七(1946),一七,notion,0,1,1,0,1,1,0.018893,4,0.282798,0.307938,0
一下(1946),一下,notion,0,1,1,0,1,1,0.004237,4,0.256206,0.26206,0
一个月(1946),一个月,notion,0,1,1,0,1,1,0.013103,4,0.272684,0.291543,0
一九(1946),一九,notion,0,1,1,0,1,1,0.013103,4,0.272684,0.291543,0
一九三八年(1946),一九三八年,notion,0,1,1,0,1,1,0.004577,4,0.257676,0.264843,0
一九三六年(1946),一九三六年,notion,0,1,1,0,1,1,0.013103,4,0.272684,0.291543,0
一九二(1946),一九二,notion,0,1,1,0,1,1,0.013103,4,0.272684,0.291543,0
一九二四年(1946),一九二四年,notion,0,1,1,0,1,1,0.013103,4,0.272684,0.291543,0
一九四二年(1946),一九四二年,notion,0,1,1,0,1,1,0.013103,4,0.272684,0.291543,0
一二一(1946),一二一,notion,0,1,1,0,2,2,0.018893,4,0.282798,0.307938,0
一二九(1946),一二九,notion,0,2,2,0,2,2,0.008814,4,0.263389,0.275439,571.594286
一些(1946),一些,notion,0,1,1,0,1,1,0.018893,4,0.282798,0.307938,0
一份(1946),一份,notion,0,1,1,0,1,1,0.017626,4,0.281496,0.305894,0
一伦半伦(1946),一伦半伦,notion,0,1,1,0,1,1,0.017626,4,0.281496,0.305894,0
一位(1946),一位,notion,0,6,6,0,7,7,0.073072,4,0.372176,0.414449,21796.525608
一例(1946),一例,notion,0,2,2,0,2,2,0.008655,4,0.263004,0.274743,415.877318
一元(1946),一元,notion,0,1,1,0,1,1,0.005304,4,0.259537,0.268322,0
一元论(1946),一元论,notion,0,1,1,0,1,1,0.004564,4,0.256755,0.263104,0
一党(1946),一党,notion,0,3,3,0,3,3,0.026201,4,0.29128,0.320954,3191.408668
一党的(1946),一党的,notion,0,1,1,0,1,1,0.009637,4,0.265506,0.27915,0
一八(1946),一八,notion,0,1,1,0,1,1,0.013103,4,0.272684,0.291543,0
一册(1946),一册,notion,0,1,1,0,1,1,0.009637,4,0.265506,0.27915,0
一击(1946),一击,notion,0,1,1,0,1,1,0.018893,4,0.282798,0.307938,0
一千七百(1946),一千七百,notion,0,1,1,0,1,1,0.00826,4,0.264992,0.278237,0
一只(1946),一只,notion,0,1,1,0,1,1,0.013634,4,0.273332,0.292631,0
一号(1946),一号,notion,0,1,1,0,1,1,0.013378,4,0.272039,0.290456,0
一名(1946),一名,notion,0,2,2,0,2,2,0.017897,4,0.280261,0.304009,1765.875744
一周年(1946),一周年,notion,0,2,2,0,2,2,0.027153,4,0.296784,0.32884,1981.441549
一呼(1946),一呼,notion,0,1,1,0,1,1,0.013103,4,0.272684,0.291543,0
一场(1946),一场,notion,0,1,1,0,1,1,0.018893,4,0.282798,0.307938,0
一声(1946),一声,notion,0,1,1,0,1,1,0.005304,4,0.259537,0.268322,0
一多(1946),一多,notion,0,2,2,0,2,2,0.018113,4,0.278577,0.301313,749.731439
一大(1946),一大,notion,0,1,1,0,1,1,0.013634,4,0.273332,0.292631,0
一天(1946),一天,notion,0,1,1,0,1,1,0.013634,4,0.273332,0.292631,0
一女(1946),一女,notion,0,1,1,0,1,1,0.013378,4,0.272039,0.290456,0
一字兴(1946),一字兴,notion,0,1,1,0,1,1,0.00826,4,0.264992,0.278237,0
一定(1946),一定,notion,0,2,2,0,2,2,0.031996,4,0.303907,0.338711,1883.718005
一家(1946),一家,notion,0,2,2,0,2,2,0.031996,4,0.303907,0.338711,1883.718005
一封(1946),一封,notion,0,2,2,0,2,2,0.027011,4,0.292079,0.322056,1114.922273
一封信(1946),一封信,notion,0,1,1,0,1,1,0.018893,4,0.282798,0.307938,0
一幅(1946),一幅,notion,0,1,1,0,2,2,0.00826,4,0.264992,0.278237,0
一幕(1946),一幕,notion,0,2,2,0,2,2,0.021638,4,0.286262,0.313359,1666.282153
一年(1946),一年,notion,0,8,8,0,16,16,0.093936,4,0.413925,0.448469,39152.10045
一年级(1946),一年级,notion,0,1,1,0,1,1,0.017626,4,0.281496,0.305894,0
一应(1946),一应,notion,0,1,1,0,1,1,0.013103,4,0.272684,0.291543,0
一张(1946),一张,notion,0,2,2,0,2,2,0.026481,4,0.292853,0.323187,1408.34579
一往无前(1946),一往无前,notion,0,1,1,0,1,1,0.00826,4,0.264992,0.278237,0
一感(1946),一感,notion,0,1,1,0,1,1,0.003608,4,0.255568,0.260842,0
一手包办(1946),一手包办,notion,0,1,1,0,1,1,0.004237,4,0.256206,0.26206,0
一批(1946),一批,notion,0,1,1,0,1,1,0.007159,4,0.261235,0.271453,0
一把(1946),一把,notion,0,1,1,0,1,1,0.007159,4,0.261235,0.271453,0
一支(1946),一支,notion,0,2,2,0,2,2,0.018938,4,0.282437,0.307445,1861.68946
一文(1946),一文,notion,0,2,2,0,2,2,0.020389,4,0.284308,0.310358,712.812748
一本(1946),一本,notion,0,1,1,0,1,1,0.013634,4,0.273332,0.292631,0
一朵(1946),一朵,notion,0,1,1,0,1,1,0.018893,4,0.282798,0.307938,0
一条(1946),一条,notion,0,5,5,0,5,5,0.030996,4,0.291753,0.321795,4364.965826
一步(1946),一步,notion,0,1,1,0,1,1,0.004564,4,0.256755,0.263104,0
一段时间(1946),一段时间,notion,0,1,1,0,1,1,0.018893,4,0.282798,0.307938,0
一点(1946),一点,notion,0,5,5,0,5,5,0.063244,4,0.349038,0.392112,11782.922926
一片(1946),一片,notion,0,1,1,0,3,3,0.018893,4,0.282798,0.307938,0
一生(1946),一生,notion,0,1,1,0,1,1,0.004479,4,0.256686,0.262973,0
一百五十(1946),一百五十,notion,0,1,1,0,1,1,0.018893,4,0.282798,0.307938,0
一种(1946),一种,notion,0,3,3,0,4,4,0.040898,4,0.317677,0.356613,4835.835906
一窝(1946),一窝,notion,0,1,1,0,1,1,0.00826,4,0.264992,0.278237,0
一章(1946),一章,notion,0,3,3,0,3,3,0.035581,4,0.308903,0.345437,4397.690562
一笔(1946),一笔,notion,0,1,1,0,1,1,0.00826,4,0.264992,0.278237,0
一线(1946),一线,notion,0,1,1,0,1,1,0.013634,4,0.273332,0.292631,0
一线希望(1946),一线希望,notion,0,1,1,0,1,1,0.009637,4,0.265506,0.27915,0
一统(1946),一统,notion,0,3,3,0,3,3,0.045904,4,0.321478,0.361266,4001.310187
一群(1946),一群,notion,0,1,1,0,1,1,0.018893,4,0.282798,0.307938,0
一股(1946),一股,notion,0,1,1,0,1,1,0.017626,4,0.281496,0.305894,0
一致(1946),一致,notion,0,2,2,0,3,3,0.030729,4,0.302946,0.337407,2092.27198
一般(1946),一般,notion,0,1,1,0,1,1,0.005304,4,0.259537,0.268322,0
一角(1946),一角,notion,0,1,1,0,1,1,0.017626,4,0.281496,0.305894,0
一解(1946),一解,notion,0,1,1,0,1,1,0.005461,4,0.25793,0.265322,0
一道(1946),一道,notion,0,1,1,0,1,1,0.007159,4,0.261235,0.271453,0
一隅(1946),一隅,notion,0,1,1,0,1,1,0.013634,4,0.273332,0.292631,0
一项(1946),一项,notion,0,1,1,0,1,1,0.004564,4,0.256755,0.263104,0
一颗(1946),一颗,notion,0,3,3,0,3,3,0.044779,4,0.329588,0.370833,7407.356159
丁聪(1946),丁聪,notion,0,1,1,0,1,1,0.018893,4,0.282798,0.307938,0
七七(1946),七七,notion,0,4,4,0,10,10,0.039631,4,0.306564,0.342422,4497.018051
七七八八(1946),七七八八,notion,0,1,1,0,1,1,0.018893,4,0.282798,0.307938,0
七十二变(1946),七十二变,notion,0,1,1,0,1,1,0.018893,4,0.282798,0.307938,0
七十五(1946),七十五,notion,0,1,1,0,1,1,0.013103,4,0.272684,0.291543,0
七十八岁(1946),七十八岁,notion,0,2,2,0,2,2,0.031996,4,0.303907,0.338711,1883.718005
七十六岁(1946),七十六岁,notion,0,1,1,0,1,1,0.013103,4,0.272684,0.291543,0
七年(1946),七年,notion,0,1,1,0,1,1,0.013103,4,0.272684,0.291543,0
七次(1946),七次,notion,0,1,1,0,1,1,0.013103,4,0.272684,0.291543,0
万一(1946),万一,notion,0,1,1,0,1,1,0.013378,4,0.272039,0.290456,0
万世师表(1946),万世师表,notion,0,1,1,0,1,1,0.017626,4,0.281496,0.305894,0
万人(1946),万人,notion,0,1,1,0,1,1,0.018893,4,0.282798,0.307938,0
万分(1946),万分,notion,0,1,1,0,1,1,0.009637,4,0.265506,0.27915,0
万岁(1946),万岁,notion,0,1,1,0,1,1,0.013103,4,0.272684,0.291543,0
万肯(1946),万肯,notion,0,1,1,0,1,1,0.018893,4,0.282798,0.307938,0
万邦(1946),万邦,notion,0,1,1,0,1,1,0.017626,4,0.281496,0.305894,0
万里(1946),万里,notion,0,1,1,0,1,1,0.004237,4,0.256206,0.26206,0
三个(1946),三个,notion,0,5,5,0,7,7,0.062459,4,0.361277,0.404244,20018.848004
三五(1946),三五,notion,0,1,1,0,1,1,0.018893,4,0.282798,0.307938,0
三傑(1946),三傑,notion,0,1,1,0,1,1,0.017626,4,0.281496,0.305894,0
三八(1946),三八,notion,0,1,1,0,1,1,0.013378,4,0.272039,0.290456,0
三八节(1946),三八节,notion,0,1,1,0,1,1,0.018893,4,0.282798,0.307938,0
三十一日(1946),三十一日,notion,0,1,1,0,1,1,0.013103,4,0.272684,0.291543,0
三十五周年(1946),三十五周年,notion,0,1,1,0,1,1,0.004479,4,0.256686,0.262973,0
三反(1946),三反,notion,0,1,1,0,1,1,0.013634,4,0.273332,0.292631,0
三句话(1946),三句话,notion,0,1,1,0,1,1,0.009637,4,0.265506,0.27915,0
三国(1946),三国,notion,0,1,1,0,1,1,0.013103,4,0.272684,0.291543,0
三大(1946),三大,notion,0,1,1,0,1,1,0.017626,4,0.281496,0.305894,0
三天(1946),三天,notion,0,2,2,0,2,2,0.03126,4,0.304035,0.338885,2199.499867
三峡(1946),三峡,notion,0,1,1,0,1,1,0.004577,4,0.257676,0.264843,0
三幅(1946),三幅,notion,0,1,1,0,1,1,0.013634,4,0.273332,0.292631,0
三强(1946),三强,notion,0,3,3,0,5,5,0.040127,4,0.318416,0.357526,4702.14063
三征(1946),三征,notion,0,1,1,0,1,1,0.00826,4,0.264992,0.278237,0
三思(1946),三思,notion,0,1,1,0,1,1,0.013634,4,0.273332,0.292631,0
三才(1946),三才,notion,0,1,1,0,1,1,0.003608,4,0.255568,0.260842,0
三民主义(1946),三民主义,notion,0,4,4,0,6,6,0.042682,4,0.321083,0.36086,9568.127446
三点(1946),三点,notion,0,1,1,0,1,1,0.005304,4,0.259537,0.268322,0
三片(1946),三片,notion,0,1,1,0,1,1,0.013378,4,0.272039,0.290456,0
三病(1946),三病,notion,0,1,1,0,1,1,0.017626,4,0.281496,0.305894,0
三百(1946),三百,notion,0,2,2,0,2,2,0.016711,4,0.277341,0.299313,944.999925
三种(1946),三种,notion,0,3,3,0,4,4,0.023417,4,0.287695,0.315606,3485.590991
三轮(1946),三轮,notion,0,1,1,0,1,1,0.013634,4,0.273332,0.292631,0
三轮车(1946),三轮车,notion,0,1,1,0,1,1,0.004577,4,0.257676,0.264843,0
三项(1946),三项,notion,0,1,1,0,1,1,0.005304,4,0.259537,0.268322,0
上争(1946),上争,notion,0,1,1,0,1,1,0.013378,4,0.272039,0.290456,0
上南(1946),上南,notion,0,1,1,0,1,1,0.005304,4,0.259537,0.268322,0
上台(1946),上台,notion,0,1,1,0,1,1,0.018893,4,0.282798,0.307938,0
上场(1946),上场,notion,0,1,1,0,1,1,0.013103,4,0.272684,0.291543,0
上官(1946),上官,notion,0,1,1,0,1,1,0.00826,4,0.264992,0.278237,0
上当(1946),上当,notion,0,1,1,0,1,1,0.018893,4,0.282798,0.307938,0
上期(1946),上期,notion,0,2,2,0,2,2,0.015099,4,0.271653,0.289877,456.530119
上次(1946),上次,notion,0,1,1,0,1,1,0.009637,4,0.265506,0.27915,0
上海市(1946),上海市,notion,0,2,2,0,2,2,0.027011,4,0.292079,0.322056,1114.922273
上演(1946),上演,notion,0,1,1,0,1,1,0.013103,4,0.272684,0.291543,0
上课(1946),上课,notion,0,1,1,0,1,1,0.013634,4,0.273332,0.292631,0
下乡(1946),下乡,notion,0,1,1,0,1,1,0.00826,4,0.264992,0.278237,0
下关(1946),下关,notion,0,3,3,0,6,6,0.032473,4,0.297614,0.330086,2243.405035
下去(1946),下去,notion,0,5,5,0,7,7,0.052253,4,0.329701,0.371108,10909.41266
下台(1946),下台,notion,0,1,1,0,1,1,0.018893,4,0.282798,0.307938,0
下场(1946),下场,notion,0,1,1,0,1,1,0.013103,4,0.272684,0.291543,0
下学期(1946),下学期,notion,0,1,1,0,1,1,0.017626,4,0.281496,0.305894,0
下山(1946),下山,notion,0,1,1,0,1,1,0.017626,4,0.281496,0.305894,0
下期(1946),下期,notion,0,1,1,0,2,2,0.009637,4,0.265506,0.27915,0
下面(1946),下面,notion,0,2,2,0,2,2,0.016478,4,0.275375,0.296095,554.656682
不了(1946),不了,notion,0,1,1,0,2,2,0.013378,4,0.272039,0.290456,0
不仅(1946),不仅,notion,0,1,1,0,1,1,0.013103,4,0.272684,0.291543,0
不会(1946),不会,notion,0,3,3,0,4,4,0.033639,4,0.301452,0.335435,3196.708035
不住(1946),不住,notion,0,1,1,0,1,1,0.013378,4,0.272039,0.290456,0
不像(1946),不像,notion,0,1,1,0,1,1,0.00826,4,0.264992,0.278237,0
不再(1946),不再,notion,0,1,1,0,2,2,0.018893,4,0.282798,0.307938,0
不准(1946),不准,notion,0,1,1,0,1,1,0.018893,4,0.282798,0.307938,0
不出(1946),不出,notion,0,1,1,0,1,1,0.007159,4,0.261235,0.271453,0
不利(1946),不利,notion,0,1,1,0,1,1,0.013378,4,0.272039,0.290456,0
不利于(1946),不利于,notion,0,1,1,0,1,1,0.013634,4,0.273332,0.292631,0
不到(1946),不到,notion,0,1,1,0,1,1,0.0031,4,0.254504,0.258799,0
不变(1946),不变,notion,0,1,1,0,1,1,0.018893,4,0.282798,0.307938,0
不可(1946),不可,notion,0,2,2,0,3,3,0.031004,4,0.302277,0.336493,1833.728143
不可不(1946),不可不,notion,0,1,1,0,1,1,0.009637,4,0.265506,0.27915,0
不吃(1946),不吃,notion,0,1,1,0,1,1,0.013634,4,0.273332,0.292631,0
不同(1946),不同,notion,0,1,1,0,1,1,0.013103,4,0.272684,0.291543,0
不名誉(1946),不名誉,notion,0,1,1,0,1,1,0.018893,4,0.282798,0.307938,0
不堪回首(1946),不堪回首,notion,0,1,1,0,1,1,0.007159,4,0.261235,0.271453,0
不外将(1946),不外将,notion,0,1,1,0,1,1,0.009637,4,0.265506,0.27915,0
不好(1946),不好,notion,0,1,1,0,1,1,0.018893,4,0.282798,0.307938,0
不如(1946),不如,notion,0,3,3,0,3,3,0.046157,4,0.327001,0.367832,5132.843559
不如意(1946),不如意,notion,0,1,1,0,1,1,0.00826,4,0.264992,0.278237,0
不妨(1946),不妨,notion,0,1,1,0,1,1,0.018893,4,0.282798,0.307938,0
不婚(1946),不婚,notion,0,1,1,0,1,1,0.017626,4,0.281496,0.305894,0
不安(1946),不安,notion,0,1,1,0,1,1,0.0031,4,0.254504,0.258799,0
不宜(1946),不宜,notion,0,1,1,0,1,1,0.018893,4,0.282798,0.307938,0
不容(1946),不容,notion,0,1,1,0,1,1,0.013634,4,0.273332,0.292631,0
不屈(1946),不屈,notion,0,1,1,0,1,1,0.018893,4,0.282798,0.307938,0
不平(1946),不平,notion,0,1,1,0,1,1,0.004479,4,0.256686,0.262973,0
不幸(1946),不幸,notion,0,3,3,0,3,3,0.040531,4,0.315723,0.354178,4919.220408
不应(1946),不应,notion,0,2,2,0,2,2,0.013564,4,0.274324,0.294356,2085.288442
不当(1946),不当,notion,0,1,1,0,1,1,0.009637,4,0.265506,0.27915,0
不得不(1946),不得不,notion,0,1,1,0,1,1,0.018893,4,0.282798,0.307938,0
不得已(1946),不得已,notion,0,1,1,0,1,1,0.013634,4,0.273332,0.292631,0
不得要领(1946),不得要领,notion,0,1,1,0,1,1,0.00826,4,0.264992,0.278237,0
不必(1946),不必,notion,0,1,1,0,1,1,0.009637,4,0.265506,0.27915,0
不愿(1946),不愿,notion,0,1,1,0,1,1,0.013634,4,0.273332,0.292631,0
不是(1946),不是,notion,0,6,6,0,8,8,0.080327,4,0.381259,0.42245,20337.936551
不死(1946),不死,notion,0,4,4,0,5,5,0.053063,4,0.330573,0.372036,6879.26762
不法(1946),不法,notion,0,1,1,0,1,1,0.013634,4,0.273332,0.292631,0
不由(1946),不由,notion,0,1,1,0,1,1,0.013378,4,0.272039,0.290456,0
不祥(1946),不祥,notion,0,1,1,0,1,1,0.009637,4,0.265506,0.27915,0
不管(1946),不管,notion,0,1,1,0,1,1,0.018893,4,0.282798,0.307938,0
不肖(1946),不肖,notion,0,1,1,0,1,1,0.018893,4,0.282798,0.307938,0
不肯(1946),不肯,notion,0,1,1,0,1,1,0.018893,4,0.282798,0.307938,0
不能(1946),不能,notion,0,7,7,0,12,12,0.07919,4,0.379397,0.420914,26459.714948
不要(1946),不要,notion,0,9,9,0,17,17,0.102971,4,0.427976,0.458457,47201.507894
不见(1946),不见,notion,0,1,1,0,1,1,0.018893,4,0.282798,0.307938,0
不让(1946),不让,notion,0,1,1,0,1,1,0.005461,4,0.25793,0.265322,0
不许(1946),不许,notion,0,2,2,0,2,2,0.02853,4,0.295746,0.327361,1236.887723
不该(1946),不该,notion,0,1,1,0,1,1,0.018893,4,0.282798,0.307938,0
不负责任(1946),不负责任,notion,0,1,1,0,1,1,0.0031,4,0.254504,0.258799,0
不过(1946),不过,notion,0,1,1,0,1,1,0.00826,4,0.264992,0.278237,0
不通(1946),不通,notion,0,1,1,0,1,1,0.013378,4,0.272039,0.290456,0
不问(1946),不问,notion,0,2,2,0,2,2,0.019095,4,0.279064,0.302096,590.998645
不顾(1946),不顾,notion,0,1,1,0,1,1,0.004577,4,0.257676,0.264843,0
与其(1946),与其,notion,0,1,1,0,1,1,0.004479,4,0.256686,0.262973,0
与动(1946),与动,notion,0,1,1,0,1,1,0.004577,4,0.257676,0.264843,0
与民(1946),与民,notion,0,1,1,0,1,1,0.009637,4,0.265506,0.27915,0
与民死(1946),与民死,notion,0,1,1,0,1,1,0.018893,4,0.282798,0.307938,0
与物(1946),与物,notion,0,2,2,0,2,2,0.014214,4,0.272194,0.29079,872.497436
与送(1946),与送,notion,0,1,1,0,1,1,0.013634,4,0.273332,0.292631,0
丐尊(1946),丐尊,notion,0,1,1,0,1,1,0.013634,4,0.273332,0.292631,0
丑恶(1946),丑恶,notion,0,1,1,0,1,1,0.009637,4,0.265506,0.27915,0
丑行(1946),丑行,notion,0,1,1,0,1,1,0.007159,4,0.261235,0.271453,0
丑表功(1946),丑表功,notion,0,2,2,0,2,2,0.032527,4,0.303393,0.338015,1614.891208
专制(1946),专制,notion,0,2,2,0,2,2,0.017941,4,0.27702,0.298791,611.724515
专家(1946),专家,notion,0,1,1,0,1,1,0.013378,4,0.272039,0.290456,0
专政(1946),专政,notion,0,1,1,0,1,1,0.018893,4,0.282798,0.307938,0
专访(1946),专访,notion,0,1,1,0,1,1,0.013634,4,0.273332,0.292631,0
专轮(1946),专轮,notion,0,1,1,0,1,1,0.013634,4,0.273332,0.292631,0
专页(1946),专页,notion,0,1,1,0,1,1,0.017626,4,0.281496,0.305894,0
专题(1946),专题,notion,0,1,1,0,3,3,0.005304,4,0.259537,0.268322,0
世局(1946),世局,notion,0,2,2,0,2,2,0.020727,4,0.284759,0.311054,789.620977
世界大战(1946),世界大战,notion,0,1,1,0,1,1,0.018893,4,0.282798,0.307938,0
世界性(1946),世界性,notion,0,1,1,0,1,1,0.013103,4,0.272684,0.291543,0
世界语(1946),世界语,notion,0,1,1,0,1,1,0.003608,4,0.255568,0.260842,0
世纪(1946),世纪,notion,0,2,2,0,3,3,0.031996,4,0.303907,0.338711,1883.718005
业务(1946),业务,notion,0,2,2,0,3,3,0.022931,4,0.290456,0.319664,2102.663893
业已(1946),业已,notion,0,1,1,0,1,1,0.007159,4,0.261235,0.271453,0
业里(1946),业里,notion,0,1,1,0,1,1,0.00826,4,0.264992,0.278237,0
丛书(1946),丛书,notion,0,1,1,0,1,1,0.017626,4,0.281496,0.305894,0
丛谈(1946),丛谈,notion,0,1,1,0,1,1,0.013103,4,0.272684,0.291543,0
东九省(1946),东九省,notion,0,1,1,0,1,1,0.013634,4,0.273332,0.292631,0
东亚(1946),东亚,notion,0,1,1,0,1,1,0.013103,4,0.272684,0.291543,0
东京(1946),东京,notion,0,3,3,0,3,3,0.016215,4,0.273671,0.293341,1952.154448
东京国际(1946),东京国际,notion,0,1,1,0,1,1,0.013103,4,0.272684,0.291543,0
东北民主联军(1946),东北民主联军,notion,0,1,1,0,1,1,0.001496,4,0.252204,0.25432,0
东印(1946),东印,notion,0,1,1,0,1,1,0.005461,4,0.25793,0.265322,0
东方(1946),东方,notion,0,1,1,0,1,1,0.018893,4,0.282798,0.307938,0
东江(1946),东江,notion,0,2,2,0,4,4,0.011868,4,0.270274,0.287528,1315.392171
东江纵队(1946),东江纵队,notion,0,2,2,0,2,2,0.025886,4,0.296968,0.329101,2935.752997
东胜(1946),东胜,notion,0,1,1,0,1,1,0.017626,4,0.281496,0.305894,0
东西(1946),东西,notion,0,2,2,0,2,2,0.017615,4,0.276807,0.298443,528.122
两个(1946),两个,notion,0,12,12,0,14,14,0.121256,4,0.466223,0.482635,78087.661404
两使(1946),两使,notion,0,1,1,0,1,1,0.017626,4,0.281496,0.305894,0
两则(1946),两则,notion,0,2,2,0,3,3,0.014942,4,0.274717,0.295008,1559.497175
两周年(1946),两周年,notion,0,1,1,0,1,1,0.013378,4,0.272039,0.290456,0
两国(1946),两国,notion,0,1,1,0,2,2,0.013103,4,0.272684,0.291543,0
两幅(1946),两幅,notion,0,1,1,0,1,1,0.018893,4,0.282798,0.307938,0
两年(1946),两年,notion,0,2,2,0,2,2,0.032271,4,0.301168,0.334971,1271.496707
两报(1946),两报,notion,0,1,1,0,1,1,0.00826,4,0.264992,0.278237,0
两方(1946),两方,notion,0,1,1,0,1,1,0.009637,4,0.265506,0.27915,0
两月来(1946),两月来,notion,0,1,1,0,1,1,0.013378,4,0.272039,0.290456,0
两条路(1946),两条路,notion,0,1,1,0,1,1,0.013103,4,0.272684,0.291543,0
两条路线(1946),两条路线,notion,0,1,1,0,1,1,0.004479,4,0.256686,0.262973,0
两条道路(1946),两条道路,notion,0,1,1,0,1,1,0.013634,4,0.273332,0.292631,0
两次(1946),两次,notion,0,3,3,0,3,3,0.03096,4,0.298076,0.330739,2935.467671
两派(1946),两派,notion,0,1,1,0,1,1,0.013378,4,0.272039,0.290456,0
两点(1946),两点,notion,0,1,1,0,2,2,0.005304,4,0.259537,0.268322,0
两种(1946),两种,notion,0,3,3,0,3,3,0.041824,4,0.323942,0.364223,6881.110907
两童(1946),两童,notion,0,1,1,0,1,1,0.013378,4,0.272039,0.290456,0
两重(1946),两重,notion,0,1,1,0,1,1,0.009637,4,0.265506,0.27915,0
两阳(1946),两阳,notion,0,1,1,0,1,1,0.00826,4,0.264992,0.278237,0
两院制(1946),两院制,notion,0,1,1,0,1,1,0.013634,4,0.273332,0.292631,0
两面(1946),两面,notion,0,3,3,0,4,4,0.03679,4,0.310237,0.347176,4984.205015
严加(1946),严加,notion,0,1,1,0,2,2,0.013634,4,0.273332,0.292631,0
严密(1946),严密,notion,0,1,1,0,1,1,0.018893,4,0.282798,0.307938,0
严案(1946),严案,notion,0,1,1,0,1,1,0.018893,4,0.282798,0.307938,0
严肃(1946),严肃,notion,0,1,1,0,1,1,0.005304,4,0.259537,0.268322,0
严重(1946),严重,notion,0,9,9,0,17,17,0.087843,4,0.387321,0.427799,33380.436656
严重局面(1946),严重局面,notion,0,1,1,0,1,1,0.009637,4,0.265506,0.27915,0
严防(1946),严防,notion,0,1,1,0,1,1,0.017626,4,0.281496,0.305894,0
丧失(1946),丧失,notion,0,1,1,0,1,1,0.013634,4,0.273332,0.292631,0
丧钟(1946),丧钟,notion,0,1,1,0,1,1,0.009637,4,0.265506,0.27915,0
个人主义(1946),个人主义,notion,0,1,1,0,1,1,0.013634,4,0.273332,0.292631,0
个己(1946),个己,notion,0,1,1,0,1,1,0.004577,4,0.257676,0.264843,0
个性(1946),个性,notion,0,2,2,0,2,2,0.013721,4,0.272039,0.290529,811.384126
中三补(1946),中三补,notion,0,1,1,0,1,1,0.009637,4,0.265506,0.27915,0
中东(1946),中东,notion,0,1,1,0,1,1,0.013103,4,0.272684,0.291543,0
中之权(1946),中之权,notion,0,2,2,0,2,2,0.009698,4,0.262356,0.273569,160.636246
中共(1946),中共,notion,0,4,4,0,6,6,0.032844,4,0.305003,0.340335,6726.137385
中华(1946),中华,notion,0,1,1,0,1,1,0.018893,4,0.282798,0.307938,0
中华全国(1946),中华全国,notion,0,1,1,0,1,1,0.004564,4,0.256755,0.263104,0
中华民族(1946),中华民族,notion,0,1,1,0,1,1,0.018893,4,0.282798,0.307938,0
中原(1946),中原,notion,0,4,4,0,6,6,0.037919,4,0.310539,0.34764,7265.729115
中原军区(1946),中原军区,notion,0,1,1,0,1,1,0.018893,4,0.282798,0.307938,0
中去(1946),中去,notion,0,1,1,0,1,1,0.00826,4,0.264992,0.278237,0
中周(1946),中周,notion,0,2,2,0,6,6,0.031004,4,0.302277,0.336493,1833.728143
中国人(1946),中国人,notion,0,6,6,0,8,8,0.076354,4,0.379748,0.421146,23545.0343
中国农工民主党(1946),中国农工民主党,notion,0,1,1,0,1,1,0.004564,4,0.256755,0.263104,0
中国政府(1946),中国政府,notion,0,1,1,0,1,1,0.009637,4,0.265506,0.27915,0
中国民主促进会(1946),中国民主促进会,notion,0,1,1,0,1,1,0.013634,4,0.273332,0.292631,0
中国通(1946),中国通,notion,0,1,1,0,1,1,0.013634,4,0.273332,0.292631,0
中外(1946),中外,notion,0,4,4,0,4,4,0.034613,4,0.301011,0.334899,3815.776459
中大(1946),中大,notion,0,1,1,0,1,1,0.004577,4,0.257676,0.264843,0
中央(1946),中央,notion,0,2,2,0,2,2,0.021234,4,0.286205,0.313272,1214.025388
中央大学(1946),中央大学,notion,0,1,1,0,1,1,0.009637,4,0.265506,0.27915,0
中央日报(1946),中央日报,notion,0,1,1,0,1,1,0.005461,4,0.25793,0.265322,0
中央社(1946),中央社,notion,0,2,2,0,2,2,0.020389,4,0.284308,0.310358,712.812748
中央集权(1946),中央集权,notion,0,1,1,0,1,1,0.005461,4,0.25793,0.265322,0
中学(1946),中学,notion,0,4,4,0,4,4,0.048982,4,0.33372,0.375602,10566.507638
中学校长(1946),中学校长,notion,0,1,1,0,1,1,0.018893,4,0.282798,0.307938,0
中小(1946),中小,notion,0,2,2,0,2,2,0.026052,4,0.291576,0.321317,1054.556401
中层阶级(1946),中层阶级,notion,0,1,1,0,1,1,0.013634,4,0.273332,0.292631,0
中山公园(1946),中山公园,notion,0,2,2,0,2,2,0.032527,4,0.303393,0.338015,1614.891208
中心(1946),中心,notion,0,3,3,0,6,6,0.044363,4,0.326555,0.36731,6261.172064
中日(1946),中日,notion,0,2,2,0,2,2,0.020262,4,0.282243,0.30714,1027.722249
中旬(1946),中旬,notion,0,1,1,0,1,1,0.004577,4,0.257676,0.264843,0
中枢(1946),中枢,notion,0,1,1,0,1,1,0.009637,4,0.265506,0.27915,0
中正(1946),中正,notion,0,1,1,0,1,1,0.017626,4,0.281496,0.305894,0
中求(1946),中求,notion,0,1,1,0,1,1,0.005304,4,0.259537,0.268322,0
中的(1946),中的,notion,0,1,1,0,1,1,0.018893,4,0.282798,0.307938,0
中秋(1946),中秋,notion,0,1,1,0,1,1,0.00826,4,0.264992,0.278237,0
中立地带(1946),中立地带,notion,0,1,1,0,1,1,0.017626,4,0.281496,0.305894,0
中等学校(1946),中等学校,notion,0,1,1,0,1,1,0.017626,4,0.281496,0.305894,0
中等教育(1946),中等教育,notion,0,1,1,0,2,2,0.007159,4,0.261235,0.271453,0
中美(1946),中美,notion,0,1,1,0,2,2,0.013378,4,0.272039,0.290456,0
中美合作(1946),中美合作,notion,0,2,2,0,2,2,0.020536,4,0.280891,0.30501,760.639997
中美新(1946),中美新,notion,0,1,1,0,1,1,0.00826,4,0.264992,0.278237,0
中苏(1946),中苏,notion,0,3,3,0,3,3,0.045904,4,0.321478,0.361266,4001.310187
中英关系(1946),中英关系,notion,0,1,1,0,1,1,0.018893,4,0.282798,0.307938,0
中补(1946),中补,notion,0,1,1,0,1,1,0.009637,4,0.265506,0.27915,0
中译本(1946),中译本,notion,0,1,1,0,1,1,0.013103,4,0.272684,0.291543,0
中间(1946),中间,notion,0,1,1,0,1,1,0.00826,4,0.264992,0.278237,0
中间性(1946),中间性,notion,0,2,2,0,2,2,0.02853,4,0.295746,0.327361,1236.887723
中间派(1946),中间派,notion,0,1,1,0,1,1,0.0031,4,0.254504,0.258799,0
丰富(1946),丰富,notion,0,1,1,0,2,2,0.005304,4,0.259537,0.268322,0
临沂(1946),临沂,notion,0,1,1,0,2,2,0.018893,4,0.282798,0.307938,0
丹麦(1946),丹麦,notion,0,1,1,0,1,1,0.017626,4,0.281496,0.305894,0
为了(1946),为了,notion,0,4,4,0,4,4,0.053889,4,0.342019,0.38469,11645.453176
为什(1946),为什,notion,0,1,1,0,1,1,0.017626,4,0.281496,0.305894,0
为何(1946),为何,notion,0,1,1,0,1,1,0.005461,4,0.25793,0.265322,0
为止(1946),为止,notion,0,1,1,0,1,1,0.018893,4,0.282798,0.307938,0
为闻氏(1946),为闻氏,notion,0,1,1,0,1,1,0.013634,4,0.273332,0.292631,0
主义者(1946),主义者,notion,0,1,1,0,1,1,0.013103,4,0.272684,0.291543,0
主人(1946),主人,notion,0,2,2,0,2,2,0.026737,4,0.295411,0.326883,1969.400217
主人翁(1946),主人翁,notion,0,1,1,0,1,1,0.017626,4,0.281496,0.305894,0
主任(1946),主任,notion,0,2,2,0,2,2,0.027153,4,0.296784,0.32884,1981.441549
主力(1946),主力,notion,0,1,1,0,1,1,0.013103,4,0.272684,0.291543,0
主动(1946),主动,notion,0,2,2,0,2,2,0.024197,4,0.292198,0.32223,2288.2854
主奴(1946),主奴,notion,0,1,1,0,1,1,0.013103,4,0.272684,0.291543,0
主张(1946),主张,notion,0,8,8,0,14,14,0.087141,4,0.389261,0.429336,27881.66231
主权(1946),主权,notion,0,6,6,0,9,9,0.074927,4,0.371071,0.413449,17915.992231
主流(1946),主流,notion,0,1,1,0,1,1,0.004564,4,0.256755,0.263104,0
主编(1946),主编,notion,0,1,1,0,2,2,0.017626,4,0.281496,0.305894,0
主要(1946),主要,notion,0,1,1,0,2,2,0.018893,4,0.282798,0.307938,0
主题(1946),主题,notion,0,1,1,0,1,1,0.013103,4,0.272684,0.291543,0
举世(1946),举世,notion,0,1,1,0,1,1,0.017626,4,0.281496,0.305894,0
举国一致(1946),举国一致,notion,0,1,1,0,1,1,0.017626,4,0.281496,0.305894,0
举火(1946),举火,notion,0,1,1,0,1,1,0.013634,4,0.273332,0.292631,0
举行(1946),举行,notion,0,3,3,0,3,3,0.036309,4,0.311514,0.348829,5497.49157
举隅(1946),举隅,notion,0,1,1,0,1,1,0.018893,4,0.282798,0.307938,0
义大利(1946),义大利,notion,0,2,2,0,3,3,0.027264,4,0.294896,0.326144,1405.794223
义愤(1946),义愤,notion,0,1,1,0,1,1,0.013378,4,0.272039,0.290456,0
义民(1946),义民,notion,0,1,1,0,1,1,0.018893,4,0.282798,0.307938,0
义舞(1946),义舞,notion,0,1,1,0,1,1,0.013634,4,0.273332,0.292631,0
之七(1946),之七,notion,0,1,1,0,1,1,0.013378,4,0.272039,0.290456,0
之下(1946),之下,notion,0,2,2,0,3,3,0.027011,4,0.292079,0.322056,1114.922273
之中(1946),之中,notion,0,1,1,0,1,1,0.009637,4,0.265506,0.27915,0
之久(1946),之久,notion,0,1,1,0,1,1,0.007159,4,0.261235,0.271453,0
之争(1946),之争,notion,0,3,3,0,4,4,0.045374,4,0.322561,0.36257,4563.560502
之五(1946),之五,notion,0,3,3,0,4,4,0.039264,4,0.317958,0.356961,6435.763293
之作(1946),之作,notion,0,1,1,0,1,1,0.004577,4,0.257676,0.264843,0
之例(1946),之例,notion,0,1,1,0,1,1,0.00826,4,0.264992,0.278237,0
之光(1946),之光,notion,0,1,1,0,1,1,0.018893,4,0.282798,0.307938,0
之八(1946),之八,notion,0,1,1,0,1,1,0.013378,4,0.272039,0.290456,0
之六(1946),之六,notion,0,2,2,0,2,2,0.031004,4,0.302277,0.336493,1833.728143
之关(1946),之关,notion,0,1,1,0,1,1,0.017626,4,0.281496,0.305894,0
之冬(1946),之冬,notion,0,1,1,0,1,1,0.017626,4,0.281496,0.305894,0
之分(1946),之分,notion,0,1,1,0,1,1,0.013103,4,0.272684,0.291543,0
之前(1946),之前,notion,0,4,4,0,4,4,0.046938,4,0.326889,0.367774,9859.311356
之史(1946),之史,notion,0,2,2,0,3,3,0.031996,4,0.303907,0.338711,1883.718005
之后(1946),之后,notion,0,4,4,0,6,6,0.047273,4,0.322814,0.362947,7343.791559
之四(1946),之四,notion,0,4,4,0,5,5,0.044981,4,0.325889,0.3666,9470.519726
之因(1946),之因,notion,0,1,1,0,1,1,0.0031,4,0.254504,0.258799,0
之围(1946),之围,notion,0,1,1,0,1,1,0.018893,4,0.282798,0.307938,0
之城(1946),之城,notion,0,1,1,0,1,1,0.018893,4,0.282798,0.307938,0
之夏(1946),之夏,notion,0,1,1,0,1,1,0.017626,4,0.281496,0.305894,0
之外(1946),之外,notion,0,1,1,0,1,1,0.018893,4,0.282798,0.307938,0
之夜(1946),之夜,notion,0,1,1,0,1,1,0.004564,4,0.256755,0.263104,0
之妻(1946),之妻,notion,0,1,1,0,1,1,0.013634,4,0.273332,0.292631,0
之家(1946),之家,notion,0,1,1,0,1,1,0.017626,4,0.281496,0.305894,0
之局(1946),之局,notion,0,1,1,0,1,1,0.009637,4,0.265506,0.27915,0
之年(1946),之年,notion,0,1,1,0,1,1,0.013378,4,0.272039,0.290456,0
之役(1946),之役,notion,0,1,1,0,1,1,0.017626,4,0.281496,0.305894,0
之恋(1946),之恋,notion,0,2,2,0,2,2,0.02347,4,0.289958,0.318925,1721.315005
之患(1946),之患,notion,0,1,1,0,1,1,0.00826,4,0.264992,0.278237,0
之接(1946),之接,notion,0,1,1,0,1,1,0.013634,4,0.273332,0.292631,0
之时(1946),之时,notion,0,1,1,0,1,1,0.004479,4,0.256686,0.262973,0
之春(1946),之春,notion,0,3,3,0,3,3,0.044363,4,0.326555,0.36731,6261.172064
之本(1946),之本,notion,0,1,1,0,1,1,0.018893,4,0.282798,0.307938,0
之术(1946),之术,notion,0,1,1,0,1,1,0.018893,4,0.282798,0.307938,0
之歌(1946),之歌,notion,0,1,1,0,3,3,0.018893,4,0.282798,0.307938,0
之正(1946),之正,notion,0,1,1,0,1,1,0.017626,4,0.281496,0.305894,0
之死(1946),之死,notion,0,3,3,0,5,5,0.050153,4,0.336337,0.378443,6304.552689
之母(1946),之母,notion,0,1,1,0,1,1,0.007159,4,0.261235,0.271453,0
之洋(1946),之洋,notion,0,1,1,0,1,1,0.005304,4,0.259537,0.268322,0
之流(1946),之流,notion,0,1,1,0,1,1,0.005461,4,0.25793,0.265322,0
之父(1946),之父,notion,0,1,1,0,1,1,0.013103,4,0.272684,0.291543,0
之狱(1946),之狱,notion,0,1,1,0,1,1,0.018893,4,0.282798,0.307938,0
之献(1946),之献,notion,0,1,1,0,1,1,0.013378,4,0.272039,0.290456,0
之类(1946),之类,notion,0,1,1,0,1,1,0.013378,4,0.272039,0.290456,0
之舞(1946),之舞,notion,0,1,1,0,1,1,0.018893,4,0.282798,0.307938,0
之葬(1946),之葬,notion,0,1,1,0,1,1,0.013378,4,0.272039,0.290456,0
之誓(1946),之誓,notion,0,1,1,0,1,1,0.005304,4,0.259537,0.268322,0
之谜(1946),之谜,notion,0,3,3,0,3,3,0.045374,4,0.322561,0.36257,4563.560502
之路(1946),之路,notion,0,9,9,0,9,9,0.091588,4,0.403864,0.441019,44150.813997
之逝(1946),之逝,notion,0,1,1,0,1,1,0.018893,4,0.282798,0.307938,0
之非(1946),之非,notion,0,1,1,0,1,1,0.005304,4,0.259537,0.268322,0
之风(1946),之风,notion,0,1,1,0,1,1,0.004564,4,0.256755,0.263104,0
乌云(1946),乌云,notion,0,1,1,0,1,1,0.017626,4,0.281496,0.305894,0
乌烟瘴气(1946),乌烟瘴气,notion,0,1,1,0,1,1,0.00826,4,0.264992,0.278237,0
乏味(1946),乏味,notion,0,1,1,0,1,1,0.00826,4,0.264992,0.278237,0
乐章(1946),乐章,notion,0,1,1,0,1,1,0.018893,4,0.282798,0.307938,0
乐观(1946),乐观,notion,0,2,2,0,2,2,0.026052,4,0.291576,0.321317,1054.556401
乐长(1946),乐长,notion,0,1,1,0,1,1,0.013103,4,0.272684,0.291543,0
乘机(1946),乘机,notion,0,1,1,0,1,1,0.001496,4,0.252204,0.25432,0
九一八(1946),九一八,notion,0,2,2,0,2,2,0.021638,4,0.286262,0.313359,1666.282153
九周(1946),九周,notion,0,1,1,0,1,1,0.013103,4,0.272684,0.291543,0
九省(1946),九省,notion,0,1,1,0,1,1,0.00826,4,0.264992,0.278237,0
九种(1946),九种,notion,0,1,1,0,1,1,0.004577,4,0.257676,0.264843,0
九龙(1946),九龙,notion,0,1,1,0,1,1,0.017626,4,0.281496,0.305894,0
乞丐(1946),乞丐,notion,0,1,1,0,1,1,0.00826,4,0.264992,0.278237,0
也有(1946),也有,notion,0,1,1,0,1,1,0.009637,4,0.265506,0.27915,0
乡吟(1946),乡吟,notion,0,1,1,0,1,1,0.018893,4,0.282798,0.307938,0
乡土(1946),乡土,notion,0,1,1,0,1,1,0.009637,4,0.265506,0.27915,0
乡居(1946),乡居,notion,0,1,1,0,1,1,0.007159,4,0.261235,0.271453,0
乡政(1946),乡政,notion,0,1,1,0,1,1,0.017626,4,0.281496,0.305894,0
乡村(1946),乡村,notion,0,3,3,0,4,4,0.036565,4,0.313417,0.351264,6163.85322
乡镇(1946),乡镇,notion,0,1,1,0,1,1,0.017626,4,0.281496,0.305894,0
乡长(1946),乡长,notion,0,1,1,0,1,1,0.0031,4,0.254504,0.258799,0
书报摊(1946),书报摊,notion,0,1,1,0,1,1,0.018893,4,0.282798,0.307938,0
书法(1946),书法,notion,0,1,1,0,2,2,0.013634,4,0.273332,0.292631,0
书目(1946),书目,notion,0,1,1,0,1,1,0.013103,4,0.272684,0.291543,0
书记(1946),书记,notion,0,1,1,0,1,1,0.013634,4,0.273332,0.292631,0
书评(1946),书评,notion,0,2,2,0,3,3,0.017955,4,0.278848,0.301748,1157.770247
买空卖空(1946),买空卖空,notion,0,1,1,0,1,1,0.017626,4,0.281496,0.305894,0
乱世(1946),乱世,notion,0,1,1,0,1,1,0.005304,4,0.259537,0.268322,0
乱离(1946),乱离,notion,0,1,1,0,1,1,0.013634,4,0.273332,0.292631,0
乱纷纷(1946),乱纷纷,notion,0,1,1,0,1,1,0.00826,4,0.264992,0.278237,0
了什(1946),了什,notion,0,1,1,0,1,1,0.004577,4,0.257676,0.264843,0
了结(1946),了结,notion,0,1,1,0,1,1,0.018893,4,0.282798,0.307938,0
了解(1946),了解,notion,0,1,1,0,1,1,0.005304,4,0.259537,0.268322,0
了首(1946),了首,notion,0,1,1,0,1,1,0.009637,4,0.265506,0.27915,0
争取(1946),争取,notion,0,8,8,0,19,19,0.098734,4,0.422379,0.454514,42203.650797
争取和平(1946),争取和平,notion,0,2,2,0,3,3,0.022501,4,0.28712,0.314663,997.953629
争执(1946),争执,notion,0,3,3,0,3,3,0.034741,4,0.307812,0.344002,5249.921704
争议(1946),争议,notion,0,1,1,0,1,1,0.018893,4,0.282798,0.307938,0
争霸(1946),争霸,notion,0,1,1,0,1,1,0.009637,4,0.265506,0.27915,0
争鸣(1946),争鸣,notion,0,1,1,0,1,1,0.007159,4,0.261235,0.271453,0
事务(1946),事务,notion,0,1,1,0,1,1,0.005304,4,0.259537,0.268322,0
事变(1946),事变,notion,0,1,1,0,1,1,0.013634,4,0.273332,0.292631,0
事实(1946),事实,notion,0,4,4,0,6,6,0.053634,4,0.338236,0.380602,10386.577965
事情(1946),事情,notion,0,2,2,0,2,2,0.026737,4,0.295411,0.326883,1969.400217
事物(1946),事物,notion,0,1,1,0,1,1,0.005304,4,0.259537,0.268322,0
二一○(1946),二一○,notion,0,1,1,0,1,1,0.004237,4,0.256206,0.26206,0
二三(1946),二三,notion,0,5,5,0,7,7,0.067267,4,0.361777,0.404723,17106.500098
二中全会(1946),二中全会,notion,0,4,4,0,4,4,0.055542,4,0.334887,0.376906,7366.316748
二九(1946),二九,notion,0,1,1,0,1,1,0.017626,4,0.281496,0.305894,0
二五(1946),二五,notion,0,2,2,0,3,3,0.024785,4,0.291398,0.321056,1410.74284
二伦(1946),二伦,notion,0,1,1,0,1,1,0.017626,4,0.281496,0.305894,0
二十一(1946),二十一,notion,0,1,1,0,1,1,0.004577,4,0.257676,0.264843,0
二十一条(1946),二十一条,notion,0,1,1,0,1,1,0.004479,4,0.256686,0.262973,0
二十三(1946),二十三,notion,0,1,1,0,1,1,0.013634,4,0.273332,0.292631,0
二十世纪(1946),二十世纪,notion,0,1,1,0,1,1,0.013103,4,0.272684,0.291543,0
二十二(1946),二十二,notion,0,1,1,0,1,1,0.013103,4,0.272684,0.291543,0
二十五(1946),二十五,notion,0,1,1,0,1,1,0.00826,4,0.264992,0.278237,0
二十八(1946),二十八,notion,0,1,1,0,1,1,0.013103,4,0.272684,0.291543,0
二十年(1946),二十年,notion,0,1,1,0,1,1,0.005304,4,0.259537,0.268322,0
二幅(1946),二幅,notion,0,1,1,0,1,1,0.013634,4,0.273332,0.292631,0
二年级(1946),二年级,notion,0,1,1,0,1,1,0.017626,4,0.281496,0.305894,0
二郎庙(1946),二郎庙,notion,0,1,1,0,1,1,0.018893,4,0.282798,0.307938,0
于诸公(1946),于诸公,notion,0,1,1,0,1,1,0.009637,4,0.265506,0.27915,0
于金陵(1946),于金陵,notion,0,1,1,0,1,1,0.004479,4,0.256686,0.262973,0
云南(1946),云南,notion,0,1,1,0,1,1,0.0031,4,0.254504,0.258799,0
云龙山(1946),云龙山,notion,0,1,1,0,1,1,0.017626,4,0.281496,0.305894,0
互惠(1946),互惠,notion,0,1,1,0,1,1,0.004237,4,0.256206,0.26206,0
互斗(1946),互斗,notion,0,1,1,0,1,1,0.013634,4,0.273332,0.292631,0
互有(1946),互有,notion,0,1,1,0,1,1,0.00826,4,0.264992,0.278237,0
互相(1946),互相,notion,0,1,1,0,1,1,0.009637,4,0.265506,0.27915,0
互让(1946),互让,notion,0,1,1,0,1,1,0.013634,4,0.273332,0.292631,0
五一国际劳动节(1946),五一国际劳动节,notion,0,1,1,0,1,1,0.013378,4,0.272039,0.290456,0
五一节(1946),五一节,notion,0,1,1,0,1,1,0.013103,4,0.272684,0.291543,0
五万元(1946),五万元,notion,0,1,1,0,1,1,0.004577,4,0.257676,0.264843,0
五五(1946),五五,notion,0,2,2,0,2,2,0.030729,4,0.302946,0.337407,2092.27198
五人(1946),五人,notion,0,2,2,0,3,3,0.032271,4,0.301168,0.334971,1271.496707
五伦(1946),五伦,notion,0,1,1,0,1,1,0.017626,4,0.281496,0.305894,0
五十天(1946),五十天,notion,0,1,1,0,2,2,0.018893,4,0.282798,0.307938,0
五周年(1946),五周年,notion,0,1,1,0,1,1,0.013103,4,0.272684,0.291543,0
五四(1946),五四,notion,0,7,7,0,8,8,0.082866,4,0.380602,0.421957,21818.101778
五四时代(1946),五四时代,notion,0,1,1,0,1,1,0.013378,4,0.272039,0.290456,0
五四运动(1946),五四运动,notion,0,3,3,0,3,3,0.027592,4,0.291576,0.321389,2927.844705
五大(1946),五大,notion,0,1,1,0,1,1,0.018893,4,0.282798,0.307938,0
五年(1946),五年,notion,0,1,1,0,1,1,0.0031,4,0.254504,0.258799,0
五权宪法(1946),五权宪法,notion,0,1,1,0,2,2,0.017626,4,0.281496,0.305894,0
五种(1946),五种,notion,0,1,1,0,1,1,0.013634,4,0.273332,0.292631,0
五项(1946),五项,notion,0,1,1,0,1,1,0.005304,4,0.259537,0.268322,0
亚区(1946),亚区,notion,0,1,1,0,1,1,0.013103,4,0.272684,0.291543,0
亚洲(1946),亚洲,notion,0,2,2,0,4,4,0.016203,4,0.276115,0.297313,650.123339
交化(1946),交化,notion,0,1,1,0,1,1,0.003608,4,0.255568,0.260842,0
交替(1946),交替,notion,0,1,1,0,1,1,0.009637,4,0.265506,0.27915,0
交流(1946),交流,notion,0,1,1,0,1,1,0.013378,4,0.272039,0.290456,0
交迫(1946),交迫,notion,0,1,1,0,1,1,0.00826,4,0.264992,0.278237,0
交通(1946),交通,notion,0,2,2,0,3,3,0.022931,4,0.290456,0.319664,2102.663893
交通线(1946),交通线,notion,0,1,1,0,1,1,0.017626,4,0.281496,0.305894,0
亦能覆舟(1946),亦能覆舟,notion,0,1,1,0,1,1,0.017626,4,0.281496,0.305894,0
产业(1946),产业,notion,0,1,1,0,1,1,0.013634,4,0.273332,0.292631,0
产地(1946),产地,notion,0,1,1,0,1,1,0.017626,4,0.281496,0.305894,0
产生(1946),产生,notion,0,4,4,0,5,5,0.050207,4,0.333875,0.375775,10018.491692
亨利(1946),亨利,notion,0,1,1,0,1,1,0.017626,4,0.281496,0.305894,0
京华(1946),京华,notion,0,1,1,0,1,1,0.009637,4,0.265506,0.27915,0
京沪(1946),京沪,notion,0,1,1,0,1,1,0.009637,4,0.265506,0.27915,0
亲与友(1946),亲与友,notion,0,1,1,0,1,1,0.009637,4,0.265506,0.27915,0
亲历(1946),亲历,notion,0,1,1,0,1,1,0.013634,4,0.273332,0.292631,0
人为(1946),人为,notion,0,1,1,0,1,1,0.017626,4,0.281496,0.305894,0
人之云亡(1946),人之云亡,notion,0,1,1,0,1,1,0.004564,4,0.256755,0.263104,0
人事工作(1946),人事工作,notion,0,1,1,0,1,1,0.005304,4,0.259537,0.268322,0
人侮(1946),人侮,notion,0,1,1,0,1,1,0.013634,4,0.273332,0.292631,0
人力车(1946),人力车,notion,0,2,2,0,2,2,0.018211,4,0.280617,0.304575,1609.081689
人口普查(1946),人口普查,notion,0,1,1,0,1,1,0.017626,4,0.281496,0.305894,0
人员(1946),人员,notion,0,1,1,0,1,1,0.004577,4,0.257676,0.264843,0
人士(1946),人士,notion,0,2,2,0,2,2,0.020792,4,0.283021,0.308358,1062.761034
人头税(1946),人头税,notion,0,1,1,0,1,1,0.018893,4,0.282798,0.307938,0
人家(1946),人家,notion,0,1,1,0,1,1,0.013103,4,0.272684,0.291543,0
人心(1946),人心,notion,0,1,1,0,1,1,0.004577,4,0.257676,0.264843,0
人必(1946),人必,notion,0,1,1,0,1,1,0.013378,4,0.272039,0.290456,0
人性化(1946),人性化,notion,0,1,1,0,1,1,0.009637,4,0.265506,0.27915,0
人才(1946),人才,notion,0,1,1,0,1,1,0.005304,4,0.259537,0.268322,0
人教(1946),人教,notion,0,1,1,0,1,1,0.009637,4,0.265506,0.27915,0
人数(1946),人数,notion,0,1,1,0,1,1,0.009637,4,0.265506,0.27915,0
人文科学(1946),人文科学,notion,0,1,1,0,1,1,0.004577,4,0.257676,0.264843,0
人未识(1946),人未识,notion,0,1,1,0,1,1,0.013634,4,0.273332,0.292631,0
人权(1946),人权,notion,0,3,3,0,6,6,0.041908,4,0.31393,0.351916,3405.961451
人民之声(1946),人民之声,notion,0,1,1,0,1,1,0.017626,4,0.281496,0.305894,0
人民政权(1946),人民政权,notion,0,1,1,0,1,1,0.013103,4,0.272684,0.291543,0
人物志(1946),人物志,notion,0,2,2,0,2,2,0.02853,4,0.295746,0.327361,1236.887723
人的(1946),人的,notion,0,1,1,0,1,1,0.017626,4,0.281496,0.305894,0
人类(1946),人类,notion,0,4,4,0,8,8,0.054199,4,0.344025,0.386821,10813.744345
人群(1946),人群,notion,0,1,1,0,2,2,0.005304,4,0.259537,0.268322,0
人语(1946),人语,notion,0,1,1,0,1,1,0.018893,4,0.282798,0.307938,0
人身自由(1946),人身自由,notion,0,1,1,0,1,1,0.017626,4,0.281496,0.305894,0
人道(1946),人道,notion,0,2,2,0,2,2,0.019095,4,0.279064,0.302096,590.998645
人间(1946),人间,notion,0,3,3,0,3,3,0.041908,4,0.31393,0.351916,3405.961451
亿元(1946),亿元,notion,0,1,1,0,1,1,0.009637,4,0.265506,0.27915,0
什么样(1946),什么样,notion,0,1,1,0,1,1,0.00826,4,0.264992,0.278237,0
什记(1946),什记,notion,0,1,1,0,1,1,0.013378,4,0.272039,0.290456,0
仁爱(1946),仁爱,notion,0,1,1,0,1,1,0.005304,4,0.259537,0.268322,0
仅仅(1946),仅仅,notion,0,1,1,0,1,1,0.009637,4,0.265506,0.27915,0
仅可(1946),仅可,notion,0,1,1,0,1,1,0.007159,4,0.261235,0.271453,0
仇苏(1946),仇苏,notion,0,1,1,0,1,1,0.013103,4,0.272684,0.291543,0
今后(1946),今后,notion,0,7,7,0,9,9,0.079975,4,0.379197,0.42074,22375.373602
今天(1946),今天,notion,0,5,5,0,5,5,0.06126,4,0.351599,0.394721,13229.495885
今年(1946),今年,notion,0,4,4,0,6,6,0.04253,4,0.313178,0.351032,4935.905862
今昔(1946),今昔,notion,0,2,2,0,2,2,0.023015,4,0.2849,0.311272,897.577022
仍以(1946),仍以,notion,0,1,1,0,1,1,0.017626,4,0.281496,0.305894,0
仍旧(1946),仍旧,notion,0,2,2,0,2,2,0.02853,4,0.295746,0.327361,1236.887723
仍然(1946),仍然,notion,0,2,2,0,2,2,0.020536,4,0.280891,0.30501,760.639997
从事(1946),从事,notion,0,1,1,0,1,1,0.004237,4,0.256206,0.26206,0
从何而来(1946),从何而来,notion,0,1,1,0,1,1,0.013103,4,0.272684,0.291543,0
从古(1946),从古,notion,0,1,1,0,1,1,0.018893,4,0.282798,0.307938,0
从头(1946),从头,notion,0,1,1,0,1,1,0.017626,4,0.281496,0.305894,0
从头做起(1946),从头做起,notion,0,1,1,0,1,1,0.005304,4,0.259537,0.268322,0
从忧时(1946),从忧时,notion,0,1,1,0,1,1,0.00826,4,0.264992,0.278237,0
从政(1946),从政,notion,0,1,1,0,1,1,0.017626,4,0.281496,0.305894,0
从来不(1946),从来不,notion,0,1,1,0,1,1,0.013103,4,0.272684,0.291543,0
从此(1946),从此,notion,0,2,2,0,2,2,0.027153,4,0.296784,0.32884,1981.441549
从王(1946),从王,notion,0,1,1,0,1,1,0.005461,4,0.25793,0.265322,0
从警(1946),从警,notion,0,1,1,0,1,1,0.005461,4,0.25793,0.265322,0
从达(1946),从达,notion,0,1,1,0,1,1,0.013634,4,0.273332,0.292631,0
从锡(1946),从锡,notion,0,1,1,0,1,1,0.007159,4,0.261235,0.271453,0
从马帅(1946),从马帅,notion,0,1,1,0,1,1,0.007159,4,0.261235,0.271453,0
他活(1946),他活,notion,0,1,1,0,1,1,0.004479,4,0.256686,0.262973,0
付出(1946),付出,notion,0,1,1,0,1,1,0.013634,4,0.273332,0.292631,0
仙境(1946),仙境,notion,0,1,1,0,1,1,0.009637,4,0.265506,0.27915,0
代价(1946),代价,notion,0,3,3,0,3,3,0.033895,4,0.30468,0.339827,4059.883499
代劳(1946),代劳,notion,0,1,1,0,1,1,0.007159,4,0.261235,0.271453,0
代表团(1946),代表团,notion,0,1,1,0,1,1,0.003608,4,0.255568,0.260842,0
令下(1946),令下,notion,0,1,1,0,1,1,0.013634,4,0.273332,0.292631,0
令人(1946),令人,notion,0,2,2,0,2,2,0.015419,4,0.27556,0.296399,1296.225957
以不变应万变(1946),以不变应万变,notion,0,1,1,0,1,1,0.013378,4,0.272039,0.290456,0
以为(1946),以为,notion,0,1,1,0,1,1,0.003608,4,0.255568,0.260842,0
以前(1946),以前,notion,0,1,1,0,1,1,0.013378,4,0.272039,0.290456,0
以外(1946),以外,notion,0,1,1,0,2,2,0.017626,4,0.281496,0.305894,0
以来(1946),以来,notion,0,3,3,0,5,5,0.034741,4,0.307812,0.344002,5249.921704
以示(1946),以示,notion,0,1,1,0,1,1,0.004564,4,0.256755,0.263104,0
以观(1946),以观,notion,0,1,1,0,1,1,0.00826,4,0.264992,0.278237,0
以防(1946),以防,notion,0,1,1,0,1,1,0.013378,4,0.272039,0.290456,0
仪式(1946),仪式,notion,0,1,1,0,1,1,0.013634,4,0.273332,0.292631,0
仲夏夜(1946),仲夏夜,notion,0,1,1,0,1,1,0.013634,4,0.273332,0.292631,0
仲秋(1946),仲秋,notion,0,1,1,0,1,1,0.017626,4,0.281496,0.305894,0
仲裁(1946),仲裁,notion,0,1,1,0,3,3,0.013378,4,0.272039,0.290456,0
价值(1946),价值,notion,0,1,1,0,1,1,0.004577,4,0.257676,0.264843,0
任何(1946),任何,notion,0,1,1,0,1,1,0.003608,4,0.255568,0.260842,0
任务(1946),任务,notion,0,8,8,0,12,12,0.085934,4,0.390159,0.430075,33075.605533
任劳任怨(1946),任劳任怨,notion,0,1,1,0,1,1,0.005304,4,0.259537,0.268322,0
任重(1946),任重,notion,0,1,1,0,1,1,0.013378,4,0.272039,0.290456,0
份子(1946),份子,notion,0,1,1,0,2,2,0.013103,4,0.272684,0.291543,0
仿朱柏庐(1946),仿朱柏庐,notion,0,1,1,0,1,1,0.018893,4,0.282798,0.307938,0
企业(1946),企业,notion,0,1,1,0,1,1,0.004577,4,0.257676,0.264843,0
企业家(1946),企业家,notion,0,1,1,0,1,1,0.004577,4,0.257676,0.264843,0
企图(1946),企图,notion,0,1,1,0,1,1,0.017626,4,0.281496,0.305894,0
伊宁(1946),伊宁,notion,0,3,3,0,3,3,0.038419,4,0.31393,0.351916,4673.003742
伊拉克(1946),伊拉克,notion,0,1,1,0,1,1,0.013103,4,0.272684,0.291543,0
伊琳娜(1946),伊琳娜,notion,0,1,1,0,1,1,0.013103,4,0.272684,0.291543,0
伊苏(1946),伊苏,notion,0,1,1,0,1,1,0.017626,4,0.281496,0.305894,0
伎俩(1946),伎俩,notion,0,1,1,0,1,1,0.018893,4,0.282798,0.307938,0
伏尔加(1946),伏尔加,notion,0,1,1,0,2,2,0.013103,4,0.272684,0.291543,0
休会(1946),休会,notion,0,1,1,0,1,1,0.017626,4,0.281496,0.305894,0
休养生息(1946),休养生息,notion,0,1,1,0,1,1,0.0031,4,0.254504,0.258799,0
休养院(1946),休养院,notion,0,1,1,0,1,1,0.018893,4,0.282798,0.307938,0
休刊(1946),休刊,notion,0,1,1,0,5,5,0.013634,4,0.273332,0.292631,0
休战(1946),休战,notion,0,1,1,0,1,1,0.005461,4,0.25793,0.265322,0
优先(1946),优先,notion,0,1,1,0,1,1,0.00826,4,0.264992,0.278237,0
优秀作家(1946),优秀作家,notion,0,1,1,0,1,1,0.013103,4,0.272684,0.291543,0
优越感(1946),优越感,notion,0,1,1,0,1,1,0.0031,4,0.254504,0.258799,0
会后(1946),会后,notion,0,1,1,0,1,1,0.005461,4,0.25793,0.265322,0
会演(1946),会演,notion,0,1,1,0,1,1,0.007159,4,0.261235,0.271453,0
会谈(1946),会谈,notion,0,1,1,0,1,1,0.013103,4,0.272684,0.291543,0
会谈纪要(1946),会谈纪要,notion,0,1,1,0,1,1,0.003608,4,0.255568,0.260842,0
会长(1946),会长,notion,0,1,1,0,1,1,0.005304,4,0.259537,0.268322,0
伟人(1946),伟人,notion,0,1,1,0,2,2,0.017626,4,0.281496,0.305894,0
伟大胜利(1946),伟大胜利,notion,0,1,1,0,1,1,0.013103,4,0.272684,0.291543,0
传入(1946),传入,notion,0,1,1,0,1,1,0.017626,4,0.281496,0.305894,0
传奇人物(1946),传奇人物,notion,0,1,1,0,1,1,0.004577,4,0.257676,0.264843,0
传统(1946),传统,notion,0,2,2,0,2,2,0.023015,4,0.2849,0.311272,897.577022
伤兵(1946),伤兵,notion,0,1,1,0,1,1,0.004479,4,0.256686,0.262973,0
伤心(1946),伤心,notion,0,1,1,0,1,1,0.004479,4,0.256686,0.262973,0
伤心事(1946),伤心事,notion,0,1,1,0,1,1,0.013634,4,0.273332,0.292631,0
伪报(1946),伪报,notion,0,1,1,0,1,1,0.00826,4,0.264992,0.278237,0
估衣(1946),估衣,notion,0,1,1,0,1,1,0.017626,4,0.281496,0.305894,0
估计(1946),估计,notion,0,1,1,0,1,1,0.013378,4,0.272039,0.290456,0
伸向(1946),伸向,notion,0,1,1,0,1,1,0.013103,4,0.272684,0.291543,0
伸进(1946),伸进,notion,0,1,1,0,1,1,0.00826,4,0.264992,0.278237,0
似乎(1946),似乎,notion,0,1,1,0,1,1,0.013103,4,0.272684,0.291543,0
但原(1946),但原,notion,0,1,1,0,1,1,0.013378,4,0.272039,0.290456,0
佈置(1946),佈置,notion,0,1,1,0,1,1,0.007159,4,0.261235,0.271453,0
低眉(1946),低眉,notion,0,1,1,0,1,1,0.013378,4,0.272039,0.290456,0
低落(1946),低落,notion,0,1,1,0,1,1,0.017626,4,0.281496,0.305894,0
住宅(1946),住宅,notion,0,2,2,0,2,2,0.023372,4,0.287781,0.315664,849.784339
住居(1946),住居,notion,0,2,2,0,2,2,0.032527,4,0.303393,0.338015,1614.891208
体之四(1946),体之四,notion,0,1,1,0,1,1,0.009637,4,0.265506,0.27915,0
体制(1946),体制,notion,0,1,1,0,2,2,0.017626,4,0.281496,0.305894,0
体系(1946),体系,notion,0,2,2,0,2,2,0.01262,4,0.267856,0.283354,430.211985
体育(1946),体育,notion,0,1,1,0,1,1,0.017626,4,0.281496,0.305894,0
体育节(1946),体育节,notion,0,1,1,0,1,1,0.013103,4,0.272684,0.291543,0
何不(1946),何不,notion,0,1,1,0,1,1,0.004479,4,0.256686,0.262973,0
何事(1946),何事,notion,0,2,2,0,2,2,0.027153,4,0.296784,0.32884,1981.441549
何以(1946),何以,notion,0,1,1,0,1,1,0.009637,4,0.265506,0.27915,0
何信(1946),何信,notion,0,1,1,0,1,1,0.007159,4,0.261235,0.271453,0
何在(1946),何在,notion,0,5,5,0,6,6,0.067768,4,0.360597,0.403592,13203.743951
何处(1946),何处,notion,0,4,4,0,9,9,0.054199,4,0.344025,0.386821,10813.744345
何如(1946),何如,notion,0,2,2,0,2,2,0.024354,4,0.288822,0.317229,783.391635
何尝(1946),何尝,notion,0,1,1,0,1,1,0.001496,4,0.252204,0.25432,0
何年(1946),何年,notion,0,1,1,0,1,1,0.018893,4,0.282798,0.307938,0
何德奎(1946),何德奎,notion,0,1,1,0,1,1,0.018893,4,0.282798,0.307938,0
何德奎案(1946),何德奎案,notion,0,1,1,0,1,1,0.004577,4,0.257676,0.264843,0
何日(1946),何日,notion,0,1,1,0,1,1,0.013634,4,0.273332,0.292631,0
何时(1946),何时,notion,0,2,2,0,2,2,0.027153,4,0.296784,0.32884,1981.441549
何曾(1946),何曾,notion,0,1,1,0,1,1,0.00826,4,0.264992,0.278237,0
何有(1946),何有,notion,0,1,1,0,2,2,0.018893,4,0.282798,0.307938,0
何独(1946),何独,notion,0,1,1,0,1,1,0.007159,4,0.261235,0.271453,0
何用(1946),何用,notion,0,1,1,0,1,1,0.013378,4,0.272039,0.290456,0
何罪(1946),何罪,notion,0,1,1,0,1,1,0.013634,4,0.273332,0.292631,0
何香凝(1946),何香凝,notion,0,1,1,0,1,1,0.013634,4,0.273332,0.292631,0
余孽(1946),余孽,notion,0,1,1,0,1,1,0.013103,4,0.272684,0.291543,0
余尽话(1946),余尽话,notion,0,1,1,0,1,1,0.0031,4,0.254504,0.258799,0
余年(1946),余年,notion,0,1,1,0,1,1,0.009637,4,0.265506,0.27915,0
余感(1946),余感,notion,0,1,1,0,1,1,0.013634,4,0.273332,0.292631,0
佛学(1946),佛学,notion,0,1,1,0,1,1,0.017626,4,0.281496,0.305894,0
佛朗哥(1946),佛朗哥,notion,0,3,3,0,5,5,0.035689,4,0.304615,0.33974,3045.179808
作为(1946),作为,notion,0,2,2,0,2,2,0.018682,4,0.280974,0.30514,1561.099535
作品(1946),作品,notion,0,2,2,0,5,5,0.026737,4,0.295411,0.326883,1969.400217
作家(1946),作家,notion,0,3,3,0,6,6,0.044363,4,0.326555,0.36731,6261.172064
作怪(1946),作怪,notion,0,1,1,0,1,1,0.017626,4,0.281496,0.305894,0
作想(1946),作想,notion,0,1,1,0,1,1,0.007159,4,0.261235,0.271453,0
作文(1946),作文,notion,0,1,1,0,1,1,0.007159,4,0.261235,0.271453,0
作曲家(1946),作曲家,notion,0,1,1,0,1,1,0.004577,4,0.257676,0.264843,0
作歌(1946),作歌,notion,0,1,1,0,1,1,0.018893,4,0.282798,0.307938,0
作爲(1946),作爲,notion,0,1,1,0,1,1,0.004577,4,0.257676,0.264843,0
作者(1946),作者,notion,0,2,2,0,5,5,0.009141,4,0.263752,0.276091,604.443087
作风(1946),作风,notion,0,3,3,0,3,3,0.027325,4,0.29199,0.321998,1945.588268
使人(1946),使人,notion,0,1,1,0,2,2,0.018893,4,0.282798,0.307938,0
使命(1946),使命,notion,0,3,3,0,4,4,0.029362,4,0.297891,0.330478,3662.73104
侈言(1946),侈言,notion,0,1,1,0,1,1,0.003608,4,0.255568,0.260842,0
例证(1946),例证,notion,0,1,1,0,1,1,0.013378,4,0.272039,0.290456,0
依归(1946),依归,notion,0,1,1,0,1,1,0.009637,4,0.265506,0.27915,0
依然(1946),依然,notion,0,1,1,0,1,1,0.013634,4,0.273332,0.292631,0
依靠(1946),依靠,notion,0,1,1,0,1,1,0.013634,4,0.273332,0.292631,0
侦察员(1946),侦察员,notion,0,1,1,0,1,1,0.001496,4,0.252204,0.25432,0
侧写(1946),侧写,notion,0,1,1,0,4,4,0.017626,4,0.281496,0.305894,0
侧影(1946),侧影,notion,0,3,3,0,3,3,0.041908,4,0.31393,0.351916,3405.961451
侧闻(1946),侧闻,notion,0,1,1,0,1,1,0.018893,4,0.282798,0.307938,0
侨工(1946),侨工,notion,0,1,1,0,1,1,0.00826,4,0.264992,0.278237,0
侨校(1946),侨校,notion,0,1,1,0,1,1,0.00826,4,0.264992,0.278237,0
侵犯(1946),侵犯,notion,0,1,1,0,1,1,0.013103,4,0.272684,0.291543,0
侵略(1946),侵略,notion,0,1,1,0,2,2,0.013103,4,0.272684,0.291543,0
侵蚀(1946),侵蚀,notion,0,1,1,0,1,1,0.018893,4,0.282798,0.307938,0
便是(1946),便是,notion,0,1,1,0,1,1,0.004237,4,0.256206,0.26206,0
便笺(1946),便笺,notion,0,1,1,0,1,1,0.0031,4,0.254504,0.258799,0
促成(1946),促成,notion,0,1,1,0,1,1,0.018893,4,0.282798,0.307938,0
促进(1946),促进,notion,0,1,1,0,2,2,0.017626,4,0.281496,0.305894,0
保全(1946),保全,notion,0,1,1,0,1,1,0.017626,4,0.281496,0.305894,0
保加利亚(1946),保加利亚,notion,0,1,1,0,1,1,0.013103,4,0.272684,0.291543,0
保卫(1946),保卫,notion,0,4,4,0,5,5,0.054164,4,0.337165,0.379428,9669.742325
保垒(1946),保垒,notion,0,1,1,0,1,1,0.013103,4,0.272684,0.291543,0
保姆(1946),保姆,notion,0,1,1,0,1,1,0.013634,4,0.273332,0.292631,0
保安队(1946),保安队,notion,0,1,1,0,1,1,0.00826,4,0.264992,0.278237,0
保护(1946),保护,notion,0,2,2,0,2,2,0.032527,4,0.303393,0.338015,1614.891208
保持(1946),保持,notion,0,1,1,0,1,1,0.017626,4,0.281496,0.305894,0
保甲(1946),保甲,notion,0,5,5,0,8,8,0.061003,4,0.340601,0.383241,9734.721263
保荐(1946),保荐,notion,0,1,1,0,1,1,0.017626,4,0.281496,0.305894,0
保证(1946),保证,notion,0,3,3,0,3,3,0.02775,4,0.292287,0.322433,2562.69308
保障人权(1946),保障人权,notion,0,1,1,0,1,1,0.004237,4,0.256206,0.26206,0
信不信(1946),信不信,notion,0,1,1,0,1,1,0.017626,4,0.281496,0.305894,0
信仰(1946),信仰,notion,0,1,1,0,1,1,0.018893,4,0.282798,0.307938,0
信号(1946),信号,notion,0,5,5,0,5,5,0.060093,4,0.347519,0.390546,11547.300367
信心(1946),信心,notion,0,3,3,0,3,3,0.035096,4,0.307187,0.343176,3397.600392
信念(1946),信念,notion,0,2,2,0,3,3,0.027264,4,0.294896,0.326144,1405.794223
信箱(1946),信箱,notion,0,3,3,0,9,9,0.026539,4,0.295199,0.326651,4185.452582
修宪(1946),修宪,notion,0,1,1,0,1,1,0.004237,4,0.256206,0.26206,0
修建(1946),修建,notion,0,1,1,0,1,1,0.018893,4,0.282798,0.307938,0
修改(1946),修改,notion,0,3,3,0,3,3,0.032725,4,0.300853,0.334609,2774.499997
修正(1946),修正,notion,0,3,3,0,6,6,0.032725,4,0.300853,0.334609,2774.499997
俱乐部(1946),俱乐部,notion,0,1,1,0,1,1,0.013103,4,0.272684,0.291543,0
倒台(1946),倒台,notion,0,1,1,0,1,1,0.004237,4,0.256206,0.26206,0
倒底(1946),倒底,notion,0,1,1,0,1,1,0.018893,4,0.282798,0.307938,0
倒悬(1946),倒悬,notion,0,1,1,0,1,1,0.013634,4,0.273332,0.292631,0
倒转(1946),倒转,notion,0,1,1,0,1,1,0.013103,4,0.272684,0.291543,0
倒闭(1946),倒闭,notion,0,1,1,0,1,1,0.018893,4,0.282798,0.307938,0
倒阁(1946),倒阁,notion,0,1,1,0,1,1,0.013103,4,0.272684,0.291543,0
候补(1946),候补,notion,0,1,1,0,1,1,0.017626,4,0.281496,0.305894,0
候选人(1946),候选人,notion,0,2,2,0,2,2,0.024354,4,0.288822,0.317229,783.391635
借款(1946),借款,notion,0,1,1,0,1,1,0.017626,4,0.281496,0.305894,0
借端(1946),借端,notion,0,1,1,0,1,1,0.00826,4,0.264992,0.278237,0
值得(1946),值得,notion,0,3,3,0,5,5,0.037575,4,0.310942,0.34809,5120.881642
倾向(1946),倾向,notion,0,2,2,0,2,2,0.021363,4,0.287407,0.315098,2175.293762
倾销(1946),倾销,notion,0,1,1,0,1,1,0.004564,4,0.256755,0.263104,0
假中杂(1946),假中杂,notion,0,1,1,0,1,1,0.013378,4,0.272039,0.290456,0
假使(1946),假使,notion,0,1,1,0,1,1,0.005304,4,0.259537,0.268322,0
假如(1946),假如,notion,0,2,2,0,3,3,0.02853,4,0.295746,0.327361,1236.887723
假谈(1946),假谈,notion,0,1,1,0,1,1,0.018893,4,0.282798,0.307938,0
偏向(1946),偏向,notion,0,1,1,0,1,1,0.018893,4,0.282798,0.307938,0
做些(1946),做些,notion,0,2,2,0,2,2,0.009698,4,0.262356,0.273569,160.636246
做官(1946),做官,notion,0,2,2,0,2,2,0.017615,4,0.276807,0.298443,528.122
做生(1946),做生,notion,0,1,1,0,1,1,0.013378,4,0.272039,0.290456,0
做起(1946),做起,notion,0,1,1,0,1,1,0.005304,4,0.259537,0.268322,0
停刊(1946),停刊,notion,0,2,2,0,3,3,0.027011,4,0.292079,0.322056,1114.922273
停发(1946),停发,notion,0,1,1,0,1,1,0.017626,4,0.281496,0.305894,0
停止(1946),停止,notion,0,5,5,0,10,10,0.073168,4,0.370258,0.412637,15295.500594
停水(1946),停水,notion,0,1,1,0,1,1,0.018893,4,0.282798,0.307938,0
停运(1946),停运,notion,0,1,1,0,1,1,0.007159,4,0.261235,0.271453,0
健全(1946),健全,notion,0,1,1,0,1,1,0.005304,4,0.259537,0.268322,0
偶像(1946),偶像,notion,0,1,1,0,1,1,0.013634,4,0.273332,0.292631,0
偶像化(1946),偶像化,notion,0,1,1,0,1,1,0.013103,4,0.272684,0.291543,0
偶感(1946),偶感,notion,0,1,1,0,1,1,0.003608,4,0.255568,0.260842,0
偶拾(1946),偶拾,notion,0,1,1,0,1,1,0.017626,4,0.281496,0.305894,0
偶语(1946),偶语,notion,0,1,1,0,1,1,0.018893,4,0.282798,0.307938,0
傀儡戏(1946),傀儡戏,notion,0,1,1,0,1,1,0.013634,4,0.273332,0.292631,0
傅泾波(1946),傅泾波,notion,0,1,1,0,1,1,0.018893,4,0.282798,0.307938,0
催征(1946),催征,notion,0,1,1,0,1,1,0.00826,4,0.264992,0.278237,0
傻子(1946),傻子,notion,0,1,1,0,1,1,0.005304,4,0.259537,0.268322,0
僵尸(1946),僵尸,notion,0,1,1,0,1,1,0.013634,4,0.273332,0.292631,0
僵局(1946),僵局,notion,0,3,3,0,3,3,0.041981,4,0.319869,0.359309,4185.728903
僵持(1946),僵持,notion,0,1,1,0,1,1,0.017626,4,0.281496,0.305894,0
儒君关(1946),儒君关,notion,0,1,1,0,1,1,0.017626,4,0.281496,0.305894,0
儒学(1946),儒学,notion,0,1,1,0,1,1,0.017626,4,0.281496,0.305894,0
儒家(1946),儒家,notion,0,1,1,0,1,1,0.017626,4,0.281496,0.305894,0
儒着(1946),儒着,notion,0,1,1,0,1,1,0.007159,4,0.261235,0.271453,0
儿女(1946),儿女,notion,0,1,1,0,1,1,0.018893,4,0.282798,0.307938,0
儿子(1946),儿子,notion,0,1,1,0,2,2,0.013103,4,0.272684,0.291543,0
儿童(1946),儿童,notion,0,1,1,0,1,1,0.017626,4,0.281496,0.305894,0
元旦(1946),元旦,notion,0,1,1,0,1,1,0.013634,4,0.273332,0.292631,0
兄绘(1946),兄绘,notion,0,1,1,0,1,1,0.018893,4,0.282798,0.307938,0
兄长(1946),兄长,notion,0,1,1,0,1,1,0.00826,4,0.264992,0.278237,0
充实(1946),充实,notion,0,2,2,0,3,3,0.009882,4,0.266886,0.281658,1422.879592
充满(1946),充满,notion,0,1,1,0,1,1,0.013634,4,0.273332,0.292631,0
先修班(1946),先修班,notion,0,1,1,0,1,1,0.017626,4,0.281496,0.305894,0
先兆(1946),先兆,notion,0,1,1,0,1,1,0.00826,4,0.264992,0.278237,0
先改(1946),先改,notion,0,1,1,0,1,1,0.013634,4,0.273332,0.292631,0
光明(1946),光明,notion,0,6,6,0,11,11,0.054162,4,0.336849,0.379225,19789.367711
光明面(1946),光明面,notion,0,1,1,0,1,1,0.013634,4,0.273332,0.292631,0
克伦威尔(1946),克伦威尔,notion,0,1,1,0,1,1,0.017626,4,0.281496,0.305894,0
克利(1946),克利,notion,0,2,2,0,2,2,0.02313,4,0.287378,0.315055,697.222
克里姆(1946),克里姆,notion,0,1,1,0,1,1,0.013103,4,0.272684,0.291543,0
免征(1946),免征,notion,0,1,1,0,1,1,0.018893,4,0.282798,0.307938,0
免税(1946),免税,notion,0,1,1,0,1,1,0.007159,4,0.261235,0.271453,0
兑现(1946),兑现,notion,0,3,3,0,3,3,0.031248,4,0.296661,0.328738,2223.968046
兔子(1946),兔子,notion,0,1,1,0,1,1,0.017626,4,0.281496,0.305894,0
党专政(1946),党专政,notion,0,3,3,0,3,3,0.02775,4,0.292287,0.322433,2562.69308
党争(1946),党争,notion,0,2,2,0,2,2,0.022204,4,0.287896,0.315838,1406.192172
党务(1946),党务,notion,0,1,1,0,1,1,0.017626,4,0.281496,0.305894,0
党化(1946),党化,notion,0,1,1,0,1,1,0.007159,4,0.261235,0.271453,0
党员(1946),党员,notion,0,1,1,0,1,1,0.005461,4,0.25793,0.265322,0
党国(1946),党国,notion,0,1,1,0,1,1,0.018893,4,0.282798,0.307938,0
党教(1946),党教,notion,0,1,1,0,1,1,0.00826,4,0.264992,0.278237,0
党棍(1946),党棍,notion,0,1,1,0,1,1,0.005461,4,0.25793,0.265322,0
党章(1946),党章,notion,0,1,1,0,2,2,0.00826,4,0.264992,0.278237,0
党风(1946),党风,notion,0,1,1,0,1,1,0.009637,4,0.265506,0.27915,0
入主出奴(1946),入主出奴,notion,0,1,1,0,1,1,0.005461,4,0.25793,0.265322,0
全世界(1946),全世界,notion,0,3,3,0,3,3,0.031044,4,0.297706,0.330217,2801.771669
全之处(1946),全之处,notion,0,1,1,0,1,1,0.009637,4,0.265506,0.27915,0
全体(1946),全体,notion,0,1,1,0,1,1,0.013103,4,0.272684,0.291543,0
全国同胞(1946),全国同胞,notion,0,1,1,0,1,1,0.013634,4,0.273332,0.292631,0
全民(1946),全民,notion,0,2,2,0,2,2,0.024785,4,0.291398,0.321056,1410.74284
全盘(1946),全盘,notion,0,1,1,0,1,1,0.004577,4,0.257676,0.264843,0
全责(1946),全责,notion,0,1,1,0,1,1,0.017626,4,0.281496,0.305894,0
全部(1946),全部,notion,0,1,1,0,1,1,0.017626,4,0.281496,0.305894,0
全集(1946),全集,notion,0,1,1,0,1,1,0.018893,4,0.282798,0.307938,0
八七(1946),八七,notion,0,2,2,0,3,3,0.021363,4,0.287407,0.315098,2175.293762
八万(1946),八万,notion,0,1,1,0,1,1,0.018893,4,0.282798,0.307938,0
八个(1946),八个,notion,0,1,1,0,1,1,0.005304,4,0.259537,0.268322,0
八则(1946),八则,notion,0,1,1,0,1,1,0.003608,4,0.255568,0.260842,0
八月八(1946),八月八,notion,0,1,1,0,1,1,0.013103,4,0.272684,0.291543,0
八桂(1946),八桂,notion,0,2,2,0,2,2,0.036519,4,0.313896,0.3518,2490.161613
八路军(1946),八路军,notion,0,1,1,0,1,1,0.00826,4,0.264992,0.278237,0
八载(1946),八载,notion,0,1,1,0,1,1,0.017626,4,0.281496,0.305894,0
公主岭(1946),公主岭,notion,0,2,2,0,2,2,0.031996,4,0.303907,0.338711,1883.718005
公会(1946),公会,notion,0,1,1,0,1,1,0.013378,4,0.272039,0.290456,0
公佈(1946),公佈,notion,0,1,1,0,1,1,0.017626,4,0.281496,0.305894,0
公债(1946),公债,notion,0,1,1,0,1,1,0.013103,4,0.272684,0.291543,0
公务员(1946),公务员,notion,0,1,1,0,1,1,0.004577,4,0.257676,0.264843,0
公布(1946),公布,notion,0,1,1,0,1,1,0.0031,4,0.254504,0.258799,0
公帑(1946),公帑,notion,0,1,1,0,1,1,0.004577,4,0.257676,0.264843,0
公开(1946),公开,notion,0,1,1,0,1,1,0.013634,4,0.273332,0.292631,0
公报(1946),公报,notion,0,1,1,0,1,1,0.013103,4,0.272684,0.291543,0
公教人员(1946),公教人员,notion,0,1,1,0,1,1,0.017626,4,0.281496,0.305894,0
公朴(1946),公朴,notion,0,2,2,0,3,3,0.027153,4,0.296784,0.32884,1981.441549
公正(1946),公正,notion,0,1,1,0,1,1,0.013103,4,0.272684,0.291543,0
公民(1946),公民,notion,0,3,3,0,4,4,0.041633,4,0.316488,0.355134,4230.538536
公民投票(1946),公民投票,notion,0,1,1,0,1,1,0.018893,4,0.282798,0.307938,0
公私(1946),公私,notion,0,1,1,0,1,1,0.005304,4,0.259537,0.268322,0
公葬记(1946),公葬记,notion,0,1,1,0,1,1,0.018893,4,0.282798,0.307938,0
公道话(1946),公道话,notion,0,1,1,0,1,1,0.013378,4,0.272039,0.290456,0
六·二三下关事件(1946),六·二三下关事件,notion,0,1,1,0,1,1,0.013634,4,0.273332,0.292631,0
六二三下关事件(1946),六二三下关事件,notion,0,1,1,0,1,1,0.013378,4,0.272039,0.290456,0
六十(1946),六十,notion,0,2,2,0,4,4,0.025886,4,0.296968,0.329101,2935.752997
六十大寿(1946),六十大寿,notion,0,1,1,0,1,1,0.00826,4,0.264992,0.278237,0
六十年(1946),六十年,notion,0,1,1,0,1,1,0.017626,4,0.281496,0.305894,0
六大(1946),六大,notion,0,1,1,0,1,1,0.004479,4,0.256686,0.262973,0
共同(1946),共同,notion,0,2,2,0,2,2,0.013245,4,0.269995,0.28705,596.681008
共和(1946),共和,notion,0,3,3,0,3,3,0.027579,4,0.289841,0.318824,2074.718086
共和党(1946),共和党,notion,0,2,2,0,2,2,0.023372,4,0.287781,0.315664,849.784339
共存亡(1946),共存亡,notion,0,2,2,0,3,3,0.020389,4,0.284308,0.310358,712.812748
关健(1946),关健,notion,0,1,1,0,1,1,0.017626,4,0.281496,0.305894,0
关内(1946),关内,notion,0,1,1,0,1,1,0.013103,4,0.272684,0.291543,0
关口(1946),关口,notion,0,1,1,0,1,1,0.00826,4,0.264992,0.278237,0
关外(1946),关外,notion,0,1,1,0,1,1,0.013103,4,0.272684,0.291543,0
关头(1946),关头,notion,0,4,4,0,4,4,0.03608,4,0.30215,0.336464,4302.767562
关心(1946),关心,notion,0,2,2,0,2,2,0.030729,4,0.302946,0.337407,2092.27198
关怀(1946),关怀,notion,0,1,1,0,1,1,0.018893,4,0.282798,0.307938,0
关於(1946),关於,notion,0,1,1,0,1,1,0.004577,4,0.257676,0.264843,0
关榷(1946),关榷,notion,0,1,1,0,1,1,0.013634,4,0.273332,0.292631,0
关注(1946),关注,notion,0,1,1,0,2,2,0.013103,4,0.272684,0.291543,0
关键(1946),关键,notion,0,7,7,0,9,9,0.065485,4,0.350955,0.394213,17751.820611
兴学(1946),兴学,notion,0,1,1,0,1,1,0.018893,4,0.282798,0.307938,0
兴怀(1946),兴怀,notion,0,1,1,0,1,1,0.017626,4,0.281496,0.305894,0
兴趣(1946),兴趣,notion,0,1,1,0,1,1,0.004577,4,0.257676,0.264843,0
兵匪(1946),兵匪,notion,0,1,1,0,1,1,0.00826,4,0.264992,0.278237,0
兵士(1946),兵士,notion,0,1,1,0,1,1,0.013634,4,0.273332,0.292631,0
兵学(1946),兵学,notion,0,1,1,0,1,1,0.004577,4,0.257676,0.264843,0
兵役(1946),兵役,notion,0,1,1,0,1,1,0.018893,4,0.282798,0.307938,0
兵役制(1946),兵役制,notion,0,1,1,0,1,1,0.018893,4,0.282798,0.307938,0
兵祸(1946),兵祸,notion,0,1,1,0,1,1,0.013634,4,0.273332,0.292631,0
兵船(1946),兵船,notion,0,1,1,0,1,1,0.018893,4,0.282798,0.307938,0
兵诗(1946),兵诗,notion,0,1,1,0,1,1,0.013634,4,0.273332,0.292631,0
其人(1946),其人,notion,0,1,1,0,1,1,0.018893,4,0.282798,0.307938,0
其后(1946),其后,notion,0,1,1,0,1,1,0.00826,4,0.264992,0.278237,0
其平则鸣(1946),其平则鸣,notion,0,1,1,0,1,1,0.013634,4,0.273332,0.292631,0
具体(1946),具体,notion,0,1,1,0,1,1,0.018893,4,0.282798,0.307938,0
具体办法(1946),具体办法,notion,0,1,1,0,1,1,0.004237,4,0.256206,0.26206,0
养成(1946),养成,notion,0,2,2,0,2,2,0.020792,4,0.283021,0.308358,1062.761034
养殖场(1946),养殖场,notion,0,1,1,0,1,1,0.005304,4,0.259537,0.268322,0
兼为(1946),兼为,notion,0,1,1,0,1,1,0.004237,4,0.256206,0.26206,0
兼致(1946),兼致,notion,0,1,1,0,1,1,0.018893,4,0.282798,0.307938,0
内乱(1946),内乱,notion,0,1,1,0,1,1,0.013378,4,0.272039,0.290456,0
内乳(1946),内乳,notion,0,1,1,0,1,1,0.013378,4,0.272039,0.290456,0
内争(1946),内争,notion,0,1,1,0,1,1,0.013378,4,0.272039,0.290456,0
内内实(1946),内内实,notion,0,1,1,0,1,1,0.013378,4,0.272039,0.290456,0
内容(1946),内容,notion,0,1,1,0,1,1,0.013103,4,0.272684,0.291543,0
内心(1946),内心,notion,0,1,1,0,1,1,0.017626,4,0.281496,0.305894,0
内政外交(1946),内政外交,notion,0,1,1,0,1,1,0.009637,4,0.265506,0.27915,0
内河(1946),内河,notion,0,1,1,0,1,1,0.007159,4,0.261235,0.271453,0
内蒙(1946),内蒙,notion,0,1,1,0,1,1,0.017626,4,0.281496,0.305894,0
内虞(1946),内虞,notion,0,1,1,0,1,1,0.013378,4,0.272039,0.290456,0
内部(1946),内部,notion,0,2,2,0,2,2,0.016203,4,0.276115,0.297313,650.123339
内阁(1946),内阁,notion,0,3,3,0,3,3,0.034967,4,0.307911,0.344132,3678.9293
内阁制(1946),内阁制,notion,0,1,1,0,1,1,0.017626,4,0.281496,0.305894,0
再以(1946),再以,notion,0,1,1,0,1,1,0.017626,4,0.281496,0.305894,0
再会(1946),再会,notion,0,1,1,0,1,1,0.013634,4,0.273332,0.292631,0
再度(1946),再度,notion,0,1,1,0,1,1,0.00826,4,0.264992,0.278237,0
再战(1946),再战,notion,0,1,1,0,1,1,0.018893,4,0.282798,0.307938,0
再接再厉(1946),再接再厉,notion,0,1,1,0,1,1,0.018893,4,0.282798,0.307938,0
再来(1946),再来,notion,0,1,1,0,1,1,0.004577,4,0.257676,0.264843,0
再生(1946),再生,notion,0,2,2,0,2,2,0.014214,4,0.272194,0.29079,872.497436
再说(1946),再说,notion,0,1,1,0,1,1,0.013378,4,0.272039,0.290456,0
写于(1946),写于,notion,0,2,2,0,2,2,0.011722,4,0.266812,0.281527,472.501913
写在(1946),写在,notion,0,1,1,0,1,1,0.013103,4,0.272684,0.291543,0
写处(1946),写处,notion,0,1,1,0,1,1,0.013378,4,0.272039,0.290456,0
写得(1946),写得,notion,0,1,1,0,1,1,0.017626,4,0.281496,0.305894,0
写给(1946),写给,notion,0,2,2,0,2,2,0.01734,4,0.277877,0.300183,713.880954
军与民(1946),军与民,notion,0,1,1,0,1,1,0.004577,4,0.257676,0.264843,0
军中(1946),军中,notion,0,1,1,0,1,1,0.013634,4,0.273332,0.292631,0
军事同盟(1946),军事同盟,notion,0,1,1,0,1,1,0.017626,4,0.281496,0.305894,0
军事基地(1946),军事基地,notion,0,1,1,0,1,1,0.013103,4,0.272684,0.291543,0
军人(1946),军人,notion,0,3,3,0,5,5,0.03709,4,0.308737,0.345219,3418.307502
军力(1946),军力,notion,0,1,1,0,2,2,0.013103,4,0.272684,0.291543,0
军国主义(1946),军国主义,notion,0,1,1,0,1,1,0.018893,4,0.282798,0.307938,0
军官(1946),军官,notion,0,3,3,0,3,3,0.026373,4,0.293092,0.323607,3565.913112
军歌(1946),军歌,notion,0,1,1,0,1,1,0.003608,4,0.255568,0.260842,0
军火(1946),军火,notion,0,2,2,0,2,2,0.031996,4,0.303907,0.338711,1883.718005
军火商(1946),军火商,notion,0,1,1,0,1,1,0.013634,4,0.273332,0.292631,0
军粮(1946),军粮,notion,0,3,3,0,4,4,0.025998,4,0.286633,0.313997,1728.3361
军纪(1946),军纪,notion,0,1,1,0,1,1,0.013378,4,0.272039,0.290456,0
军统(1946),军统,notion,0,1,1,0,1,1,0.004479,4,0.256686,0.262973,0
军训(1946),军训,notion,0,1,1,0,1,1,0.017626,4,0.281496,0.305894,0
军风纪(1946),军风纪,notion,0,1,1,0,1,1,0.004479,4,0.256686,0.262973,0
农业试验(1946),农业试验,notion,0,1,1,0,1,1,0.004577,4,0.257676,0.264843,0
农场(1946),农场,notion,0,1,1,0,4,4,0.005304,4,0.259537,0.268322,0
农学院(1946),农学院,notion,0,1,1,0,1,1,0.017626,4,0.281496,0.305894,0
农家(1946),农家,notion,0,1,1,0,1,1,0.013634,4,0.273332,0.292631,0
农林水利(1946),农林水利,notion,0,1,1,0,1,1,0.017626,4,0.281496,0.305894,0
农民(1946),农民,notion,0,7,7,0,8,8,0.073446,4,0.378897,0.420479,32290.856829
农民工(1946),农民工,notion,0,1,1,0,1,1,0.0031,4,0.254504,0.258799,0
农民节(1946),农民节,notion,0,1,1,0,1,1,0.0031,4,0.254504,0.258799,0
农艺系(1946),农艺系,notion,0,1,1,0,1,1,0.017626,4,0.281496,0.305894,0
农行(1946),农行,notion,0,1,1,0,1,1,0.017626,4,0.281496,0.305894,0
冤狱(1946),冤狱,notion,0,2,2,0,2,2,0.027153,4,0.296784,0.32884,1981.441549
冬令救济(1946),冬令救济,notion,0,1,1,0,1,1,0.017626,4,0.281496,0.305894,0
冬天(1946),冬天,notion,0,3,3,0,3,3,0.035209,4,0.308605,0.345046,4046.053282
冬宫(1946),冬宫,notion,0,1,1,0,2,2,0.013103,4,0.272684,0.291543,0
冬讯(1946),冬讯,notion,0,1,1,0,1,1,0.013634,4,0.273332,0.292631,0
冯将军(1946),冯将军,notion,0,1,1,0,1,1,0.009637,4,0.265506,0.27915,0
冯承钧(1946),冯承钧,notion,0,1,1,0,1,1,0.005461,4,0.25793,0.265322,0
冲击(1946),冲击,notion,0,1,1,0,1,1,0.004564,4,0.256755,0.263104,0
冲突(1946),冲突,notion,0,1,1,0,1,1,0.013103,4,0.272684,0.291543,0
决不(1946),决不,notion,0,1,1,0,1,1,0.018893,4,0.282798,0.307938,0
决堤(1946),决堤,notion,0,1,1,0,1,1,0.017626,4,0.281496,0.305894,0
决定(1946),决定,notion,0,5,5,0,7,7,0.058524,4,0.336337,0.378588,9221.354002
决定权(1946),决定权,notion,0,1,1,0,1,1,0.013378,4,0.272039,0.290456,0
决战(1946),决战,notion,0,1,1,0,1,1,0.004237,4,0.256206,0.26206,0
决议(1946),决议,notion,0,6,6,0,8,8,0.058764,4,0.341653,0.384444,14405.583695
决赛(1946),决赛,notion,0,1,1,0,1,1,0.00826,4,0.264992,0.278237,0
冷落(1946),冷落,notion,0,1,1,0,1,1,0.018893,4,0.282798,0.307938,0
冷静下来(1946),冷静下来,notion,0,1,1,0,1,1,0.013378,4,0.272039,0.290456,0
凄寂的(1946),凄寂的,notion,0,1,1,0,1,1,0.013378,4,0.272039,0.290456,0
准备(1946),准备,notion,0,4,4,0,4,4,0.031918,4,0.299287,0.332507,5548.62884
准时(1946),准时,notion,0,1,1,0,1,1,0.018893,4,0.282798,0.307938,0
减征(1946),减征,notion,0,1,1,0,1,1,0.007159,4,0.261235,0.271453,0
减租(1946),减租,notion,0,2,2,0,3,3,0.024785,4,0.291398,0.321056,1410.74284
几件(1946),几件,notion,0,2,2,0,2,2,0.009069,4,0.262499,0.27383,318.19258
几位(1946),几位,notion,0,1,1,0,1,1,0.004479,4,0.256686,0.262973,0
几句(1946),几句,notion,0,1,1,0,3,3,0.013378,4,0.272039,0.290456,0
几句话(1946),几句话,notion,0,1,1,0,3,3,0.017626,4,0.281496,0.305894,0
几年(1946),几年,notion,0,1,1,0,1,1,0.018893,4,0.282798,0.307938,0
几张(1946),几张,notion,0,1,1,0,1,1,0.018893,4,0.282798,0.307938,0
几时(1946),几时,notion,0,1,1,0,1,1,0.013634,4,0.273332,0.292631,0
几星(1946),几星,notion,0,1,1,0,1,1,0.003608,4,0.255568,0.260842,0
几本(1946),几本,notion,0,2,2,0,2,2,0.021864,4,0.286576,0.313837,872.776367
几点(1946),几点,notion,0,4,4,0,4,4,0.031102,4,0.300759,0.334551,6642.575645
几种(1946),几种,notion,0,1,1,0,1,1,0.018893,4,0.282798,0.307938,0
几项(1946),几项,notion,0,1,1,0,1,1,0.005304,4,0.259537,0.268322,0
几首(1946),几首,notion,0,1,1,0,1,1,0.018893,4,0.282798,0.307938,0
凭借(1946),凭借,notion,0,1,1,0,1,1,0.005461,4,0.25793,0.265322,0
凶手(1946),凶手,notion,0,1,1,0,1,1,0.018893,4,0.282798,0.307938,0
凶欧(1946),凶欧,notion,0,1,1,0,1,1,0.007159,4,0.261235,0.271453,0
出使(1946),出使,notion,0,1,1,0,1,1,0.013103,4,0.272684,0.291543,0
出卖(1946),出卖,notion,0,1,1,0,1,1,0.004237,4,0.256206,0.26206,0
出发(1946),出发,notion,0,1,1,0,1,1,0.004237,4,0.256206,0.26206,0
出命(1946),出命,notion,0,1,1,0,1,1,0.00826,4,0.264992,0.278237,0
出奇(1946),出奇,notion,0,1,1,0,1,1,0.013378,4,0.272039,0.290456,0
出席(1946),出席,notion,0,1,1,0,1,1,0.009637,4,0.265506,0.27915,0
出征(1946),出征,notion,0,1,1,0,1,1,0.013634,4,0.273332,0.292631,0
出来(1946),出来,notion,0,2,2,0,2,2,0.015419,4,0.27556,0.296399,1296.225957
出此下策(1946),出此下策,notion,0,1,1,0,1,1,0.00826,4,0.264992,0.278237,0
出殡(1946),出殡,notion,0,1,1,0,1,1,0.018893,4,0.282798,0.307938,0
出洋(1946),出洋,notion,0,1,1,0,1,1,0.018893,4,0.282798,0.307938,0
出版业(1946),出版业,notion,0,2,2,0,2,2,0.022931,4,0.290456,0.319664,2102.663893
出版界(1946),出版界,notion,0,1,1,0,1,1,0.017626,4,0.281496,0.305894,0
出狱(1946),出狱,notion,0,1,1,0,1,1,0.001496,4,0.252204,0.25432,0
出现(1946),出现,notion,0,2,2,0,2,2,0.032527,4,0.303393,0.338015,1614.891208
出路(1946),出路,notion,0,5,5,0,6,6,0.043048,4,0.313793,0.351887,8040.729172
出钱(1946),出钱,notion,0,1,1,0,1,1,0.00826,4,0.264992,0.278237,0
击退(1946),击退,notion,0,2,2,0,2,2,0.031996,4,0.303907,0.338711,1883.718005
分割(1946),分割,notion,0,1,1,0,1,1,0.013634,4,0.273332,0.292631,0
分子(1946),分子,notion,0,4,4,0,4,4,0.040832,4,0.310203,0.347205,4263.84855
分家(1946),分家,notion,0,1,1,0,1,1,0.018893,4,0.282798,0.307938,0
分明(1946),分明,notion,0,1,1,0,1,1,0.013378,4,0.272039,0.290456,0
分清(1946),分清,notion,0,1,1,0,1,1,0.013634,4,0.273332,0.292631,0
分级制(1946),分级制,notion,0,1,1,0,1,1,0.013634,4,0.273332,0.292631,0
分裂(1946),分裂,notion,0,4,4,0,5,5,0.043828,4,0.323141,0.363339,9048.496353
分赃(1946),分赃,notion,0,1,1,0,1,1,0.003608,4,0.255568,0.260842,0
分配(1946),分配,notion,0,2,2,0,3,3,0.017955,4,0.278848,0.301748,1157.770247
切实(1946),切实,notion,0,2,2,0,2,2,0.02313,4,0.287378,0.315055,697.222
刊物(1946),刊物,notion,0,2,2,0,2,2,0.022501,4,0.28712,0.314663,997.953629
刊载(1946),刊载,notion,0,1,1,0,1,1,0.007159,4,0.261235,0.271453,0
刍狗(1946),刍狗,notion,0,1,1,0,1,1,0.017626,4,0.281496,0.305894,0
划时代(1946),划时代,notion,0,1,1,0,1,1,0.018893,4,0.282798,0.307938,0
列宁格勒(1946),列宁格勒,notion,0,1,1,0,1,1,0.013103,4,0.272684,0.291543,0
列强(1946),列强,notion,0,1,1,0,2,2,0.013103,4,0.272684,0.291543,0
列车(1946),列车,notion,0,1,1,0,1,1,0.00826,4,0.264992,0.278237,0
刘伯承(1946),刘伯承,notion,0,1,1,0,1,1,0.00826,4,0.264992,0.278237,0
刘汝明部(1946),刘汝明部,notion,0,1,1,0,1,1,0.00826,4,0.264992,0.278237,0
刘野(1946),刘野,notion,0,1,1,0,1,1,0.001496,4,0.252204,0.25432,0
刘魁(1946),刘魁,notion,0,1,1,0,1,1,0.017626,4,0.281496,0.305894,0
创伤(1946),创伤,notion,0,1,1,0,1,1,0.013103,4,0.272684,0.291543,0
创作(1946),创作,notion,0,1,1,0,1,1,0.005304,4,0.259537,0.268322,0
创刊号(1946),创刊号,notion,0,1,1,0,1,1,0.004577,4,0.257676,0.264843,0
创建(1946),创建,notion,0,4,4,0,5,5,0.044734,4,0.31962,0.359077,8156.175531
创立(1946),创立,notion,0,1,1,0,1,1,0.013103,4,0.272684,0.291543,0
创设(1946),创设,notion,0,1,1,0,1,1,0.003608,4,0.255568,0.260842,0
创造(1946),创造,notion,0,4,4,0,5,5,0.037021,4,0.311683,0.349119,9048.520604
创造者(1946),创造者,notion,0,1,1,0,2,2,0.00826,4,0.264992,0.278237,0
初到(1946),初到,notion,0,1,1,0,1,1,0.018893,4,0.282798,0.307938,0
初春(1946),初春,notion,0,2,2,0,2,2,0.031004,4,0.302277,0.336493,1833.728143
初期(1946),初期,notion,0,1,1,0,2,2,0.017626,4,0.281496,0.305894,0
初次(1946),初次,notion,0,1,1,0,1,1,0.013378,4,0.272039,0.290456,0
初步(1946),初步,notion,0,5,5,0,5,5,0.070689,4,0.366155,0.408854,14813.400083
判决书(1946),判决书,notion,0,1,1,0,1,1,0.009637,4,0.265506,0.27915,0
判处死刑(1946),判处死刑,notion,0,1,1,0,1,1,0.00826,4,0.264992,0.278237,0
利国(1946),利国,notion,0,1,1,0,1,1,0.017626,4,0.281496,0.305894,0
利得税(1946),利得税,notion,0,1,1,0,1,1,0.017626,4,0.281496,0.305894,0
利润(1946),利润,notion,0,1,1,0,1,1,0.013103,4,0.272684,0.291543,0
利益(1946),利益,notion,0,2,2,0,2,2,0.020536,4,0.280891,0.30501,760.639997
别写(1946),别写,notion,0,1,1,0,1,1,0.004479,4,0.256686,0.262973,0
别接(1946),别接,notion,0,1,1,0,1,1,0.018893,4,0.282798,0.307938,0
到处(1946),到处,notion,0,1,1,0,1,1,0.013634,4,0.273332,0.292631,0
到来(1946),到来,notion,0,1,1,0,1,1,0.013378,4,0.272039,0.290456,0
制在(1946),制在,notion,0,1,1,0,1,1,0.007159,4,0.261235,0.271453,0
制定(1946),制定,notion,0,1,1,0,1,1,0.017626,4,0.281496,0.305894,0
制宪(1946),制宪,notion,0,3,3,0,6,6,0.046157,4,0.327001,0.367832,5132.843559
制服(1946),制服,notion,0,1,1,0,1,1,0.013634,4,0.273332,0.292631,0
制止(1946),制止,notion,0,3,3,0,3,3,0.015924,4,0.274822,0.295254,2169.664124
制造(1946),制造,notion,0,1,1,0,1,1,0.013378,4,0.272039,0.290456,0
刺刀(1946),刺刀,notion,0,1,1,0,1,1,0.013378,4,0.272039,0.290456,0
刺案(1946),刺案,notion,0,1,1,0,1,1,0.007159,4,0.261235,0.271453,0
刺激(1946),刺激,notion,0,1,1,0,1,1,0.013634,4,0.273332,0.292631,0
前仆后继(1946),前仆后继,notion,0,1,1,0,1,1,0.005304,4,0.259537,0.268322,0
前哨战(1946),前哨战,notion,0,1,1,0,1,1,0.005461,4,0.25793,0.265322,0
前因后果(1946),前因后果,notion,0,1,1,0,1,1,0.018893,4,0.282798,0.307938,0
前夕(1946),前夕,notion,0,2,2,0,2,2,0.01768,4,0.279308,0.302487,1220.085569
前夜(1946),前夜,notion,0,1,1,0,1,1,0.018893,4,0.282798,0.307938,0
前奏(1946),前奏,notion,0,2,2,0,2,2,0.018113,4,0.278577,0.301313,749.731439
前提(1946),前提,notion,0,1,1,0,1,1,0.018893,4,0.282798,0.307938,0
前瞻(1946),前瞻,notion,0,3,3,0,4,4,0.035483,4,0.307647,0.343784,3586.146971
前线(1946),前线,notion,0,2,2,0,4,4,0.018938,4,0.282437,0.307445,1861.68946
前言(1946),前言,notion,0,1,1,0,1,1,0.005304,4,0.259537,0.268322,0
前记(1946),前记,notion,0,2,2,0,2,2,0.02347,4,0.289958,0.318925,1721.315005
前身(1946),前身,notion,0,1,1,0,1,1,0.004479,4,0.256686,0.262973,0
前辈(1946),前辈,notion,0,1,1,0,1,1,0.007159,4,0.261235,0.271453,0
前进(1946),前进,notion,0,4,4,0,7,7,0.050835,4,0.328308,0.369427,6628.474751
前锋(1946),前锋,notion,0,1,1,0,1,1,0.00826,4,0.264992,0.278237,0
前面(1946),前面,notion,0,1,1,0,1,1,0.017626,4,0.281496,0.305894,0
剑剌进(1946),剑剌进,notion,0,1,1,0,1,1,0.007159,4,0.261235,0.271453,0
剑川(1946),剑川,notion,0,1,1,0,1,1,0.017626,4,0.281496,0.305894,0
剔亮(1946),剔亮,notion,0,1,1,0,1,1,0.003608,4,0.255568,0.260842,0
剖视(1946),剖视,notion,0,1,1,0,1,1,0.018893,4,0.282798,0.307938,0
剥削(1946),剥削,notion,0,1,1,0,1,1,0.013378,4,0.272039,0.290456,0
剥夺(1946),剥夺,notion,0,1,1,0,1,1,0.013378,4,0.272039,0.290456,0
剧人(1946),剧人,notion,0,1,1,0,1,1,0.013103,4,0.272684,0.291543,0
剧艺(1946),剧艺,notion,0,1,1,0,2,2,0.013634,4,0.273332,0.292631,0
剧运(1946),剧运,notion,0,1,1,0,1,1,0.013634,4,0.273332,0.292631,0
剩余物资(1946),剩余物资,notion,0,2,2,0,3,3,0.032271,4,0.301168,0.334971,1271.496707
剪影(1946),剪影,notion,0,1,1,0,2,2,0.017626,4,0.281496,0.305894,0
割去(1946),割去,notion,0,1,1,0,1,1,0.017626,4,0.281496,0.305894,0
剷除(1946),剷除,notion,0,1,1,0,1,1,0.003608,4,0.255568,0.260842,0
力图(1946),力图,notion,0,1,1,0,1,1,0.017626,4,0.281496,0.305894,0
力行(1946),力行,notion,0,1,1,0,1,1,0.005304,4,0.259537,0.268322,0
力量(1946),力量,notion,0,8,8,0,14,14,0.07434,4,0.363838,0.406897,27196.257034
劝告(1946),劝告,notion,0,1,1,0,1,1,0.009637,4,0.265506,0.27915,0
办法(1946),办法,notion,0,4,4,0,4,4,0.046061,4,0.328683,0.369861,9230.152642
加价(1946),加价,notion,0,1,1,0,1,1,0.004564,4,0.256755,0.263104,0
加官(1946),加官,notion,0,1,1,0,1,1,0.018893,4,0.282798,0.307938,0
加尔各答(1946),加尔各答,notion,0,1,1,0,1,1,0.017626,4,0.281496,0.305894,0
加工(1946),加工,notion,0,1,1,0,1,1,0.005304,4,0.259537,0.268322,0
加强(1946),加强,notion,0,2,2,0,2,2,0.021638,4,0.286262,0.313359,1666.282153
加征(1946),加征,notion,0,1,1,0,1,1,0.007159,4,0.261235,0.271453,0
加拿大(1946),加拿大,notion,0,1,1,0,1,1,0.013103,4,0.272684,0.291543,0
加斯(1946),加斯,notion,0,1,1,0,1,1,0.018893,4,0.282798,0.307938,0
加深(1946),加深,notion,0,1,1,0,1,1,0.00826,4,0.264992,0.278237,0
加里(1946),加里,notion,0,1,1,0,1,1,0.013103,4,0.272684,0.291543,0
加饷(1946),加饷,notion,0,1,1,0,1,1,0.004564,4,0.256755,0.263104,0
动乱(1946),动乱,notion,0,1,1,0,1,1,0.013634,4,0.273332,0.292631,0
动力(1946),动力,notion,0,2,2,0,2,2,0.018938,4,0.282437,0.307445,1861.68946
动向(1946),动向,notion,0,4,4,0,4,4,0.038555,4,0.306564,0.342422,4213.228302
动员(1946),动员,notion,0,2,2,0,2,2,0.018682,4,0.280974,0.30514,1561.099535
动员令(1946),动员令,notion,0,1,1,0,1,1,0.017626,4,0.281496,0.305894,0
动工(1946),动工,notion,0,1,1,0,1,1,0.013378,4,0.272039,0.290456,0
动态(1946),动态,notion,0,2,2,0,2,2,0.012738,4,0.268934,0.285224,447.151269
动盪(1946),动盪,notion,0,1,1,0,1,1,0.004577,4,0.257676,0.264843,0
动盪中(1946),动盪中,notion,0,1,1,0,2,2,0.017626,4,0.281496,0.305894,0
助学(1946),助学,notion,0,3,3,0,3,3,0.037831,4,0.31328,0.35109,5764.866068
助长(1946),助长,notion,0,1,1,0,1,1,0.013378,4,0.272039,0.290456,0
努力完成(1946),努力完成,notion,0,1,1,0,1,1,0.017626,4,0.281496,0.305894,0
劫后(1946),劫后,notion,0,1,1,0,1,1,0.00826,4,0.264992,0.278237,0
劳动(1946),劳动,notion,0,3,3,0,3,3,0.035604,4,0.308373,0.344741,3826.67156
劳动者(1946),劳动者,notion,0,1,1,0,2,2,0.013103,4,0.272684,0.291543,0
劳动营(1946),劳动营,notion,0,1,1,0,1,1,0.018893,4,0.282798,0.307938,0
劳协(1946),劳协,notion,0,1,1,0,1,1,0.004479,4,0.256686,0.262973,0
劳工(1946),劳工,notion,0,3,3,0,3,3,0.049622,4,0.336297,0.378399,6466.151599
勇于(1946),勇于,notion,0,1,1,0,1,1,0.005304,4,0.259537,0.268322,0
勇敢(1946),勇敢,notion,0,1,1,0,1,1,0.018893,4,0.282798,0.307938,0
勇气(1946),勇气,notion,0,1,1,0,1,1,0.005304,4,0.259537,0.268322,0
包办(1946),包办,notion,0,1,1,0,1,1,0.013378,4,0.272039,0.290456,0
包含(1946),包含,notion,0,1,1,0,1,1,0.013103,4,0.272684,0.291543,0
化为(1946),化为,notion,0,1,1,0,1,1,0.005304,4,0.259537,0.268322,0
北上(1946),北上,notion,0,2,2,0,2,2,0.027153,4,0.296784,0.32884,1981.441549
北方(1946),北方,notion,0,3,3,0,4,4,0.040114,4,0.313896,0.351873,4492.668279
北极(1946),北极,notion,0,1,1,0,2,2,0.017626,4,0.281496,0.305894,0
北海道(1946),北海道,notion,0,1,1,0,1,1,0.017626,4,0.281496,0.305894,0
匪患(1946),匪患,notion,0,1,1,0,1,1,0.00826,4,0.264992,0.278237,0
医活(1946),医活,notion,0,1,1,0,1,1,0.018893,4,0.282798,0.307938,0
医药(1946),医药,notion,0,1,1,0,1,1,0.017626,4,0.281496,0.305894,0
十一(1946),十一,notion,0,4,4,0,5,5,0.044378,4,0.321119,0.360903,9023.307278
十一万(1946),十一万,notion,0,1,1,0,1,1,0.00826,4,0.264992,0.278237,0
十七(1946),十七,notion,0,1,1,0,1,1,0.013103,4,0.272684,0.291543,0
十三(1946),十三,notion,0,3,3,0,4,4,0.031,4,0.301294,0.335218,5051.102313
十个(1946),十个,notion,0,1,1,0,1,1,0.004577,4,0.257676,0.264843,0
十九年(1946),十九年,notion,0,1,1,0,1,1,0.004564,4,0.256755,0.263104,0
十二(1946),十二,notion,0,4,4,0,5,5,0.044378,4,0.321119,0.360903,9023.307278
十二艘(1946),十二艘,notion,0,1,1,0,1,1,0.018893,4,0.282798,0.307938,0
十五(1946),十五,notion,0,4,4,0,6,6,0.030406,4,0.297675,0.330246,5814.797553
十五天(1946),十五天,notion,0,5,5,0,6,6,0.068645,4,0.358573,0.401635,13737.713567
十五岁(1946),十五岁,notion,0,1,1,0,1,1,0.018893,4,0.282798,0.307938,0
十八(1946),十八,notion,0,1,1,0,1,1,0.00826,4,0.264992,0.278237,0
十周年(1946),十周年,notion,0,3,3,0,3,3,0.033639,4,0.301452,0.335435,3196.708035
十四(1946),十四,notion,0,2,2,0,3,3,0.02274,4,0.286006,0.312967,1109.932808
十四行(1946),十四行,notion,0,1,1,0,1,1,0.004577,4,0.257676,0.264843,0
十大(1946),十大,notion,0,1,1,0,1,1,0.017626,4,0.281496,0.305894,0
十天(1946),十天,notion,0,1,1,0,1,1,0.018893,4,0.282798,0.307938,0
十字架(1946),十字架,notion,0,2,2,0,2,2,0.018938,4,0.282437,0.307445,1861.68946
十字街头(1946),十字街头,notion,0,1,1,0,1,1,0.017626,4,0.281496,0.305894,0
十字路口(1946),十字路口,notion,0,1,1,0,1,1,0.013634,4,0.273332,0.292631,0
十年(1946),十年,notion,0,3,3,0,3,3,0.025113,4,0.287839,0.315823,2764.206272
十年如一日(1946),十年如一日,notion,0,1,1,0,1,1,0.005461,4,0.25793,0.265322,0
十数年(1946),十数年,notion,0,1,1,0,1,1,0.007159,4,0.261235,0.271453,0
十月革命(1946),十月革命,notion,0,1,1,0,5,5,0.013103,4,0.272684,0.291543,0
十粪(1946),十粪,notion,0,1,1,0,1,1,0.013634,4,0.273332,0.292631,0
十读(1946),十读,notion,0,1,1,0,1,1,0.013378,4,0.272039,0.290456,0
千千万万(1946),千千万万,notion,0,1,1,0,1,1,0.018893,4,0.282798,0.307938,0
千岛(1946),千岛,notion,0,1,1,0,1,1,0.013103,4,0.272684,0.291543,0
千百万(1946),千百万,notion,0,1,1,0,1,1,0.007159,4,0.261235,0.271453,0
千肯(1946),千肯,notion,0,1,1,0,1,1,0.018893,4,0.282798,0.307938,0
卅日(1946),卅日,notion,0,1,1,0,1,1,0.018893,4,0.282798,0.307938,0
升官(1946),升官,notion,0,1,1,0,1,1,0.005461,4,0.25793,0.265322,0
半山(1946),半山,notion,0,1,1,0,1,1,0.003608,4,0.255568,0.260842,0
半年(1946),半年,notion,0,2,2,0,3,3,0.021363,4,0.287407,0.315098,2175.293762
半日(1946),半日,notion,0,1,1,0,1,1,0.004237,4,0.256206,0.26206,0
半月(1946),半月,notion,0,2,2,0,3,3,0.02219,4,0.287062,0.314576,1087.606545
半月刊(1946),半月刊,notion,0,1,1,0,1,1,0.013378,4,0.272039,0.290456,0
半殖民地(1946),半殖民地,notion,0,1,1,0,1,1,0.013378,4,0.272039,0.290456,0
华中(1946),华中,notion,0,1,1,0,1,1,0.018893,4,0.282798,0.307938,0
华侨(1946),华侨,notion,0,3,3,0,3,3,0.044638,4,0.323432,0.363614,5148.150283
华南(1946),华南,notion,0,1,1,0,1,1,0.004479,4,0.256686,0.262973,0
华商报(1946),华商报,notion,0,1,1,0,1,1,0.018893,4,0.282798,0.307938,0
华士(1946),华士,notion,0,1,1,0,1,1,0.013378,4,0.272039,0.290456,0
华战日(1946),华战日,notion,0,1,1,0,1,1,0.017626,4,0.281496,0.305894,0
华盛顿(1946),华盛顿,notion,0,3,3,0,3,3,0.036573,4,0.311278,0.348524,4825.118579
华竟(1946),华竟,notion,0,1,1,0,1,1,0.013378,4,0.272039,0.290456,0
华罗庚(1946),华罗庚,notion,0,1,1,0,1,1,0.018893,4,0.282798,0.307938,0
协和(1946),协和,notion,0,1,1,0,1,1,0.013103,4,0.272684,0.291543,0
协商(1946),协商,notion,0,1,1,0,2,2,0.013378,4,0.272039,0.290456,0
协商会议(1946),协商会议,notion,0,3,3,0,3,3,0.022195,4,0.282603,0.307778,1575.210154
协国(1946),协国,notion,0,1,1,0,1,1,0.013378,4,0.272039,0.290456,0
协定(1946),协定,notion,0,4,4,0,5,5,0.035806,4,0.305652,0.341204,5572.904071
协议(1946),协议,notion,0,3,3,0,3,3,0.034612,4,0.306859,0.342741,3783.649272
协进会(1946),协进会,notion,0,1,1,0,1,1,0.017626,4,0.281496,0.305894,0
卓然(1946),卓然,notion,0,1,1,0,1,1,0.005461,4,0.25793,0.265322,0
单帮(1946),单帮,notion,0,1,1,0,1,1,0.013634,4,0.273332,0.292631,0
单车(1946),单车,notion,0,1,1,0,1,1,0.013634,4,0.273332,0.292631,0
卖国(1946),卖国,notion,0,1,1,0,1,1,0.00826,4,0.264992,0.278237,0
南北(1946),南北,notion,0,1,1,0,1,1,0.004479,4,0.256686,0.262973,0
南北朝(1946),南北朝,notion,0,2,2,0,2,2,0.036519,4,0.313896,0.3518,2490.161613
南北极(1946),南北极,notion,0,1,1,0,1,1,0.009637,4,0.265506,0.27915,0
南宁(1946),南宁,notion,0,1,1,0,1,1,0.018893,4,0.282798,0.307938,0
南斯拉夫(1946),南斯拉夫,notion,0,4,4,0,4,4,0.054102,4,0.341775,0.384429,9269.71724
南昌(1946),南昌,notion,0,2,2,0,2,2,0.027011,4,0.292079,0.322056,1114.922273
南洋(1946),南洋,notion,0,4,4,0,4,4,0.057056,4,0.342753,0.385473,8821.325701
南洋群岛(1946),南洋群岛,notion,0,1,1,0,1,1,0.013103,4,0.272684,0.291543,0
博士(1946),博士,notion,0,3,3,0,3,3,0.027304,4,0.291162,0.32078,2457.05072
占领(1946),占领,notion,0,1,1,0,1,1,0.00826,4,0.264992,0.278237,0
占领区(1946),占领区,notion,0,1,1,0,1,1,0.013103,4,0.272684,0.291543,0
卡片(1946),卡片,notion,0,1,1,0,1,1,0.018893,4,0.282798,0.307938,0
卡逊(1946),卡逊,notion,0,1,1,0,1,1,0.018893,4,0.282798,0.307938,0
卢汉(1946),卢汉,notion,0,1,1,0,1,1,0.004577,4,0.257676,0.264843,0
印关(1946),印关,notion,0,1,1,0,1,1,0.017626,4,0.281496,0.305894,0
印刷业(1946),印刷业,notion,0,1,1,0,1,1,0.004479,4,0.256686,0.262973,0
印刷所(1946),印刷所,notion,0,1,1,0,1,1,0.005304,4,0.259537,0.268322,0
印回(1946),印回,notion,0,1,1,0,1,1,0.018893,4,0.282798,0.307938,0
印度尼西亚(1946),印度尼西亚,notion,0,1,1,0,1,1,0.013103,4,0.272684,0.291543,0
危害(1946),危害,notion,0,1,1,0,1,1,0.017626,4,0.281496,0.305894,0
危局(1946),危局,notion,0,1,1,0,1,1,0.004237,4,0.256206,0.26206,0
危机(1946),危机,notion,0,9,9,0,14,14,0.099398,4,0.420833,0.453499,44088.560775
危楼(1946),危楼,notion,0,1,1,0,1,1,0.00826,4,0.264992,0.278237,0
危言(1946),危言,notion,0,1,1,0,1,1,0.007159,4,0.261235,0.271453,0
危险(1946),危险,notion,0,2,2,0,2,2,0.02853,4,0.295746,0.327361,1236.887723
危险期(1946),危险期,notion,0,1,1,0,1,1,0.009637,4,0.265506,0.27915,0
即刻(1946),即刻,notion,0,1,1,0,1,1,0.007159,4,0.261235,0.271453,0
厄运(1946),厄运,notion,0,1,1,0,1,1,0.013634,4,0.273332,0.292631,0
历程(1946),历程,notion,0,1,1,0,1,1,0.013103,4,0.272684,0.291543,0
压林(1946),压林,notion,0,1,1,0,1,1,0.013378,4,0.272039,0.290456,0
原则(1946),原则,notion,0,4,4,0,6,6,0.038029,4,0.310505,0.347597,7450.780004
原因(1946),原因,notion,0,5,5,0,5,5,0.04743,4,0.327709,0.368803,12423.737393
原子弹(1946),原子弹,notion,0,8,8,0,13,13,0.097909,4,0.41536,0.449513,35094.681363
原文(1946),原文,notion,0,1,1,0,1,1,0.00826,4,0.264992,0.278237,0
原是(1946),原是,notion,0,1,1,0,1,1,0.018893,4,0.282798,0.307938,0
原来如此(1946),原来如此,notion,0,1,1,0,1,1,0.013378,4,0.272039,0.290456,0
原着(1946),原着,notion,0,1,1,0,1,1,0.017626,4,0.281496,0.305894,0
原题(1946),原题,notion,0,2,2,0,2,2,0.02853,4,0.295746,0.327361,1236.887723
厦门(1946),厦门,notion,0,1,1,0,1,1,0.0031,4,0.254504,0.258799,0
去向(1946),去向,notion,0,1,1,0,1,1,0.004577,4,0.257676,0.264843,0
去职(1946),去职,notion,0,1,1,0,1,1,0.004564,4,0.256755,0.263104,0
县政(1946),县政,notion,0,1,1,0,1,1,0.017626,4,0.281496,0.305894,0
县长(1946),县长,notion,0,3,3,0,3,3,0.032316,4,0.301294,0.335218,4537.711267
参会(1946),参会,notion,0,1,1,0,1,1,0.013634,4,0.273332,0.292631,0
参加(1946),参加,notion,0,2,2,0,3,3,0.022931,4,0.290456,0.319664,2102.663893
参加国(1946),参加国,notion,0,1,1,0,1,1,0.009637,4,0.265506,0.27915,0
参政会(1946),参政会,notion,0,3,3,0,3,3,0.028732,4,0.292585,0.322868,2278.07058
参考资料(1946),参考资料,notion,0,1,1,0,1,1,0.013103,4,0.272684,0.291543,0
参议会(1946),参议会,notion,0,3,3,0,5,5,0.045904,4,0.321478,0.361266,4001.310187
参议员(1946),参议员,notion,0,1,1,0,1,1,0.013634,4,0.273332,0.292631,0
及闻(1946),及闻,notion,0,1,1,0,1,1,0.005461,4,0.25793,0.265322,0
友人(1946),友人,notion,0,2,2,0,2,2,0.02313,4,0.287378,0.315055,697.222
友情(1946),友情,notion,0,1,1,0,1,1,0.017626,4,0.281496,0.305894,0
友谊(1946),友谊,notion,0,2,2,0,3,3,0.030729,4,0.302946,0.337407,2092.27198
双包(1946),双包,notion,0,1,1,0,1,1,0.001496,4,0.252204,0.25432,0
双十(1946),双十,notion,0,4,4,0,6,6,0.043909,4,0.314514,0.352728,5066.114303
双簧(1946),双簧,notion,0,1,1,0,1,1,0.018893,4,0.282798,0.307938,0
反串(1946),反串,notion,0,1,1,0,1,1,0.007159,4,0.261235,0.271453,0
反侵略(1946),反侵略,notion,0,1,1,0,1,1,0.013103,4,0.272684,0.291543,0
反俄(1946),反俄,notion,0,1,1,0,1,1,0.009637,4,0.265506,0.27915,0
反动势力(1946),反动势力,notion,0,3,3,0,3,3,0.022801,4,0.283244,0.308778,1618.555697
反动派(1946),反动派,notion,0,5,5,0,9,9,0.041698,4,0.315342,0.353844,9628.275256
反响(1946),反响,notion,0,1,1,0,1,1,0.017626,4,0.281496,0.305894,0
反对党(1946),反对党,notion,0,2,2,0,2,2,0.027011,4,0.292079,0.322056,1114.922273
反对派(1946),反对派,notion,0,1,1,0,1,1,0.004564,4,0.256755,0.263104,0
反应(1946),反应,notion,0,1,1,0,1,1,0.009637,4,0.265506,0.27915,0
反战(1946),反战,notion,0,1,1,0,1,1,0.00826,4,0.264992,0.278237,0
反抗(1946),反抗,notion,0,2,2,0,2,2,0.017582,4,0.278308,0.300878,864.242178
反抢(1946),反抢,notion,0,1,1,0,1,1,0.00826,4,0.264992,0.278237,0
反映(1946),反映,notion,0,2,2,0,2,2,0.013564,4,0.274324,0.294356,2085.288442
反死(1946),反死,notion,0,1,1,0,1,1,0.007159,4,0.261235,0.271453,0
反民主(1946),反民主,notion,0,4,4,0,5,5,0.049512,4,0.326147,0.366904,6740.433764
反法西斯(1946),反法西斯,notion,0,1,1,0,1,1,0.013103,4,0.272684,0.291543,0
反法西斯战争(1946),反法西斯战争,notion,0,1,1,0,1,1,0.013103,4,0.272684,0.291543,0
反美(1946),反美,notion,0,2,2,0,2,2,0.031004,4,0.302277,0.336493,1833.728143
反苏(1946),反苏,notion,0,4,4,0,4,4,0.03555,4,0.303041,0.337682,4688.956651
反革命(1946),反革命,notion,0,1,1,0,1,1,0.018893,4,0.282798,0.307938,0
发刊(1946),发刊,notion,0,1,1,0,1,1,0.013103,4,0.272684,0.291543,0
发动(1946),发动,notion,0,1,1,0,1,1,0.013103,4,0.272684,0.291543,0
发扬(1946),发扬,notion,0,1,1,0,1,1,0.013103,4,0.272684,0.291543,0
发挥(1946),发挥,notion,0,1,1,0,2,2,0.005304,4,0.259537,0.268322,0
发现(1946),发现,notion,0,1,1,0,1,1,0.017626,4,0.281496,0.305894,0
发生(1946),发生,notion,0,2,2,0,2,2,0.02274,4,0.286006,0.312967,1109.932808
发疯(1946),发疯,notion,0,1,1,0,1,1,0.018893,4,0.282798,0.307938,0
发芽(1946),发芽,notion,0,1,1,0,1,1,0.013634,4,0.273332,0.292631,0
发行(1946),发行,notion,0,2,2,0,2,2,0.022931,4,0.290456,0.319664,2102.663893
发表(1946),发表,notion,0,2,2,0,2,2,0.031004,4,0.302277,0.336493,1833.728143
发言(1946),发言,notion,0,1,1,0,1,1,0.013103,4,0.272684,0.291543,0
发言人(1946),发言人,notion,0,1,1,0,1,1,0.00826,4,0.264992,0.278237,0
发财(1946),发财,notion,0,1,1,0,1,1,0.013378,4,0.272039,0.290456,0
取样(1946),取样,notion,0,1,1,0,1,1,0.013378,4,0.272039,0.290456,0
取消(1946),取消,notion,0,3,3,0,3,3,0.031248,4,0.296661,0.328738,2223.968046
取缔(1946),取缔,notion,0,1,1,0,1,1,0.017626,4,0.281496,0.305894,0
受不了(1946),受不了,notion,0,1,1,0,1,1,0.017626,4,0.281496,0.305894,0
受伤(1946),受伤,notion,0,1,1,0,1,1,0.004237,4,0.256206,0.26206,0
受审(1946),受审,notion,0,1,1,0,3,3,0.013634,4,0.273332,0.292631,0
变为(1946),变为,notion,0,1,1,0,1,1,0.007159,4,0.261235,0.271453,0
变乱(1946),变乱,notion,0,1,1,0,1,1,0.004577,4,0.257676,0.264843,0
变化(1946),变化,notion,0,1,1,0,1,1,0.017626,4,0.281496,0.305894,0
变爱(1946),变爱,notion,0,1,1,0,2,2,0.017626,4,0.281496,0.305894,0
变端(1946),变端,notion,0,1,1,0,2,2,0.005304,4,0.259537,0.268322,0
变质(1946),变质,notion,0,1,1,0,1,1,0.007159,4,0.261235,0.271453,0
变迁(1946),变迁,notion,0,2,2,0,2,2,0.02347,4,0.289958,0.318925,1721.315005
变革(1946),变革,notion,0,1,1,0,1,1,0.005304,4,0.259537,0.268322,0
叙利亚(1946),叙利亚,notion,0,1,1,0,2,2,0.013103,4,0.272684,0.291543,0
叛国(1946),叛国,notion,0,1,1,0,1,1,0.00826,4,0.264992,0.278237,0
口中(1946),口中,notion,0,2,2,0,2,2,0.027153,4,0.296784,0.32884,1981.441549
口号(1946),口号,notion,0,1,1,0,1,1,0.013378,4,0.272039,0.290456,0
口是心非(1946),口是心非,notion,0,2,2,0,2,2,0.009698,4,0.262356,0.273569,160.636246
口红(1946),口红,notion,0,1,1,0,1,1,0.007159,4,0.261235,0.271453,0
口诛笔伐(1946),口诛笔伐,notion,0,1,1,0,1,1,0.018893,4,0.282798,0.307938,0
古代(1946),古代,notion,0,1,1,0,1,1,0.007159,4,0.261235,0.271453,0
古代篇(1946),古代篇,notion,0,1,1,0,1,1,0.004564,4,0.256755,0.263104,0
古城(1946),古城,notion,0,1,1,0,1,1,0.004577,4,0.257676,0.264843,0
古录(1946),古录,notion,0,1,1,0,1,1,0.018893,4,0.282798,0.307938,0
古都(1946),古都,notion,0,1,1,0,1,1,0.013634,4,0.273332,0.292631,0
另一手(1946),另一手,notion,0,1,1,0,1,1,0.013634,4,0.273332,0.292631,0
只好(1946),只好,notion,0,1,1,0,1,1,0.013378,4,0.272039,0.290456,0
只收(1946),只收,notion,0,1,1,0,1,1,0.013634,4,0.273332,0.292631,0
只是(1946),只是,notion,0,1,1,0,1,1,0.013634,4,0.273332,0.292631,0
只有(1946),只有,notion,0,7,7,0,7,7,0.073467,4,0.367607,0.410347,24483.812148
只要(1946),只要,notion,0,1,1,0,1,1,0.018893,4,0.282798,0.307938,0
只许(1946),只许,notion,0,1,1,0,1,1,0.018893,4,0.282798,0.307938,0
叫做(1946),叫做,notion,0,3,3,0,3,3,0.041908,4,0.31393,0.351916,3405.961451
召集(1946),召集,notion,0,1,1,0,1,1,0.017626,4,0.281496,0.305894,0
召集人(1946),召集人,notion,0,1,1,0,1,1,0.009637,4,0.265506,0.27915,0
叭儿狗(1946),叭儿狗,notion,0,1,1,0,1,1,0.001496,4,0.252204,0.25432,0
可以(1946),可以,notion,0,2,2,0,2,2,0.018113,4,0.278577,0.301313,749.731439
可怕(1946),可怕,notion,0,2,2,0,2,2,0.018938,4,0.282437,0.307445,1861.68946
可怜(1946),可怜,notion,0,2,2,0,2,2,0.020536,4,0.280891,0.30501,760.639997
可惜(1946),可惜,notion,0,1,1,0,2,2,0.018893,4,0.282798,0.307938,0
可杀(1946),可杀,notion,0,1,1,0,1,1,0.013103,4,0.272684,0.291543,0
可畏(1946),可畏,notion,0,1,1,0,1,1,0.013378,4,0.272039,0.290456,0
可行(1946),可行,notion,0,1,1,0,1,1,0.017626,4,0.281496,0.305894,0
可见一斑(1946),可见一斑,notion,0,1,1,0,1,1,0.017626,4,0.281496,0.305894,0
可观(1946),可观,notion,0,1,1,0,1,1,0.00826,4,0.264992,0.278237,0
台人(1946),台人,notion,0,1,1,0,1,1,0.018893,4,0.282798,0.307938,0
台做(1946),台做,notion,0,1,1,0,1,1,0.00826,4,0.264992,0.278237,0
台北(1946),台北,notion,0,1,1,0,1,1,0.013634,4,0.273332,0.292631,0
台胞(1946),台胞,notion,0,1,1,0,1,1,0.007159,4,0.261235,0.271453,0
台鉴(1946),台鉴,notion,0,1,1,0,1,1,0.017626,4,0.281496,0.305894,0
史大林宪法(1946),史大林宪法,notion,0,1,1,0,1,1,0.013103,4,0.272684,0.291543,0
史学史(1946),史学史,notion,0,1,1,0,1,1,0.017626,4,0.281496,0.305894,0
史实(1946),史实,notion,0,1,1,0,1,1,0.013378,4,0.272039,0.290456,0
史料(1946),史料,notion,0,2,2,0,4,4,0.017667,4,0.277985,0.300357,781.701364
史达林(1946),史达林,notion,0,1,1,0,1,1,0.017626,4,0.281496,0.305894,0
史迪威(1946),史迪威,notion,0,2,2,0,4,4,0.036519,4,0.313896,0.3518,2490.161613
叶挺(1946),叶挺,notion,0,3,3,0,4,4,0.034023,4,0.304841,0.340045,2961.289954
叶楼(1946),叶楼,notion,0,1,1,0,1,1,0.017626,4,0.281496,0.305894,0
号角(1946),号角,notion,0,2,2,0,2,2,0.018682,4,0.280974,0.30514,1561.099535
司徒(1946),司徒,notion,0,5,5,0,6,6,0.06217,4,0.344768,0.387676,11404.612385
司徒美堂(1946),司徒美堂,notion,0,1,1,0,1,1,0.004479,4,0.256686,0.262973,0
司徒雷登(1946),司徒雷登,notion,0,3,3,0,4,4,0.045904,4,0.321478,0.361266,4001.310187
司法(1946),司法,notion,0,1,1,0,1,1,0.007159,4,0.261235,0.271453,0
司法制度(1946),司法制度,notion,0,1,1,0,1,1,0.004577,4,0.257676,0.264843,0
司派(1946),司派,notion,0,1,1,0,1,1,0.013634,4,0.273332,0.292631,0
司空(1946),司空,notion,0,1,1,0,1,1,0.018893,4,0.282798,0.307938,0
司马(1946),司马,notion,0,2,2,0,2,2,0.036519,4,0.313896,0.3518,2490.161613
吃奶(1946),吃奶,notion,0,1,1,0,1,1,0.013634,4,0.273332,0.292631,0
各党派(1946),各党派,notion,0,3,3,0,3,3,0.032198,4,0.300947,0.334739,3304.437359
各国(1946),各国,notion,0,2,2,0,2,2,0.020262,4,0.282243,0.30714,1027.722249
各大(1946),各大,notion,0,1,1,0,1,1,0.013103,4,0.272684,0.291543,0
各政党(1946),各政党,notion,0,1,1,0,1,1,0.009637,4,0.265506,0.27915,0
各方(1946),各方,notion,0,1,1,0,1,1,0.017626,4,0.281496,0.305894,0
各界(1946),各界,notion,0,3,3,0,3,3,0.040786,4,0.31831,0.357395,5617.041193
各自(1946),各自,notion,0,1,1,0,1,1,0.009637,4,0.265506,0.27915,0
合一(1946),合一,notion,0,2,2,0,2,2,0.025886,4,0.296968,0.329101,2935.752997
合众(1946),合众,notion,0,1,1,0,1,1,0.013103,4,0.272684,0.291543,0
合同(1946),合同,notion,0,1,1,0,1,1,0.004564,4,0.256755,0.263104,0
合唱(1946),合唱,notion,0,1,1,0,1,1,0.013103,4,0.272684,0.291543,0
合唱团(1946),合唱团,notion,0,1,1,0,1,1,0.018893,4,0.282798,0.307938,0
合川(1946),合川,notion,0,1,1,0,1,1,0.013634,4,0.273332,0.292631,0
合法(1946),合法,notion,0,1,1,0,1,1,0.017626,4,0.281496,0.305894,0
吉普(1946),吉普,notion,0,1,1,0,1,1,0.004577,4,0.257676,0.264843,0
吉田(1946),吉田,notion,0,2,2,0,2,2,0.01734,4,0.277877,0.300183,713.880954
同一个(1946),同一个,notion,0,1,1,0,1,1,0.013103,4,0.272684,0.291543,0
同业(1946),同业,notion,0,1,1,0,1,1,0.018893,4,0.282798,0.307938,0
同人(1946),同人,notion,0,1,1,0,1,1,0.005304,4,0.259537,0.268322,0
同友(1946),同友,notion,0,1,1,0,1,1,0.017626,4,0.281496,0.305894,0
同姓(1946),同姓,notion,0,1,1,0,1,1,0.017626,4,0.281496,0.305894,0
同学(1946),同学,notion,0,3,3,0,4,4,0.043678,4,0.323323,0.363484,4955.460855
同志(1946),同志,notion,0,3,3,0,4,4,0.026824,4,0.293871,0.324738,3730.716385
同志会(1946),同志会,notion,0,1,1,0,1,1,0.004479,4,0.256686,0.262973,0
同时(1946),同时,notion,0,1,1,0,1,1,0.017626,4,0.281496,0.305894,0
同时代(1946),同时代,notion,0,1,1,0,1,1,0.017626,4,0.281496,0.305894,0
同正(1946),同正,notion,0,1,1,0,1,1,0.007159,4,0.261235,0.271453,0
同盟(1946),同盟,notion,0,1,1,0,1,1,0.004564,4,0.256755,0.263104,0
同看(1946),同看,notion,0,1,1,0,1,1,0.007159,4,0.261235,0.271453,0
名单(1946),名单,notion,0,1,1,0,1,1,0.005461,4,0.25793,0.265322,0
名字(1946),名字,notion,0,1,1,0,1,1,0.018893,4,0.282798,0.307938,0
名牌(1946),名牌,notion,0,1,1,0,1,1,0.013378,4,0.272039,0.290456,0
名画(1946),名画,notion,0,1,1,0,1,1,0.013378,4,0.272039,0.290456,0
名誌(1946),名誌,notion,0,1,1,0,1,1,0.004479,4,0.256686,0.262973,0
后援(1946),后援,notion,0,1,1,0,1,1,0.018893,4,0.282798,0.307938,0
后方(1946),后方,notion,0,1,1,0,1,1,0.00826,4,0.264992,0.278237,0
后果(1946),后果,notion,0,1,1,0,1,1,0.004479,4,0.256686,0.262973,0
后能(1946),后能,notion,0,1,1,0,1,1,0.013634,4,0.273332,0.292631,0
后语(1946),后语,notion,0,1,1,0,1,1,0.013378,4,0.272039,0.290456,0
后面(1946),后面,notion,0,2,2,0,2,2,0.031996,4,0.303907,0.338711,1883.718005
向着(1946),向着,notion,0,1,1,0,1,1,0.013378,4,0.272039,0.290456,0
向订(1946),向订,notion,0,1,1,0,1,1,0.017626,4,0.281496,0.305894,0
吕梁(1946),吕梁,notion,0,1,1,0,1,1,0.004564,4,0.256755,0.263104,0
君主(1946),君主,notion,0,1,1,0,1,1,0.009637,4,0.265506,0.27915,0
君道(1946),君道,notion,0,1,1,0,1,1,0.018893,4,0.282798,0.307938,0
吞下(1946),吞下,notion,0,1,1,0,1,1,0.00826,4,0.264992,0.278237,0
否认(1946),否认,notion,0,1,1,0,1,1,0.005461,4,0.25793,0.265322,0
含治人(1946),含治人,notion,0,1,1,0,1,1,0.017626,4,0.281496,0.305894,0
含笑(1946),含笑,notion,0,1,1,0,1,1,0.017626,4,0.281496,0.305894,0
听不清(1946),听不清,notion,0,1,1,0,1,1,0.013634,4,0.273332,0.292631,0
听任(1946),听任,notion,0,1,1,0,1,1,0.017626,4,0.281496,0.305894,0
听到(1946),听到,notion,0,2,2,0,2,2,0.026737,4,0.295411,0.326883,1969.400217
听审(1946),听审,notion,0,2,2,0,3,3,0.03126,4,0.304035,0.338885,2199.499867
听得(1946),听得,notion,0,1,1,0,1,1,0.013103,4,0.272684,0.291543,0
听见(1946),听见,notion,0,1,1,0,1,1,0.018893,4,0.282798,0.307938,0
启示(1946),启示,notion,0,3,3,0,3,3,0.036309,4,0.311514,0.348829,5497.49157
启蒙运动(1946),启蒙运动,notion,0,1,1,0,1,1,0.004564,4,0.256755,0.263104,0
吴江(1946),吴江,notion,0,1,1,0,1,1,0.013378,4,0.272039,0.290456,0
吴谷(1946),吴谷,notion,0,1,1,0,1,1,0.00826,4,0.264992,0.278237,0
吴铁城(1946),吴铁城,notion,0,1,1,0,1,1,0.00826,4,0.264992,0.278237,0
吴鼎昌(1946),吴鼎昌,notion,0,1,1,0,1,1,0.018893,4,0.282798,0.307938,0
吹度(1946),吹度,notion,0,1,1,0,1,1,0.017626,4,0.281496,0.305894,0
吾人(1946),吾人,notion,0,1,1,0,1,1,0.00826,4,0.264992,0.278237,0
吾兄(1946),吾兄,notion,0,1,1,0,1,1,0.004577,4,0.257676,0.264843,0
吾国(1946),吾国,notion,0,1,1,0,1,1,0.009637,4,0.265506,0.27915,0
吾师(1946),吾师,notion,0,2,2,0,2,2,0.032527,4,0.303393,0.338015,1614.891208
吾爱(1946),吾爱,notion,0,1,1,0,1,1,0.013634,4,0.273332,0.292631,0
呈献(1946),呈献,notion,0,1,1,0,1,1,0.004479,4,0.256686,0.262973,0
呜呼(1946),呜呼,notion,0,1,1,0,1,1,0.013634,4,0.273332,0.292631,0
周作人(1946),周作人,notion,0,3,3,0,3,3,0.050153,4,0.336337,0.378443,6304.552689
周保中(1946),周保中,notion,0,1,1,0,1,1,0.018893,4,0.282798,0.307938,0
周信芳(1946),周信芳,notion,0,1,1,0,1,1,0.018893,4,0.282798,0.307938,0
周刊(1946),周刊,notion,0,2,2,0,2,2,0.017897,4,0.280261,0.304009,1765.875744
周年纪念(1946),周年纪念,notion,0,3,3,0,6,6,0.035293,4,0.30834,0.344698,3961.57989
周恩来(1946),周恩来,notion,0,3,3,0,3,3,0.044779,4,0.329588,0.370833,7407.356159
周报(1946),周报,notion,0,2,2,0,12,12,0.027011,4,0.292079,0.322056,1114.922273
周期性(1946),周期性,notion,0,1,1,0,1,1,0.013103,4,0.272684,0.291543,0
周济(1946),周济,notion,0,1,1,0,1,1,0.018893,4,0.282798,0.307938,0
周浦(1946),周浦,notion,0,1,1,0,1,1,0.005304,4,0.259537,0.268322,0
呼冤(1946),呼冤,notion,0,1,1,0,1,1,0.007159,4,0.261235,0.271453,0
呼呼(1946),呼呼,notion,0,1,1,0,1,1,0.013634,4,0.273332,0.292631,0
呼声(1946),呼声,notion,0,4,4,0,9,9,0.053253,4,0.339836,0.382342,8689.08386
呼籲(1946),呼籲,notion,0,2,2,0,3,3,0.013874,4,0.270198,0.287398,402.340627
命令(1946),命令,notion,0,1,1,0,3,3,0.004237,4,0.256206,0.26206,0
命运(1946),命运,notion,0,5,5,0,8,8,0.070689,4,0.366155,0.408854,14813.400083
咀咒(1946),咀咒,notion,0,1,1,0,1,1,0.005461,4,0.25793,0.265322,0
咀嚼(1946),咀嚼,notion,0,1,1,0,1,1,0.005304,4,0.259537,0.268322,0
和亲(1946),和亲,notion,0,1,1,0,1,1,0.007159,4,0.261235,0.271453,0
和平攻势(1946),和平攻势,notion,0,4,4,0,5,5,0.04587,4,0.320725,0.360425,6043.982116
和平统一(1946),和平统一,notion,0,1,1,0,1,1,0.009637,4,0.265506,0.27915,0
和平解决(1946),和平解决,notion,0,1,1,0,1,1,0.009637,4,0.265506,0.27915,0
和平谈判(1946),和平谈判,notion,0,1,1,0,1,1,0.004237,4,0.256206,0.26206,0
和秀婉(1946),和秀婉,notion,0,1,1,0,1,1,0.004564,4,0.256755,0.263104,0
和约(1946),和约,notion,0,1,1,0,1,1,0.009637,4,0.265506,0.27915,0
和而不同(1946),和而不同,notion,0,1,1,0,1,1,0.005304,4,0.259537,0.268322,0
和谈(1946),和谈,notion,0,3,3,0,4,4,0.03679,4,0.310237,0.347176,4984.205015
咏雪(1946),咏雪,notion,0,1,1,0,1,1,0.018893,4,0.282798,0.307938,0
咖啡(1946),咖啡,notion,0,1,1,0,1,1,0.013634,4,0.273332,0.292631,0
哀悼(1946),哀悼,notion,0,2,2,0,2,2,0.020389,4,0.284308,0.310358,712.812748
哀愁(1946),哀愁,notion,0,1,1,0,1,1,0.018893,4,0.282798,0.307938,0
哀求(1946),哀求,notion,0,1,1,0,1,1,0.009637,4,0.265506,0.27915,0
哀词(1946),哀词,notion,0,1,1,0,1,1,0.013378,4,0.272039,0.290456,0
哀费筱芝(1946),哀费筱芝,notion,0,1,1,0,1,1,0.018893,4,0.282798,0.307938,0
哀鸣(1946),哀鸣,notion,0,1,1,0,1,1,0.013634,4,0.273332,0.292631,0
哈尔滨(1946),哈尔滨,notion,0,1,1,0,2,2,0.00826,4,0.264992,0.278237,0
哈林致(1946),哈林致,notion,0,1,1,0,1,1,0.013103,4,0.272684,0.291543,0
哈而滨(1946),哈而滨,notion,0,1,1,0,1,1,0.013378,4,0.272039,0.290456,0
哈萨克(1946),哈萨克,notion,0,1,1,0,1,1,0.017626,4,0.281496,0.305894,0
哈里曼(1946),哈里曼,notion,0,1,1,0,1,1,0.009637,4,0.265506,0.27915,0
响应(1946),响应,notion,0,5,5,0,6,6,0.06427,4,0.355953,0.399069,13449.251178
哥哥(1946),哥哥,notion,0,1,1,0,1,1,0.007159,4,0.261235,0.271453,0
哨兵(1946),哨兵,notion,0,1,1,0,1,1,0.013103,4,0.272684,0.291543,0
哪里(1946),哪里,notion,0,1,1,0,2,2,0.018893,4,0.282798,0.307938,0
哭四弟(1946),哭四弟,notion,0,1,1,0,1,1,0.004479,4,0.256686,0.262973,0
哭诉(1946),哭诉,notion,0,1,1,0,1,1,0.003608,4,0.255568,0.260842,0
哭闻(1946),哭闻,notion,0,1,1,0,1,1,0.013378,4,0.272039,0.290456,0
唐吉珂德(1946),唐吉珂德,notion,0,1,1,0,1,1,0.013634,4,0.273332,0.292631,0
唯物(1946),唯物,notion,0,1,1,0,1,1,0.004564,4,0.256755,0.263104,0
唯物论(1946),唯物论,notion,0,1,1,0,1,1,0.005461,4,0.25793,0.265322,0
啄木鸟(1946),啄木鸟,notion,0,1,1,0,1,1,0.013103,4,0.272684,0.291543,0
商业(1946),商业,notion,0,1,1,0,1,1,0.00826,4,0.264992,0.278237,0
商业部长(1946),商业部长,notion,0,1,1,0,1,1,0.009637,4,0.265506,0.27915,0
商人(1946),商人,notion,0,1,1,0,1,1,0.005304,4,0.259537,0.268322,0
商务(1946),商务,notion,0,1,1,0,1,1,0.018893,4,0.282798,0.307938,0
商品(1946),商品,notion,0,1,1,0,1,1,0.013634,4,0.273332,0.292631,0
商场(1946),商场,notion,0,1,1,0,1,1,0.00826,4,0.264992,0.278237,0
商榷(1946),商榷,notion,0,2,2,0,2,2,0.036519,4,0.313896,0.3518,2490.161613
商港(1946),商港,notion,0,1,1,0,1,1,0.013103,4,0.272684,0.291543,0
商议(1946),商议,notion,0,1,1,0,1,1,0.013378,4,0.272039,0.290456,0
商谈(1946),商谈,notion,0,3,3,0,3,3,0.035371,4,0.304583,0.339697,2689.912435
啓示(1946),啓示,notion,0,1,1,0,1,1,0.017626,4,0.281496,0.305894,0
啼笑皆非(1946),啼笑皆非,notion,0,1,1,0,1,1,0.001496,4,0.252204,0.25432,0
善后(1946),善后,notion,0,1,1,0,1,1,0.004577,4,0.257676,0.264843,0
善本(1946),善本,notion,0,1,1,0,1,1,0.018893,4,0.282798,0.307938,0
善爲(1946),善爲,notion,0,1,1,0,1,1,0.017626,4,0.281496,0.305894,0
喉咙(1946),喉咙,notion,0,1,1,0,1,1,0.013634,4,0.273332,0.292631,0
喜剧(1946),喜剧,notion,0,1,1,0,1,1,0.004479,4,0.256686,0.262973,0
喜欢(1946),喜欢,notion,0,1,1,0,1,1,0.005461,4,0.25793,0.265322,0
喜赋(1946),喜赋,notion,0,1,1,0,1,1,0.009637,4,0.265506,0.27915,0
喝水(1946),喝水,notion,0,1,1,0,1,1,0.007159,4,0.261235,0.271453,0
嘉兴(1946),嘉兴,notion,0,1,1,0,1,1,0.013634,4,0.273332,0.292631,0
嘱望(1946),嘱望,notion,0,1,1,0,1,1,0.018893,4,0.282798,0.307938,0
嘲笑(1946),嘲笑,notion,0,1,1,0,1,1,0.004237,4,0.256206,0.26206,0
噩梦(1946),噩梦,notion,0,1,1,0,1,1,0.013634,4,0.273332,0.292631,0
嚣张(1946),嚣张,notion,0,1,1,0,1,1,0.013103,4,0.272684,0.291543,0
四七(1946),四七,notion,0,1,1,0,1,1,0.013103,4,0.272684,0.291543,0
四个(1946),四个,notion,0,3,3,0,3,3,0.032316,4,0.301294,0.335218,4537.711267
四分之三(1946),四分之三,notion,0,1,1,0,1,1,0.009637,4,0.265506,0.27915,0
四十万(1946),四十万,notion,0,1,1,0,1,1,0.013103,4,0.272684,0.291543,0
四十九年(1946),四十九年,notion,0,1,1,0,1,1,0.005304,4,0.259537,0.268322,0
四卖(1946),四卖,notion,0,1,1,0,1,1,0.018893,4,0.282798,0.307938,0
四口(1946),四口,notion,0,1,1,0,1,1,0.018893,4,0.282798,0.307938,0
四周(1946),四周,notion,0,1,1,0,1,1,0.013634,4,0.273332,0.292631,0
四哥(1946),四哥,notion,0,1,1,0,1,1,0.018893,4,0.282798,0.307938,0
四国(1946),四国,notion,0,2,2,0,3,3,0.027264,4,0.294896,0.326144,1405.794223
四川(1946),四川,notion,0,1,1,0,1,1,0.017626,4,0.281496,0.305894,0
四川省(1946),四川省,notion,0,1,1,0,1,1,0.017626,4,0.281496,0.305894,0
四平(1946),四平,notion,0,1,1,0,1,1,0.018893,4,0.282798,0.307938,0
四年(1946),四年,notion,0,1,1,0,1,1,0.013103,4,0.272684,0.291543,0
四强(1946),四强,notion,0,1,1,0,1,1,0.009637,4,0.265506,0.27915,0
四强间(1946),四强间,notion,0,1,1,0,1,1,0.0031,4,0.254504,0.258799,0
四海(1946),四海,notion,0,1,1,0,1,1,0.018893,4,0.282798,0.307938,0
四百万(1946),四百万,notion,0,1,1,0,1,1,0.013378,4,0.272039,0.290456,0
四种(1946),四种,notion,0,1,1,0,1,1,0.004577,4,0.257676,0.264843,0
四贤(1946),四贤,notion,0,1,1,0,1,1,0.013378,4,0.272039,0.290456,0
四问(1946),四问,notion,0,1,1,0,1,1,0.017626,4,0.281496,0.305894,0
四项(1946),四项,notion,0,4,4,0,5,5,0.054001,4,0.340278,0.38282,10007.44091
四首(1946),四首,notion,0,1,1,0,1,1,0.009637,4,0.265506,0.27915,0
回乡(1946),回乡,notion,0,1,1,0,1,1,0.00826,4,0.264992,0.278237,0
回事(1946),回事,notion,0,1,1,0,1,1,0.013378,4,0.272039,0.290456,0
回到(1946),回到,notion,0,3,3,0,5,5,0.036573,4,0.311278,0.348524,4825.118579
回去(1946),回去,notion,0,2,2,0,2,2,0.026052,4,0.291576,0.321317,1054.556401
回头(1946),回头,notion,0,2,2,0,2,2,0.023456,4,0.28781,0.315707,881.141468
回家(1946),回家,notion,0,1,1,0,1,1,0.005304,4,0.259537,0.268322,0
回来(1946),回来,notion,0,1,1,0,2,2,0.007159,4,0.261235,0.271453,0
回答(1946),回答,notion,0,1,1,0,1,1,0.007159,4,0.261235,0.271453,0
回老家(1946),回老家,notion,0,1,1,0,1,1,0.018893,4,0.282798,0.307938,0
因于(1946),因于,notion,0,1,1,0,1,1,0.013634,4,0.273332,0.292631,0
因何(1946),因何,notion,0,1,1,0,1,1,0.013634,4,0.273332,0.292631,0
因果(1946),因果,notion,0,1,1,0,1,1,0.009637,4,0.265506,0.27915,0
因素(1946),因素,notion,0,1,1,0,1,1,0.004564,4,0.256755,0.263104,0
团沙(1946),团沙,notion,0,1,1,0,1,1,0.00826,4,0.264992,0.278237,0
团结(1946),团结,notion,0,4,4,0,4,4,0.039476,4,0.31607,0.354685,8574.849269
团结合作(1946),团结合作,notion,0,2,2,0,2,2,0.031996,4,0.303907,0.338711,1883.718005
团结起来(1946),团结起来,notion,0,1,1,0,1,1,0.00826,4,0.264992,0.278237,0
园地(1946),园地,notion,0,1,1,0,1,1,0.005304,4,0.259537,0.268322,0
困难(1946),困难,notion,0,1,1,0,1,1,0.005304,4,0.259537,0.268322,0
围剿(1946),围剿,notion,0,1,1,0,1,1,0.018893,4,0.282798,0.307938,0
围绕(1946),围绕,notion,0,2,2,0,2,2,0.031996,4,0.303907,0.338711,1883.718005
固有(1946),固有,notion,0,1,1,0,1,1,0.013634,4,0.273332,0.292631,0
国中(1946),国中,notion,0,1,1,0,1,1,0.007159,4,0.261235,0.271453,0
国事(1946),国事,notion,0,1,1,0,1,1,0.004479,4,0.256686,0.262973,0
国会(1946),国会,notion,0,1,1,0,2,2,0.004564,4,0.256755,0.263104,0
国体(1946),国体,notion,0,1,1,0,1,1,0.004577,4,0.257676,0.264843,0
国债(1946),国债,notion,0,1,1,0,1,1,0.017626,4,0.281496,0.305894,0
国共(1946),国共,notion,0,5,5,0,8,8,0.043498,4,0.318099,0.35728,10456.298186
国共两党(1946),国共两党,notion,0,2,2,0,2,2,0.008801,4,0.262212,0.273308,318.915578
国内外(1946),国内外,notion,0,2,2,0,2,2,0.030729,4,0.302946,0.337407,2092.27198
国内形势(1946),国内形势,notion,0,1,1,0,1,1,0.00826,4,0.264992,0.278237,0
国军(1946),国军,notion,0,1,1,0,2,2,0.017626,4,0.281496,0.305894,0
国和会(1946),国和会,notion,0,1,1,0,1,1,0.004577,4,0.257676,0.264843,0
国大代表(1946),国大代表,notion,0,5,5,0,10,10,0.055855,4,0.336731,0.379022,9417.916207
国定(1946),国定,notion,0,2,2,0,2,2,0.023015,4,0.2849,0.311272,897.577022
国币(1946),国币,notion,0,1,1,0,1,1,0.004479,4,0.256686,0.262973,0
国庆日(1946),国庆日,notion,0,1,1,0,1,1,0.013378,4,0.272039,0.290456,0
国府(1946),国府,notion,0,4,4,0,5,5,0.044505,4,0.322525,0.362599,7651.816509
国教(1946),国教,notion,0,1,1,0,1,1,0.004237,4,0.256206,0.26206,0
国民会议(1946),国民会议,notion,0,2,2,0,3,3,0.009043,4,0.262236,0.273352,284.685012
国民党二中全会(1946),国民党二中全会,notion,0,3,3,0,4,4,0.040114,4,0.313896,0.351873,4492.668279
国民政府(1946),国民政府,notion,0,1,1,0,2,2,0.018893,4,0.282798,0.307938,0
国社党(1946),国社党,notion,0,1,1,0,1,1,0.013634,4,0.273332,0.292631,0
国立(1946),国立,notion,0,2,2,0,2,2,0.03126,4,0.304035,0.338885,2199.499867
国营(1946),国营,notion,0,1,1,0,1,1,0.018893,4,0.282798,0.307938,0
国见(1946),国见,notion,0,1,1,0,1,1,0.017626,4,0.281496,0.305894,0
国运(1946),国运,notion,0,1,1,0,1,1,0.005461,4,0.25793,0.265322,0
国道(1946),国道,notion,0,1,1,0,1,1,0.017626,4,0.281496,0.305894,0
国都(1946),国都,notion,0,1,1,0,1,1,0.017626,4,0.281496,0.305894,0
国际共管(1946),国际共管,notion,0,1,1,0,1,1,0.009637,4,0.265506,0.27915,0
国际化(1946),国际化,notion,0,1,1,0,1,1,0.003608,4,0.255568,0.260842,0
国际局势(1946),国际局势,notion,0,2,2,0,3,3,0.03126,4,0.304035,0.338885,2199.499867
国际形势(1946),国际形势,notion,0,4,4,0,4,4,0.045562,4,0.324271,0.364687,6682.918102
国际舆论(1946),国际舆论,notion,0,1,1,0,1,1,0.013378,4,0.272039,0.290456,0
国际贸易(1946),国际贸易,notion,0,1,1,0,1,1,0.009637,4,0.265506,0.27915,0
国风(1946),国风,notion,0,1,1,0,1,1,0.009637,4,0.265506,0.27915,0
图书(1946),图书,notion,0,1,1,0,2,2,0.005304,4,0.259537,0.268322,0
图书馆(1946),图书馆,notion,0,2,2,0,3,3,0.018938,4,0.282437,0.307445,1861.68946
图属题(1946),图属题,notion,0,1,1,0,1,1,0.018893,4,0.282798,0.307938,0
圆满(1946),圆满,notion,0,1,1,0,1,1,0.0031,4,0.254504,0.258799,0
圈外(1946),圈外,notion,0,2,2,0,2,2,0.027011,4,0.292079,0.322056,1114.922273
土匪(1946),土匪,notion,0,1,1,0,1,1,0.00826,4,0.264992,0.278237,0
土地(1946),土地,notion,0,4,4,0,9,9,0.030595,4,0.299349,0.332594,5936.610874
土地税(1946),土地税,notion,0,1,1,0,1,1,0.004577,4,0.257676,0.264843,0
圣地(1946),圣地,notion,0,1,1,0,1,1,0.005461,4,0.25793,0.265322,0
圣约翰(1946),圣约翰,notion,0,1,1,0,1,1,0.009637,4,0.265506,0.27915,0
在于(1946),在于,notion,0,1,1,0,1,1,0.017626,4,0.281496,0.305894,0
在历史上(1946),在历史上,notion,0,1,1,0,1,1,0.007159,4,0.261235,0.271453,0
地中海(1946),地中海,notion,0,5,5,0,5,5,0.058308,4,0.342549,0.385328,11794.098938
地主(1946),地主,notion,0,1,1,0,1,1,0.007159,4,0.261235,0.271453,0
地图(1946),地图,notion,0,1,1,0,1,1,0.004479,4,0.256686,0.262973,0
地方(1946),地方,notion,0,6,6,0,7,7,0.071427,4,0.372079,0.414362,20555.475016
地方分权(1946),地方分权,notion,0,1,1,0,1,1,0.005461,4,0.25793,0.265322,0
地方化(1946),地方化,notion,0,1,1,0,1,1,0.00826,4,0.264992,0.278237,0
地方戏(1946),地方戏,notion,0,1,1,0,1,1,0.013634,4,0.273332,0.292631,0
地步(1946),地步,notion,0,1,1,0,1,1,0.013378,4,0.272039,0.290456,0
地狱(1946),地狱,notion,0,1,1,0,1,1,0.018893,4,0.282798,0.307938,0
地球(1946),地球,notion,0,2,2,0,2,2,0.018211,4,0.280617,0.304575,1609.081689
地说(1946),地说,notion,0,1,1,0,1,1,0.003608,4,0.255568,0.260842,0
地雷阵(1946),地雷阵,notion,0,1,1,0,1,1,0.00826,4,0.264992,0.278237,0
场上(1946),场上,notion,0,1,1,0,1,1,0.00826,4,0.264992,0.278237,0
场员(1946),场员,notion,0,1,1,0,1,1,0.005304,4,0.259537,0.268322,0
均势(1946),均势,notion,0,1,1,0,1,1,0.017626,4,0.281496,0.305894,0
坐在(1946),坐在,notion,0,1,1,0,1,1,0.013103,4,0.272684,0.291543,0
坐视(1946),坐视,notion,0,1,1,0,1,1,0.00826,4,0.264992,0.278237,0
坚决(1946),坚决,notion,0,2,2,0,2,2,0.015419,4,0.27556,0.296399,1296.225957
坚定(1946),坚定,notion,0,4,4,0,4,4,0.056781,4,0.346054,0.388952,9959.173089
坚忍(1946),坚忍,notion,0,1,1,0,1,1,0.00826,4,0.264992,0.278237,0
坚持(1946),坚持,notion,0,4,4,0,4,4,0.032441,4,0.29786,0.330507,3741.616218
坚持原则(1946),坚持原则,notion,0,1,1,0,1,1,0.018893,4,0.282798,0.307938,0
坟墓(1946),坟墓,notion,0,1,1,0,1,1,0.004564,4,0.256755,0.263104,0
坠落(1946),坠落,notion,0,1,1,0,1,1,0.004479,4,0.256686,0.262973,0
坦白(1946),坦白,notion,0,1,1,0,1,1,0.017626,4,0.281496,0.305894,0
垂死挣扎(1946),垂死挣扎,notion,0,2,2,0,2,2,0.009698,4,0.262356,0.273569,160.636246
型式(1946),型式,notion,0,1,1,0,1,1,0.017626,4,0.281496,0.305894,0
垮台(1946),垮台,notion,0,1,1,0,1,1,0.018893,4,0.282798,0.307938,0
埃及(1946),埃及,notion,0,1,1,0,1,1,0.009637,4,0.265506,0.27915,0
埋怨(1946),埋怨,notion,0,1,1,0,1,1,0.013634,4,0.273332,0.292631,0
城墙(1946),城墙,notion,0,1,1,0,1,1,0.007159,4,0.261235,0.271453,0
城市(1946),城市,notion,0,3,3,0,3,3,0.040256,4,0.318769,0.357961,6040.453316
城记(1946),城记,notion,0,1,1,0,1,1,0.013634,4,0.273332,0.292631,0
培养(1946),培养,notion,0,1,1,0,1,1,0.005304,4,0.259537,0.268322,0
培尔(1946),培尔,notion,0,1,1,0,1,1,0.013103,4,0.272684,0.291543,0
培植(1946),培植,notion,0,2,2,0,2,2,0.020262,4,0.282243,0.30714,1027.722249
基地(1946),基地,notion,0,2,2,0,2,2,0.024197,4,0.292198,0.32223,2288.2854
基地网(1946),基地网,notion,0,1,1,0,1,1,0.013103,4,0.272684,0.291543,0
基层(1946),基层,notion,0,1,1,0,1,1,0.004564,4,0.256755,0.263104,0
基础(1946),基础,notion,0,4,4,0,7,7,0.044604,4,0.320833,0.360555,6596.996957
基频(1946),基频,notion,0,1,1,0,1,1,0.004577,4,0.257676,0.264843,0
堡垒(1946),堡垒,notion,0,2,2,0,2,2,0.027153,4,0.296784,0.32884,1981.441549
塑像(1946),塑像,notion,0,1,1,0,1,1,0.013634,4,0.273332,0.292631,0
塞上江南(1946),塞上江南,notion,0,1,1,0,1,1,0.017626,4,0.281496,0.305894,0
塞尔(1946),塞尔,notion,0,1,1,0,1,1,0.017626,4,0.281496,0.305894,0
境地(1946),境地,notion,0,1,1,0,1,1,0.009637,4,0.265506,0.27915,0
墙上(1946),墙上,notion,0,1,1,0,1,1,0.017626,4,0.281496,0.305894,0
增兵(1946),增兵,notion,0,1,1,0,1,1,0.017626,4,0.281496,0.305894,0
增刊(1946),增刊,notion,0,1,1,0,1,1,0.0031,4,0.254504,0.258799,0
增加(1946),增加,notion,0,1,1,0,1,1,0.009637,4,0.265506,0.27915,0
增防(1946),增防,notion,0,1,1,0,1,1,0.017626,4,0.281496,0.305894,0
墨水(1946),墨水,notion,0,1,1,0,1,1,0.018893,4,0.282798,0.307938,0
墨索里尼(1946),墨索里尼,notion,0,1,1,0,1,1,0.013378,4,0.272039,0.290456,0
壁垒(1946),壁垒,notion,0,1,1,0,1,1,0.009637,4,0.265506,0.27915,0
士兵(1946),士兵,notion,0,2,2,0,3,3,0.019095,4,0.279064,0.302096,590.998645
士气(1946),士气,notion,0,1,1,0,1,1,0.003608,4,0.255568,0.260842,0
壮丁(1946),壮丁,notion,0,1,1,0,2,2,0.00826,4,0.264992,0.278237,0
壮大(1946),壮大,notion,0,1,1,0,1,1,0.00826,4,0.264992,0.278237,0
声中(1946),声中,notion,0,1,1,0,2,2,0.018893,4,0.282798,0.307938,0
声明(1946),声明,notion,0,6,6,0,8,8,0.050856,4,0.322814,0.363092,10927.927848
声讨(1946),声讨,notion,0,1,1,0,1,1,0.017626,4,0.281496,0.305894,0
声音(1946),声音,notion,0,4,4,0,4,4,0.047945,4,0.327896,0.368948,9030.584584
处处(1946),处处,notion,0,1,1,0,1,1,0.013634,4,0.273332,0.292631,0
处理(1946),处理,notion,0,1,1,0,1,1,0.013103,4,0.272684,0.291543,0
处置(1946),处置,notion,0,2,2,0,2,2,0.03126,4,0.304035,0.338885,2199.499867
复仇(1946),复仇,notion,0,1,1,0,1,1,0.013103,4,0.272684,0.291543,0
复刊(1946),复刊,notion,0,1,1,0,3,3,0.017626,4,0.281496,0.305894,0
复去(1946),复去,notion,0,1,1,0,1,1,0.013634,4,0.273332,0.292631,0
复发(1946),复发,notion,0,1,1,0,1,1,0.013378,4,0.272039,0.290456,0
复员(1946),复员,notion,0,5,5,0,7,7,0.052117,4,0.33772,0.38011,12596.272085
复国(1946),复国,notion,0,1,1,0,1,1,0.009637,4,0.265506,0.27915,0
复工(1946),复工,notion,0,1,1,0,1,1,0.013634,4,0.273332,0.292631,0
复旦(1946),复旦,notion,0,1,1,0,1,1,0.004577,4,0.257676,0.264843,0
复旦大学(1946),复旦大学,notion,0,1,1,0,1,1,0.017626,4,0.281496,0.305894,0
复杂(1946),复杂,notion,0,1,1,0,1,1,0.013634,4,0.273332,0.292631,0
复杂化(1946),复杂化,notion,0,1,1,0,1,1,0.018893,4,0.282798,0.307938,0
复活(1946),复活,notion,0,1,1,0,3,3,0.013103,4,0.272684,0.291543,0
复炽(1946),复炽,notion,0,1,1,0,1,1,0.017626,4,0.281496,0.305894,0
复苏(1946),复苏,notion,0,1,1,0,1,1,0.017626,4,0.281496,0.305894,0
复课(1946),复课,notion,0,1,1,0,1,1,0.018893,4,0.282798,0.307938,0
夏天(1946),夏天,notion,0,1,1,0,1,1,0.004577,4,0.257676,0.264843,0
夏来(1946),夏来,notion,0,1,1,0,1,1,0.017626,4,0.281496,0.305894,0
夏都(1946),夏都,notion,0,1,1,0,1,1,0.013634,4,0.273332,0.292631,0
夕照(1946),夕照,notion,0,1,1,0,1,1,0.004577,4,0.257676,0.264843,0
外交学(1946),外交学,notion,0,1,1,0,1,1,0.017626,4,0.281496,0.305894,0
外交官(1946),外交官,notion,0,1,1,0,1,1,0.009637,4,0.265506,0.27915,0
外人(1946),外人,notion,0,1,1,0,1,1,0.007159,4,0.261235,0.271453,0
外力(1946),外力,notion,0,1,1,0,1,1,0.013103,4,0.272684,0.291543,0
外务(1946),外务,notion,0,1,1,0,1,1,0.013378,4,0.272039,0.290456,0
外史(1946),外史,notion,0,1,1,0,1,1,0.018893,4,0.282798,0.307938,0
外国(1946),外国,notion,0,1,1,0,1,1,0.018893,4,0.282798,0.307938,0
外国语(1946),外国语,notion,0,1,1,0,1,1,0.003608,4,0.255568,0.260842,0
外婚(1946),外婚,notion,0,1,1,0,1,1,0.017626,4,0.281496,0.305894,0
外汇市场(1946),外汇市场,notion,0,1,1,0,1,1,0.005461,4,0.25793,0.265322,0
外边(1946),外边,notion,0,1,1,0,1,1,0.017626,4,0.281496,0.305894,0
多于(1946),多于,notion,0,1,1,0,1,1,0.007159,4,0.261235,0.271453,0
多幅(1946),多幅,notion,0,1,1,0,1,1,0.013103,4,0.272684,0.291543,0
多救(1946),多救,notion,0,1,1,0,1,1,0.013634,4,0.273332,0.292631,0
多样(1946),多样,notion,0,1,1,0,1,1,0.005461,4,0.25793,0.265322,0
多灾多难(1946),多灾多难,notion,0,1,1,0,1,1,0.018893,4,0.282798,0.307938,0
多瑙河(1946),多瑙河,notion,0,2,2,0,2,2,0.014201,4,0.270936,0.288659,565.416548
多种(1946),多种,notion,0,1,1,0,1,1,0.013103,4,0.272684,0.291543,0
多首(1946),多首,notion,0,1,1,0,1,1,0.004577,4,0.257676,0.264843,0
夜渡(1946),夜渡,notion,0,1,1,0,1,1,0.018893,4,0.282798,0.307938,0
夜郎(1946),夜郎,notion,0,1,1,0,1,1,0.017626,4,0.281496,0.305894,0
大业(1946),大业,notion,0,1,1,0,1,1,0.017626,4,0.281496,0.305894,0
大事(1946),大事,notion,0,2,2,0,2,2,0.016986,4,0.276434,0.297834,735.895741
大事记(1946),大事记,notion,0,1,1,0,1,1,0.013378,4,0.272039,0.290456,0
大众(1946),大众,notion,0,1,1,0,2,2,0.0031,4,0.254504,0.258799,0
大传(1946),大传,notion,0,1,1,0,1,1,0.017626,4,0.281496,0.305894,0
大使(1946),大使,notion,0,5,5,0,7,7,0.061434,4,0.347141,0.390155,12669.942899
大党(1946),大党,notion,0,2,2,0,2,2,0.023372,4,0.287781,0.315664,849.784339
大公(1946),大公,notion,0,1,1,0,1,1,0.017626,4,0.281496,0.305894,0
大公报(1946),大公报,notion,0,5,5,0,10,10,0.056213,4,0.343573,0.386415,12004.813198
大兵(1946),大兵,notion,0,2,2,0,2,2,0.009698,4,0.262356,0.273569,160.636246
大出(1946),大出,notion,0,1,1,0,1,1,0.007159,4,0.261235,0.271453,0
大势(1946),大势,notion,0,2,2,0,2,2,0.009043,4,0.262236,0.273352,284.685012
大卫(1946),大卫,notion,0,1,1,0,1,1,0.018893,4,0.282798,0.307938,0
大吉大利(1946),大吉大利,notion,0,1,1,0,1,1,0.0031,4,0.254504,0.258799,0
大后方(1946),大后方,notion,0,1,1,0,1,1,0.0031,4,0.254504,0.258799,0
大奖(1946),大奖,notion,0,1,1,0,1,1,0.004564,4,0.256755,0.263104,0
大学教授(1946),大学教授,notion,0,2,2,0,2,2,0.032527,4,0.303393,0.338015,1614.891208
大学生(1946),大学生,notion,0,2,2,0,2,2,0.024197,4,0.292198,0.32223,2288.2854
大审群(1946),大审群,notion,0,1,1,0,1,1,0.013103,4,0.272684,0.291543,0
大家(1946),大家,notion,0,4,4,0,4,4,0.032813,4,0.300947,0.334812,6414.03622
大局(1946),大局,notion,0,2,2,0,3,3,0.02853,4,0.295746,0.327361,1236.887723
大帽子(1946),大帽子,notion,0,3,3,0,3,3,0.023658,4,0.28459,0.310866,1803.134279
大批(1946),大批,notion,0,1,1,0,1,1,0.0031,4,0.254504,0.258799,0
大拍卖(1946),大拍卖,notion,0,1,1,0,1,1,0.00826,4,0.264992,0.278237,0
大放厥词(1946),大放厥词,notion,0,1,1,0,1,1,0.001496,4,0.252204,0.25432,0
大礁(1946),大礁,notion,0,1,1,0,1,1,0.013634,4,0.273332,0.292631,0
大笑话(1946),大笑话,notion,0,1,1,0,1,1,0.00826,4,0.264992,0.278237,0
大粪(1946),大粪,notion,0,1,1,0,1,1,0.018893,4,0.282798,0.307938,0
大纲(1946),大纲,notion,0,1,1,0,1,1,0.017626,4,0.281496,0.305894,0
大罢工(1946),大罢工,notion,0,1,1,0,2,2,0.013103,4,0.272684,0.291543,0
大良(1946),大良,notion,0,1,1,0,1,1,0.00826,4,0.264992,0.278237,0
大英帝国(1946),大英帝国,notion,0,1,1,0,1,1,0.013103,4,0.272684,0.291543,0
大衆(1946),大衆,notion,0,1,1,0,1,1,0.003608,4,0.255568,0.260842,0
大衆化(1946),大衆化,notion,0,1,1,0,1,1,0.003608,4,0.255568,0.260842,0
大连(1946),大连,notion,0,1,1,0,1,1,0.013634,4,0.273332,0.292631,0
大选(1946),大选,notion,0,4,4,0,6,6,0.042762,4,0.317221,0.35612,6529.109619
大道(1946),大道,notion,0,1,1,0,1,1,0.018893,4,0.282798,0.307938,0
大闹(1946),大闹,notion,0,1,1,0,1,1,0.00826,4,0.264992,0.278237,0
大队(1946),大队,notion,0,1,1,0,1,1,0.013634,4,0.273332,0.292631,0
大陆(1946),大陆,notion,0,1,1,0,1,1,0.017626,4,0.281496,0.305894,0
天下(1946),天下,notion,0,1,1,0,1,1,0.013378,4,0.272039,0.290456,0
天下太平(1946),天下太平,notion,0,1,1,0,1,1,0.013634,4,0.273332,0.292631,0
天下第一(1946),天下第一,notion,0,1,1,0,1,1,0.00826,4,0.264992,0.278237,0
天地(1946),天地,notion,0,2,2,0,2,2,0.027153,4,0.296784,0.32884,1981.441549
天坛(1946),天坛,notion,0,1,1,0,1,1,0.013378,4,0.272039,0.290456,0
天堂(1946),天堂,notion,0,1,1,0,1,1,0.017626,4,0.281496,0.305894,0
天字第一号(1946),天字第一号,notion,0,1,1,0,1,1,0.005304,4,0.259537,0.268322,0
天桥(1946),天桥,notion,0,1,1,0,1,1,0.013378,4,0.272039,0.290456,0
天津(1946),天津,notion,0,6,6,0,7,7,0.049173,4,0.320725,0.36057,10266.516147
天津人(1946),天津人,notion,0,1,1,0,1,1,0.0031,4,0.254504,0.258799,0
天涯(1946),天涯,notion,0,1,1,0,1,1,0.005304,4,0.259537,0.268322,0
天窗(1946),天窗,notion,0,1,1,0,1,1,0.013634,4,0.273332,0.292631,0
太原(1946),太原,notion,0,3,3,0,3,3,0.027383,4,0.298882,0.331869,4766.962629
太太(1946),太太,notion,0,1,1,0,1,1,0.005461,4,0.25793,0.265322,0
太少(1946),太少,notion,0,1,1,0,1,1,0.005304,4,0.259537,0.268322,0
太平(1946),太平,notion,0,2,2,0,2,2,0.009882,4,0.266886,0.281658,1422.879592
太平洋战争(1946),太平洋战争,notion,0,1,1,0,1,1,0.013378,4,0.272039,0.290456,0
太息(1946),太息,notion,0,1,1,0,1,1,0.005304,4,0.259537,0.268322,0
太湖(1946),太湖,notion,0,1,1,0,1,1,0.013634,4,0.273332,0.292631,0
太阳(1946),太阳,notion,0,1,1,0,1,1,0.018893,4,0.282798,0.307938,0
夫人(1946),夫人,notion,0,4,4,0,4,4,0.046401,4,0.320904,0.360642,5762.807147
夫妇(1946),夫妇,notion,0,1,1,0,1,1,0.013634,4,0.273332,0.292631,0
夫子自道(1946),夫子自道,notion,0,1,1,0,1,1,0.004479,4,0.256686,0.262973,0
夫斯基(1946),夫斯基,notion,0,1,1,0,1,1,0.013103,4,0.272684,0.291543,0
失业(1946),失业,notion,0,3,3,0,4,4,0.015839,4,0.274717,0.29508,2071.344368
失信(1946),失信,notion,0,1,1,0,1,1,0.013103,4,0.272684,0.291543,0
失去(1946),失去,notion,0,1,1,0,1,1,0.018893,4,0.282798,0.307938,0
失学(1946),失学,notion,0,2,2,0,2,2,0.025886,4,0.296968,0.329101,2935.752997
失败(1946),失败,notion,0,4,4,0,8,8,0.044006,4,0.317151,0.356033,6811.574384
头等(1946),头等,notion,0,1,1,0,2,2,0.013378,4,0.272039,0.290456,0
头部(1946),头部,notion,0,1,1,0,1,1,0.013103,4,0.272684,0.291543,0
夹缝(1946),夹缝,notion,0,1,1,0,1,1,0.017626,4,0.281496,0.305894,0
奇迹(1946),奇迹,notion,0,1,1,0,1,1,0.005304,4,0.259537,0.268322,0
奉令(1946),奉令,notion,0,1,1,0,1,1,0.00826,4,0.264992,0.278237,0
奉化(1946),奉化,notion,0,1,1,0,1,1,0.013634,4,0.273332,0.292631,0
奋斗(1946),奋斗,notion,0,3,3,0,5,5,0.018044,4,0.279988,0.303647,3754.931771
奋门(1946),奋门,notion,0,1,1,0,1,1,0.013378,4,0.272039,0.290456,0
奋鬥(1946),奋鬥,notion,0,1,1,0,1,1,0.017626,4,0.281496,0.305894,0
奏演(1946),奏演,notion,0,1,1,0,1,1,0.009637,4,0.265506,0.27915,0
奖金(1946),奖金,notion,0,1,1,0,1,1,0.013103,4,0.272684,0.291543,0
奥古斯特(1946),奥古斯特,notion,0,1,1,0,1,1,0.013103,4,0.272684,0.291543,0
奥妙(1946),奥妙,notion,0,1,1,0,1,1,0.00826,4,0.264992,0.278237,0
女人(1946),女人,notion,0,1,1,0,1,1,0.013634,4,0.273332,0.292631,0
女士(1946),女士,notion,0,2,2,0,3,3,0.032527,4,0.303393,0.338015,1614.891208
女性(1946),女性,notion,0,1,1,0,2,2,0.005304,4,0.259537,0.268322,0
奴性(1946),奴性,notion,0,1,1,0,1,1,0.017626,4,0.281496,0.305894,0
奴才(1946),奴才,notion,0,3,3,0,3,3,0.030289,4,0.296081,0.327912,2175.326408
奴隶制(1946),奴隶制,notion,0,1,1,0,1,1,0.007159,4,0.261235,0.271453,0
好像(1946),好像,notion,0,2,2,0,2,2,0.020536,4,0.280891,0.30501,760.639997
好围(1946),好围,notion,0,1,1,0,1,1,0.00826,4,0.264992,0.278237,0
好处(1946),好处,notion,0,1,1,0,1,1,0.018893,4,0.282798,0.307938,0
好恶(1946),好恶,notion,0,1,1,0,1,1,0.013103,4,0.272684,0.291543,0
好战(1946),好战,notion,0,2,2,0,3,3,0.020536,4,0.280891,0.30501,760.639997
好战份子(1946),好战份子,notion,0,1,1,0,1,1,0.013103,4,0.272684,0.291543,0
好消息(1946),好消息,notion,0,1,1,0,1,1,0.013103,4,0.272684,0.291543,0
好转(1946),好转,notion,0,2,2,0,3,3,0.010259,4,0.264968,0.278266,430.797028
如今(1946),如今,notion,0,1,1,0,1,1,0.013634,4,0.273332,0.292631,0
如斯(1946),如斯,notion,0,1,1,0,1,1,0.018893,4,0.282798,0.307938,0
如是(1946),如是,notion,0,1,1,0,1,1,0.013634,4,0.273332,0.292631,0
如是我闻(1946),如是我闻,notion,0,1,1,0,2,2,0.004237,4,0.256206,0.26206,0
如此(1946),如此,notion,0,8,8,0,10,10,0.068572,4,0.357059,0.400374,25105.461872
如法泡制(1946),如法泡制,notion,0,1,1,0,1,1,0.018893,4,0.282798,0.307938,0
妄想(1946),妄想,notion,0,1,1,0,1,1,0.003608,4,0.255568,0.260842,0
妇女界(1946),妇女界,notion,0,1,1,0,1,1,0.013103,4,0.272684,0.291543,0
妓女(1946),妓女,notion,0,1,1,0,1,1,0.013634,4,0.273332,0.292631,0
妖言(1946),妖言,notion,0,1,1,0,1,1,0.009637,4,0.265506,0.27915,0
始未(1946),始未,notion,0,1,1,0,1,1,0.00826,4,0.264992,0.278237,0
始末(1946),始末,notion,0,2,2,0,3,3,0.032271,4,0.301168,0.334971,1271.496707
委会(1946),委会,notion,0,1,1,0,1,1,0.009637,4,0.265506,0.27915,0
委及(1946),委及,notion,0,1,1,0,1,1,0.005461,4,0.25793,0.265322,0
委员会(1946),委员会,notion,0,3,3,0,5,5,0.034967,4,0.307911,0.344132,3678.9293
委屈(1946),委屈,notion,0,1,1,0,1,1,0.009637,4,0.265506,0.27915,0
姜公美(1946),姜公美,notion,0,1,1,0,1,1,0.013634,4,0.273332,0.292631,0
姜太公(1946),姜太公,notion,0,1,1,0,1,1,0.013634,4,0.273332,0.292631,0
姜逆(1946),姜逆,notion,0,1,1,0,1,1,0.00826,4,0.264992,0.278237,0
姿态(1946),姿态,notion,0,1,1,0,1,1,0.013378,4,0.272039,0.290456,0
威信(1946),威信,notion,0,1,1,0,1,1,0.00826,4,0.264992,0.278237,0
威力(1946),威力,notion,0,1,1,0,1,1,0.013103,4,0.272684,0.291543,0
威尔(1946),威尔,notion,0,1,1,0,1,1,0.013103,4,0.272684,0.291543,0
威廉(1946),威廉,notion,0,1,1,0,1,1,0.017626,4,0.281496,0.305894,0
威海卫(1946),威海卫,notion,0,1,1,0,1,1,0.004564,4,0.256755,0.263104,0
威胁利诱(1946),威胁利诱,notion,0,1,1,0,1,1,0.013103,4,0.272684,0.291543,0
娇艳(1946),娇艳,notion,0,1,1,0,1,1,0.018893,4,0.282798,0.307938,0
娱乐圈(1946),娱乐圈,notion,0,1,1,0,1,1,0.017626,4,0.281496,0.305894,0
婚礼(1946),婚礼,notion,0,1,1,0,1,1,0.017626,4,0.281496,0.305894,0
婴儿(1946),婴儿,notion,0,2,2,0,2,2,0.01768,4,0.279308,0.302487,1220.085569
嫁祸(1946),嫁祸,notion,0,2,2,0,2,2,0.027153,4,0.296784,0.32884,1981.441549
嫌联(1946),嫌联,notion,0,1,1,0,1,1,0.013378,4,0.272039,0.290456,0
子夜(1946),子夜,notion,0,2,2,0,2,2,0.026052,4,0.291576,0.321317,1054.556401
子女(1946),子女,notion,0,1,1,0,1,1,0.013634,4,0.273332,0.292631,0
子敬(1946),子敬,notion,0,1,1,0,1,1,0.004479,4,0.256686,0.262973,0
孔学(1946),孔学,notion,0,1,1,0,1,1,0.013378,4,0.272039,0.290456,0
孔教(1946),孔教,notion,0,1,1,0,1,1,0.004237,4,0.256206,0.26206,0
存亡(1946),存亡,notion,0,1,1,0,1,1,0.009637,4,0.265506,0.27915,0
存在(1946),存在,notion,0,1,1,0,1,1,0.013634,4,0.273332,0.292631,0
存废(1946),存废,notion,0,2,2,0,2,2,0.027264,4,0.294896,0.326144,1405.794223
孙中山(1946),孙中山,notion,0,3,3,0,4,4,0.049622,4,0.336297,0.378399,6466.151599
孙先生(1946),孙先生,notion,0,1,1,0,1,1,0.001496,4,0.252204,0.25432,0
孙夫人(1946),孙夫人,notion,0,2,2,0,2,2,0.018197,4,0.279091,0.30214,922.274826
孙本文(1946),孙本文,notion,0,1,1,0,1,1,0.017626,4,0.281496,0.305894,0
孙科(1946),孙科,notion,0,1,1,0,1,1,0.018893,4,0.282798,0.307938,0
孙院(1946),孙院,notion,0,1,1,0,1,1,0.013378,4,0.272039,0.290456,0
孙院长(1946),孙院长,notion,0,1,1,0,1,1,0.007159,4,0.261235,0.271453,0
孟姜女(1946),孟姜女,notion,0,1,1,0,1,1,0.007159,4,0.261235,0.271453,0
孟子(1946),孟子,notion,0,1,1,0,1,1,0.007159,4,0.261235,0.271453,0
孤儿(1946),孤儿,notion,0,1,1,0,1,1,0.017626,4,0.281496,0.305894,0
学之(1946),学之,notion,0,1,1,0,1,1,0.017626,4,0.281496,0.305894,0
学习团(1946),学习团,notion,0,1,1,0,1,1,0.005304,4,0.259537,0.268322,0
学制(1946),学制,notion,0,1,1,0,1,1,0.017626,4,0.281496,0.305894,0
学宫(1946),学宫,notion,0,1,1,0,4,4,0.017626,4,0.281496,0.305894,0
学府(1946),学府,notion,0,2,2,0,4,4,0.03126,4,0.304035,0.338885,2199.499867
学徒(1946),学徒,notion,0,1,1,0,1,1,0.00826,4,0.264992,0.278237,0
学步(1946),学步,notion,0,1,1,0,1,1,0.018893,4,0.282798,0.307938,0
学派(1946),学派,notion,0,1,1,0,1,1,0.004564,4,0.256755,0.263104,0
学潮(1946),学潮,notion,0,1,1,0,2,2,0.013634,4,0.273332,0.292631,0
学生会(1946),学生会,notion,0,1,1,0,1,1,0.005304,4,0.259537,0.268322,0
学者(1946),学者,notion,0,2,2,0,3,3,0.02219,4,0.287062,0.314576,1087.606545
学联(1946),学联,notion,0,1,1,0,1,1,0.004237,4,0.256206,0.26206,0
学院(1946),学院,notion,0,1,1,0,1,1,0.017626,4,0.281496,0.305894,0
孩子(1946),孩子,notion,0,1,1,0,1,1,0.00826,4,0.264992,0.278237,0
宁愿(1946),宁愿,notion,0,1,1,0,1,1,0.00826,4,0.264992,0.278237,0
宇宙(1946),宇宙,notion,0,1,1,0,1,1,0.018893,4,0.282798,0.307938,0
守住(1946),守住,notion,0,1,1,0,1,1,0.005461,4,0.25793,0.265322,0
守卫(1946),守卫,notion,0,1,1,0,1,1,0.005461,4,0.25793,0.265322,0
安全(1946),安全,notion,0,3,3,0,5,5,0.036118,4,0.305392,0.340784,3415.855619
安多(1946),安多,notion,0,1,1,0,1,1,0.017626,4,0.281496,0.305894,0
安定(1946),安定,notion,0,2,2,0,2,2,0.03126,4,0.304035,0.338885,2199.499867
安平(1946),安平,notion,0,6,6,0,9,9,0.070996,4,0.367936,0.410579,20531.409735
安徽(1946),安徽,notion,0,2,2,0,3,3,0.03126,4,0.304035,0.338885,2199.499867
安徽省(1946),安徽省,notion,0,1,1,0,1,1,0.004564,4,0.256755,0.263104,0
安理会(1946),安理会,notion,0,2,2,0,2,2,0.030729,4,0.302946,0.337407,2092.27198
宋子文(1946),宋子文,notion,0,1,1,0,2,2,0.018893,4,0.282798,0.307938,0
宋学(1946),宋学,notion,0,1,1,0,1,1,0.017626,4,0.281496,0.305894,0
宋庆龄(1946),宋庆龄,notion,0,1,1,0,2,2,0.009637,4,0.265506,0.27915,0
宋教仁(1946),宋教仁,notion,0,1,1,0,1,1,0.007159,4,0.261235,0.271453,0
宋明理学(1946),宋明理学,notion,0,1,1,0,1,1,0.017626,4,0.281496,0.305894,0
宋诗(1946),宋诗,notion,0,1,1,0,1,1,0.017626,4,0.281496,0.305894,0
完成(1946),完成,notion,0,4,4,0,6,6,0.042898,4,0.319158,0.358512,6979.031461
完美(1946),完美,notion,0,1,1,0,1,1,0.017626,4,0.281496,0.305894,0
宗教(1946),宗教,notion,0,2,2,0,2,2,0.014214,4,0.272194,0.29079,872.497436
宗教自由(1946),宗教自由,notion,0,1,1,0,1,1,0.013103,4,0.272684,0.291543,0
宗旨(1946),宗旨,notion,0,1,1,0,1,1,0.004577,4,0.257676,0.264843,0
官僚化(1946),官僚化,notion,0,1,1,0,1,1,0.013378,4,0.272039,0.290456,0
官僚资本(1946),官僚资本,notion,0,4,4,0,7,7,0.051365,4,0.327075,0.367992,5913.184584
官儿(1946),官儿,notion,0,1,1,0,1,1,0.013634,4,0.273332,0.292631,0
官兵(1946),官兵,notion,0,1,1,0,1,1,0.00826,4,0.264992,0.278237,0
官样文章(1946),官样文章,notion,0,1,1,0,1,1,0.013634,4,0.273332,0.292631,0
官规(1946),官规,notion,0,1,1,0,1,1,0.013378,4,0.272039,0.290456,0
官逼民反(1946),官逼民反,notion,0,1,1,0,1,1,0.004479,4,0.256686,0.262973,0
定义(1946),定义,notion,0,1,1,0,1,1,0.017626,4,0.281496,0.305894,0
定向(1946),定向,notion,0,1,1,0,1,1,0.013378,4,0.272039,0.290456,0
定於(1946),定於,notion,0,1,1,0,1,1,0.017626,4,0.281496,0.305894,0
定期(1946),定期,notion,0,2,2,0,3,3,0.03126,4,0.304035,0.338885,2199.499867
定要(1946),定要,notion,0,1,1,0,1,1,0.018893,4,0.282798,0.307938,0
定都(1946),定都,notion,0,1,1,0,1,1,0.004577,4,0.257676,0.264843,0
宜中(1946),宜中,notion,0,1,1,0,1,1,0.007159,4,0.261235,0.271453,0
宜昌(1946),宜昌,notion,0,1,1,0,1,1,0.017626,4,0.281496,0.305894,0
宝藏(1946),宝藏,notion,0,1,1,0,1,1,0.00826,4,0.264992,0.278237,0
实业公司(1946),实业公司,notion,0,1,1,0,1,1,0.004479,4,0.256686,0.262973,0
实事(1946),实事,notion,0,1,1,0,1,1,0.001496,4,0.252204,0.25432,0
实例(1946),实例,notion,0,1,1,0,1,1,0.013378,4,0.272039,0.290456,0
实值(1946),实值,notion,0,1,1,0,1,1,0.004577,4,0.257676,0.264843,0
实况(1946),实况,notion,0,3,3,0,4,4,0.026031,4,0.293871,0.324738,3658.704472
实在(1946),实在,notion,0,1,1,0,1,1,0.013634,4,0.273332,0.292631,0
实处(1946),实处,notion,0,1,1,0,1,1,0.009637,4,0.265506,0.27915,0
实惠(1946),实惠,notion,0,1,1,0,1,1,0.00826,4,0.264992,0.278237,0
实据(1946),实据,notion,0,1,1,0,1,1,0.017626,4,0.281496,0.305894,0
实现(1946),实现,notion,0,3,3,0,11,11,0.035604,4,0.308373,0.344741,3826.67156
实话(1946),实话,notion,0,1,1,0,1,1,0.001496,4,0.252204,0.25432,0
实践(1946),实践,notion,0,4,4,0,4,4,0.041183,4,0.315238,0.353641,7723.494314
实际(1946),实际,notion,0,1,1,0,1,1,0.017626,4,0.281496,0.305894,0
实验(1946),实验,notion,0,1,1,0,1,1,0.005304,4,0.259537,0.268322,0
审查(1946),审查,notion,0,1,1,0,1,1,0.009637,4,0.265506,0.27915,0
审理(1946),审理,notion,0,1,1,0,1,1,0.017626,4,0.281496,0.305894,0
客观(1946),客观,notion,0,2,2,0,2,2,0.020727,4,0.284759,0.311054,789.620977
宣传(1946),宣传,notion,0,4,4,0,4,4,0.054376,4,0.338754,0.381168,8197.589629
宣传战(1946),宣传战,notion,0,1,1,0,1,1,0.013634,4,0.273332,0.292631,0
宣化(1946),宣化,notion,0,1,1,0,1,1,0.018893,4,0.282798,0.307938,0
宣布(1946),宣布,notion,0,1,1,0,1,1,0.004479,4,0.256686,0.262973,0
宣慰(1946),宣慰,notion,0,1,1,0,1,1,0.013634,4,0.273332,0.292631,0
宣战(1946),宣战,notion,0,1,1,0,2,2,0.017626,4,0.281496,0.305894,0
宣扬(1946),宣扬,notion,0,1,1,0,1,1,0.004237,4,0.256206,0.26206,0
宣言(1946),宣言,notion,0,1,1,0,1,1,0.018893,4,0.282798,0.307938,0
宣铁(1946),宣铁,notion,0,1,1,0,1,1,0.018893,4,0.282798,0.307938,0
宪与(1946),宪与,notion,0,1,1,0,1,1,0.017626,4,0.281496,0.305894,0
宪兵队(1946),宪兵队,notion,0,1,1,0,1,1,0.017626,4,0.281496,0.305894,0
宫中(1946),宫中,notion,0,1,1,0,1,1,0.013103,4,0.272684,0.291543,0
家世(1946),家世,notion,0,1,1,0,1,1,0.018893,4,0.282798,0.307938,0
家乡(1946),家乡,notion,0,1,1,0,1,1,0.018893,4,0.282798,0.307938,0
家信(1946),家信,notion,0,1,1,0,1,1,0.013634,4,0.273332,0.292631,0
家国(1946),家国,notion,0,1,1,0,1,1,0.005304,4,0.259537,0.268322,0
家庭(1946),家庭,notion,0,6,6,0,7,7,0.063386,4,0.356704,0.399881,21744.428562
容忍(1946),容忍,notion,0,1,1,0,1,1,0.013634,4,0.273332,0.292631,0
容易(1946),容易,notion,0,2,2,0,3,3,0.031996,4,0.303907,0.338711,1883.718005
宾阳(1946),宾阳,notion,0,2,2,0,2,2,0.015419,4,0.27556,0.296399,1296.225957
宿县(1946),宿县,notion,0,1,1,0,1,1,0.013634,4,0.273332,0.292631,0
寂寞(1946),寂寞,notion,0,4,4,0,4,4,0.03575,4,0.301294,0.33529,3549.566274
寄托(1946),寄托,notion,0,1,1,0,1,1,0.00826,4,0.264992,0.278237,0
寄自(1946),寄自,notion,0,1,1,0,1,1,0.013634,4,0.273332,0.292631,0
寄语(1946),寄语,notion,0,2,2,0,2,2,0.021234,4,0.286205,0.313272,1214.025388
密云(1946),密云,notion,0,1,1,0,1,1,0.013103,4,0.272684,0.291543,0
密佈(1946),密佈,notion,0,1,1,0,1,1,0.017626,4,0.281496,0.305894,0
密函(1946),密函,notion,0,1,1,0,1,1,0.017626,4,0.281496,0.305894,0
富于(1946),富于,notion,0,2,2,0,2,2,0.020727,4,0.284759,0.311054,789.620977
富春江(1946),富春江,notion,0,1,1,0,2,2,0.013634,4,0.273332,0.292631,0
富民(1946),富民,notion,0,1,1,0,1,1,0.017626,4,0.281496,0.305894,0
富阳(1946),富阳,notion,0,1,1,0,1,1,0.013634,4,0.273332,0.292631,0
寒夜(1946),寒夜,notion,0,1,1,0,1,1,0.013634,4,0.273332,0.292631,0
察哈尔(1946),察哈尔,notion,0,1,1,0,1,1,0.004237,4,0.256206,0.26206,0
寥落(1946),寥落,notion,0,1,1,0,2,2,0.017626,4,0.281496,0.305894,0
对付(1946),对付,notion,0,1,1,0,1,1,0.017626,4,0.281496,0.305894,0
对内(1946),对内,notion,0,1,1,0,1,1,0.017626,4,0.281496,0.305894,0
对华(1946),对华,notion,0,2,2,0,2,2,0.018564,4,0.2792,0.302313,744.038498
对外(1946),对外,notion,0,3,3,0,4,4,0.037888,4,0.312837,0.350525,4530.737069
对外贸易(1946),对外贸易,notion,0,3,3,0,4,4,0.040367,4,0.316105,0.354656,4607.99901
对头(1946),对头,notion,0,1,1,0,1,1,0.018893,4,0.282798,0.307938,0
对峙(1946),对峙,notion,0,1,1,0,1,1,0.009637,4,0.265506,0.27915,0
对比(1946),对比,notion,0,2,2,0,2,2,0.01768,4,0.279308,0.302487,1220.085569
对照(1946),对照,notion,0,1,1,0,1,1,0.018893,4,0.282798,0.307938,0
对着(1946),对着,notion,0,1,1,0,1,1,0.013103,4,0.272684,0.291543,0
对立(1946),对立,notion,0,2,2,0,2,2,0.031004,4,0.302277,0.336493,1833.728143
对美(1946),对美,notion,0,1,1,0,1,1,0.018893,4,0.282798,0.307938,0
对苏(1946),对苏,notion,0,1,1,0,1,1,0.017626,4,0.281496,0.305894,0
对马(1946),对马,notion,0,1,1,0,1,1,0.013378,4,0.272039,0.290456,0
寺禁(1946),寺禁,notion,0,1,1,0,1,1,0.013378,4,0.272039,0.290456,0
寻夫(1946),寻夫,notion,0,1,1,0,1,1,0.007159,4,0.261235,0.271453,0
导师(1946),导师,notion,0,3,3,0,4,4,0.036034,4,0.312361,0.349916,5975.926118
导报(1946),导报,notion,0,1,1,0,1,1,0.018893,4,0.282798,0.307938,0
导演(1946),导演,notion,0,1,1,0,1,1,0.013634,4,0.273332,0.292631,0
导言(1946),导言,notion,0,1,1,0,1,1,0.013103,4,0.272684,0.291543,0
寿辰(1946),寿辰,notion,0,2,2,0,4,4,0.025886,4,0.296968,0.329101,2935.752997
封建(1946),封建,notion,0,4,4,0,5,5,0.044249,4,0.317853,0.356903,6008.12685
封神演义(1946),封神演义,notion,0,1,1,0,1,1,0.018893,4,0.282798,0.307938,0
封闭(1946),封闭,notion,0,1,1,0,1,1,0.013378,4,0.272039,0.290456,0
将士(1946),将士,notion,0,1,1,0,1,1,0.007159,4,0.261235,0.271453,0
尊严(1946),尊严,notion,0,1,1,0,1,1,0.013634,4,0.273332,0.292631,0
尊重(1946),尊重,notion,0,2,2,0,3,3,0.03126,4,0.304035,0.338885,2199.499867
小伙子(1946),小伙子,notion,0,1,1,0,1,1,0.018893,4,0.282798,0.307938,0
小偷(1946),小偷,notion,0,1,1,0,1,1,0.003608,4,0.255568,0.260842,0
小册子(1946),小册子,notion,0,1,1,0,1,1,0.004237,4,0.256206,0.26206,0
小品(1946),小品,notion,0,1,1,0,1,1,0.017626,4,0.281496,0.305894,0
小国(1946),小国,notion,0,1,1,0,1,1,0.017626,4,0.281496,0.305894,0
小型(1946),小型,notion,0,1,1,0,1,1,0.013634,4,0.273332,0.292631,0
小城(1946),小城,notion,0,3,3,0,3,3,0.036764,4,0.307845,0.344045,2893.036981
小姐(1946),小姐,notion,0,5,5,0,5,5,0.054699,4,0.336297,0.378544,10852.858548
小学(1946),小学,notion,0,2,2,0,2,2,0.036519,4,0.313896,0.3518,2490.161613
小心(1946),小心,notion,0,1,1,0,1,1,0.007159,4,0.261235,0.271453,0
小景(1946),小景,notion,0,4,4,0,4,4,0.048344,4,0.328608,0.369774,7449.125233
小组(1946),小组,notion,0,3,3,0,3,3,0.045374,4,0.322561,0.36257,4563.560502
小组会议(1946),小组会议,notion,0,1,1,0,1,1,0.013378,4,0.272039,0.290456,0
小视(1946),小视,notion,0,1,1,0,1,1,0.017626,4,0.281496,0.305894,0
小说(1946),小说,notion,0,3,3,0,3,3,0.036573,4,0.311278,0.348524,4825.118579
小贩(1946),小贩,notion,0,2,2,0,2,2,0.025886,4,0.296968,0.329101,2935.752997
小集(1946),小集,notion,0,1,1,0,1,1,0.003608,4,0.255568,0.260842,0
小鬼(1946),小鬼,notion,0,1,1,0,1,1,0.003608,4,0.255568,0.260842,0
少数民族(1946),少数民族,notion,0,1,1,0,1,1,0.004564,4,0.256755,0.263104,0
尔海峡(1946),尔海峡,notion,0,1,1,0,1,1,0.009637,4,0.265506,0.27915,0
尔特(1946),尔特,notion,0,1,1,0,1,1,0.013103,4,0.272684,0.291543,0
尖兵(1946),尖兵,notion,0,1,1,0,1,1,0.005304,4,0.259537,0.268322,0
尖锐(1946),尖锐,notion,0,1,1,0,1,1,0.017626,4,0.281496,0.305894,0
尚恭三(1946),尚恭三,notion,0,1,1,0,1,1,0.005461,4,0.25793,0.265322,0
尚须(1946),尚须,notion,0,1,1,0,1,1,0.013634,4,0.273332,0.292631,0
尝试(1946),尝试,notion,0,1,1,0,1,1,0.017626,4,0.281496,0.305894,0
尤爱(1946),尤爱,notion,0,1,1,0,1,1,0.013634,4,0.273332,0.292631,0
就是(1946),就是,notion,0,3,3,0,4,4,0.023574,4,0.284056,0.310039,1607.856925
就算(1946),就算,notion,0,1,1,0,1,1,0.013634,4,0.273332,0.292631,0
尸臭(1946),尸臭,notion,0,1,1,0,1,1,0.013634,4,0.273332,0.292631,0
尼古拉(1946),尼古拉,notion,0,1,1,0,1,1,0.013103,4,0.272684,0.291543,0
尼赫鲁(1946),尼赫鲁,notion,0,1,1,0,1,1,0.009637,4,0.265506,0.27915,0
尼铭康(1946),尼铭康,notion,0,1,1,0,1,1,0.013378,4,0.272039,0.290456,0
尽光(1946),尽光,notion,0,1,1,0,1,1,0.009637,4,0.265506,0.27915,0
尾巴(1946),尾巴,notion,0,3,3,0,4,4,0.041908,4,0.31393,0.351916,3405.961451
局势(1946),局势,notion,0,10,10,0,15,15,0.101397,4,0.415721,0.449919,42350.169905
局长(1946),局长,notion,0,1,1,0,1,1,0.018893,4,0.282798,0.307938,0
居士(1946),居士,notion,0,1,1,0,1,1,0.013634,4,0.273332,0.292631,0
居庸关(1946),居庸关,notion,0,1,1,0,1,1,0.009637,4,0.265506,0.27915,0
屋顶花园(1946),屋顶花园,notion,0,1,1,0,1,1,0.004577,4,0.257676,0.264843,0
展开(1946),展开,notion,0,5,5,0,7,7,0.06236,4,0.353676,0.396808,15993.47202
属于(1946),属于,notion,0,4,4,0,4,4,0.036505,4,0.303425,0.338204,4373.155093
屠刀(1946),屠刀,notion,0,1,1,0,1,1,0.00826,4,0.264992,0.278237,0
屠杀(1946),屠杀,notion,0,1,1,0,1,1,0.013378,4,0.272039,0.290456,0
屠村(1946),屠村,notion,0,1,1,0,1,1,0.00826,4,0.264992,0.278237,0
履行(1946),履行,notion,0,2,2,0,2,2,0.013245,4,0.269995,0.28705,596.681008
履行诺言(1946),履行诺言,notion,0,1,1,0,1,1,0.007159,4,0.261235,0.271453,0
山下(1946),山下,notion,0,1,1,0,1,1,0.017626,4,0.281496,0.305894,0
山东(1946),山东,notion,0,1,1,0,1,1,0.00826,4,0.264992,0.278237,0
山中(1946),山中,notion,0,1,1,0,1,1,0.007159,4,0.261235,0.271453,0
山光水色(1946),山光水色,notion,0,1,1,0,2,2,0.017626,4,0.281496,0.305894,0
山国(1946),山国,notion,0,1,1,0,1,1,0.004237,4,0.256206,0.26206,0
山城(1946),山城,notion,0,2,2,0,2,2,0.020792,4,0.283021,0.308358,1062.761034
山姆叔叔(1946),山姆叔叔,notion,0,1,1,0,1,1,0.018893,4,0.282798,0.307938,0
山居(1946),山居,notion,0,1,1,0,1,1,0.018893,4,0.282798,0.307938,0
山歌(1946),山歌,notion,0,1,1,0,1,1,0.018893,4,0.282798,0.307938,0
山河(1946),山河,notion,0,1,1,0,1,1,0.017626,4,0.281496,0.305894,0
山羊(1946),山羊,notion,0,1,1,0,1,1,0.017626,4,0.281496,0.305894,0
山脉(1946),山脉,notion,0,1,1,0,1,1,0.013103,4,0.272684,0.291543,0
山西(1946),山西,notion,0,2,2,0,2,2,0.023088,4,0.287867,0.315794,912.175655
山野(1946),山野,notion,0,1,1,0,1,1,0.004577,4,0.257676,0.264843,0
山高水长(1946),山高水长,notion,0,1,1,0,1,1,0.004564,4,0.256755,0.263104,0
岁寒(1946),岁寒,notion,0,2,2,0,2,2,0.032271,4,0.301168,0.334971,1271.496707
岂能(1946),岂能,notion,0,1,1,0,1,1,0.018893,4,0.282798,0.307938,0
岗位(1946),岗位,notion,0,1,1,0,2,2,0.005304,4,0.259537,0.268322,0
崩溃(1946),崩溃,notion,0,5,5,0,6,6,0.053106,4,0.338595,0.381066,14816.595878
川岛芳子(1946),川岛芳子,notion,0,1,1,0,1,1,0.018893,4,0.282798,0.307938,0
川西(1946),川西,notion,0,1,1,0,1,1,0.017626,4,0.281496,0.305894,0
巡查(1946),巡查,notion,0,1,1,0,1,1,0.018893,4,0.282798,0.307938,0
巡礼(1946),巡礼,notion,0,1,1,0,1,1,0.00826,4,0.264992,0.278237,0
巡行(1946),巡行,notion,0,1,1,0,1,1,0.013634,4,0.273332,0.292631,0
工业化(1946),工业化,notion,0,2,2,0,2,2,0.02219,4,0.287062,0.314576,1087.606545
工会(1946),工会,notion,0,1,1,0,1,1,0.00826,4,0.264992,0.278237,0
工作实绩(1946),工作实绩,notion,0,1,1,0,1,1,0.005304,4,0.259537,0.268322,0
工作站(1946),工作站,notion,0,1,1,0,2,2,0.005304,4,0.259537,0.268322,0
工作者(1946),工作者,notion,0,3,3,0,4,4,0.028833,4,0.293631,0.32439,1900.302815
工党(1946),工党,notion,0,1,1,0,1,1,0.005461,4,0.25793,0.265322,0
工具(1946),工具,notion,0,1,1,0,1,1,0.013103,4,0.272684,0.291543,0
工农(1946),工农,notion,0,1,1,0,1,1,0.0031,4,0.254504,0.258799,0
工厂(1946),工厂,notion,0,2,2,0,2,2,0.031996,4,0.303907,0.338711,1883.718005
工友(1946),工友,notion,0,1,1,0,1,1,0.005304,4,0.259537,0.268322,0
工商业(1946),工商业,notion,0,2,2,0,2,2,0.009784,4,0.265751,0.279657,874.170092
工商业者(1946),工商业者,notion,0,1,1,0,1,1,0.004479,4,0.256686,0.262973,0
工商界(1946),工商界,notion,0,2,2,0,2,2,0.023372,4,0.287781,0.315664,849.784339
工资(1946),工资,notion,0,1,1,0,1,1,0.018893,4,0.282798,0.307938,0
左公柳(1946),左公柳,notion,0,1,1,0,1,1,0.004577,4,0.257676,0.264843,0
左右(1946),左右,notion,0,1,1,0,1,1,0.009637,4,0.265506,0.27915,0
左无右(1946),左无右,notion,0,1,1,0,1,1,0.009637,4,0.265506,0.27915,0
左舜生(1946),左舜生,notion,0,1,1,0,1,1,0.00826,4,0.264992,0.278237,0
巨人(1946),巨人,notion,0,1,1,0,1,1,0.013103,4,0.272684,0.291543,0
巨浪(1946),巨浪,notion,0,1,1,0,1,1,0.018893,4,0.282798,0.307938,0
巨轮(1946),巨轮,notion,0,1,1,0,1,1,0.013103,4,0.272684,0.291543,0
巨风(1946),巨风,notion,0,1,1,0,1,1,0.013634,4,0.273332,0.292631,0
巩固(1946),巩固,notion,0,1,1,0,1,1,0.018893,4,0.282798,0.307938,0
巫山(1946),巫山,notion,0,1,1,0,1,1,0.009637,4,0.265506,0.27915,0
差矣(1946),差矣,notion,0,1,1,0,1,1,0.009637,4,0.265506,0.27915,0
已到(1946),已到,notion,0,1,1,0,1,1,0.005461,4,0.25793,0.265322,0
已满(1946),已满,notion,0,1,1,0,1,1,0.013103,4,0.272684,0.291543,0
已知(1946),已知,notion,0,1,1,0,1,1,0.004479,4,0.256686,0.262973,0
巴士底狱(1946),巴士底狱,notion,0,1,1,0,1,1,0.018893,4,0.282798,0.307938,0
巴山(1946),巴山,notion,0,1,1,0,1,1,0.013103,4,0.272684,0.291543,0
巴斯(1946),巴斯,notion,0,1,1,0,1,1,0.013103,4,0.272684,0.291543,0
巴而干(1946),巴而干,notion,0,1,1,0,1,1,0.013378,4,0.272039,0.290456,0
巴蜀(1946),巴蜀,notion,0,1,1,0,3,3,0.017626,4,0.281496,0.305894,0
币原(1946),币原,notion,0,1,1,0,1,1,0.017626,4,0.281496,0.305894,0
市区(1946),市区,notion,0,1,1,0,1,1,0.017626,4,0.281496,0.305894,0
市场(1946),市场,notion,0,3,3,0,3,3,0.03045,4,0.302468,0.336827,4936.761542
市容(1946),市容,notion,0,1,1,0,1,1,0.013634,4,0.273332,0.292631,0
市长(1946),市长,notion,0,1,1,0,1,1,0.013378,4,0.272039,0.290456,0
市集(1946),市集,notion,0,1,1,0,1,1,0.013103,4,0.272684,0.291543,0
市面(1946),市面,notion,0,1,1,0,1,1,0.018893,4,0.282798,0.307938,0
布尔(1946),布尔,notion,0,1,1,0,1,1,0.013103,4,0.272684,0.291543,0
布里(1946),布里,notion,0,1,1,0,1,1,0.013103,4,0.272684,0.291543,0
师节(1946),师节,notion,0,1,1,0,1,1,0.017626,4,0.281496,0.305894,0
师资(1946),师资,notion,0,1,1,0,1,1,0.017626,4,0.281496,0.305894,0
希冀(1946),希冀,notion,0,1,1,0,1,1,0.018893,4,0.282798,0.307938,0
希腊(1946),希腊,notion,0,4,4,0,9,9,0.044604,4,0.320833,0.360555,6596.996957
帝俄(1946),帝俄,notion,0,1,1,0,1,1,0.017626,4,0.281496,0.305894,0
帝国主义(1946),帝国主义,notion,0,3,3,0,6,6,0.045374,4,0.322561,0.36257,4563.560502
带刺(1946),带刺,notion,0,1,1,0,1,1,0.018893,4,0.282798,0.307938,0
带来(1946),带来,notion,0,2,2,0,2,2,0.020262,4,0.282243,0.30714,1027.722249
带枪(1946),带枪,notion,0,1,1,0,1,1,0.013634,4,0.273332,0.292631,0
帮凶(1946),帮凶,notion,0,1,1,0,1,1,0.018893,4,0.282798,0.307938,0
帮助(1946),帮助,notion,0,1,1,0,1,1,0.013103,4,0.272684,0.291543,0
帮忙(1946),帮忙,notion,0,1,1,0,1,1,0.018893,4,0.282798,0.307938,0
常住(1946),常住,notion,0,1,1,0,1,1,0.017626,4,0.281496,0.305894,0
常常(1946),常常,notion,0,1,1,0,1,1,0.017626,4,0.281496,0.305894,0
常熟(1946),常熟,notion,0,2,2,0,2,2,0.027011,4,0.292079,0.322056,1114.922273
常识(1946),常识,notion,0,1,1,0,1,1,0.013634,4,0.273332,0.292631,0
帽子(1946),帽子,notion,0,1,1,0,1,1,0.017626,4,0.281496,0.305894,0
幕后(1946),幕后,notion,0,1,1,0,1,1,0.004564,4,0.256755,0.263104,0
干什么(1946),干什么,notion,0,1,1,0,1,1,0.013378,4,0.272039,0.290456,0
干涉(1946),干涉,notion,0,3,3,0,5,5,0.045374,4,0.322561,0.36257,4563.560502
干部(1946),干部,notion,0,2,2,0,2,2,0.009784,4,0.265751,0.279657,874.170092
平了(1946),平了,notion,0,1,1,0,1,1,0.013634,4,0.273332,0.292631,0
平剧(1946),平剧,notion,0,2,2,0,2,2,0.032527,4,0.303393,0.338015,1614.891208
平和(1946),平和,notion,0,1,1,0,1,1,0.004479,4,0.256686,0.262973,0
平定(1946),平定,notion,0,1,1,0,1,1,0.018893,4,0.282798,0.307938,0
平息(1946),平息,notion,0,1,1,0,1,1,0.017626,4,0.281496,0.305894,0
平时(1946),平时,notion,0,1,1,0,1,1,0.004564,4,0.256755,0.263104,0
平民(1946),平民,notion,0,2,2,0,3,3,0.017667,4,0.277985,0.300357,781.701364
平津(1946),平津,notion,0,2,2,0,3,3,0.032271,4,0.301168,0.334971,1271.496707
平等(1946),平等,notion,0,3,3,0,3,3,0.030531,4,0.296447,0.328434,2371.097895
平衡(1946),平衡,notion,0,2,2,0,2,2,0.027011,4,0.292079,0.322056,1114.922273
平议(1946),平议,notion,0,3,3,0,3,3,0.020404,4,0.279689,0.303169,1970.576102
平静(1946),平静,notion,0,1,1,0,1,1,0.018893,4,0.282798,0.307938,0
年内(1946),年内,notion,0,1,1,0,1,1,0.017626,4,0.281496,0.305894,0
年度预算(1946),年度预算,notion,0,1,1,0,1,1,0.00826,4,0.264992,0.278237,0
年间(1946),年间,notion,0,4,4,0,5,5,0.045835,4,0.326036,0.366774,10853.893786
并告(1946),并告,notion,0,1,1,0,1,1,0.018893,4,0.282798,0.307938,0
并非(1946),并非,notion,0,1,1,0,1,1,0.013378,4,0.272039,0.290456,0
幸事(1946),幸事,notion,0,1,1,0,1,1,0.018893,4,0.282798,0.307938,0
幸福(1946),幸福,notion,0,2,2,0,2,2,0.018938,4,0.282437,0.307445,1861.68946
幸运(1946),幸运,notion,0,1,1,0,1,1,0.004577,4,0.257676,0.264843,0
幻影(1946),幻影,notion,0,1,1,0,1,1,0.018893,4,0.282798,0.307938,0
幻想(1946),幻想,notion,0,3,3,0,4,4,0.026215,4,0.293481,0.324172,4936.667753
幻灭(1946),幻灭,notion,0,1,1,0,1,1,0.013103,4,0.272684,0.291543,0
幼稚园(1946),幼稚园,notion,0,1,1,0,1,1,0.003608,4,0.255568,0.260842,0
广东(1946),广东,notion,0,6,6,0,9,9,0.0665,4,0.36416,0.407056,21784.796399
广东省(1946),广东省,notion,0,1,1,0,1,1,0.004479,4,0.256686,0.262973,0
广场(1946),广场,notion,0,1,1,0,1,1,0.007159,4,0.261235,0.271453,0
广岛(1946),广岛,notion,0,1,1,0,2,2,0.013378,4,0.272039,0.290456,0
广州市(1946),广州市,notion,0,1,1,0,1,1,0.017626,4,0.281496,0.305894,0
广播电台(1946),广播电台,notion,0,1,1,0,1,1,0.004237,4,0.256206,0.26206,0
广西(1946),广西,notion,0,3,3,0,3,3,0.025272,4,0.288098,0.316214,2279.249628
广西省(1946),广西省,notion,0,1,1,0,1,1,0.018893,4,0.282798,0.307938,0
庆幸(1946),庆幸,notion,0,2,2,0,2,2,0.021638,4,0.286262,0.313359,1666.282153
庆祝(1946),庆祝,notion,0,4,4,0,6,6,0.058413,4,0.353328,0.396388,13242.45567
序幕(1946),序幕,notion,0,1,1,0,1,1,0.003608,4,0.255568,0.260842,0
庐山会议(1946),庐山会议,notion,0,1,1,0,1,1,0.009637,4,0.265506,0.27915,0
庐山真面目(1946),庐山真面目,notion,0,1,1,0,1,1,0.013634,4,0.273332,0.292631,0
应予(1946),应予,notion,0,1,1,0,1,1,0.009637,4,0.265506,0.27915,0
应付(1946),应付,notion,0,3,3,0,3,3,0.031248,4,0.296661,0.328738,2223.968046
应即(1946),应即,notion,0,1,1,0,1,1,0.013378,4,0.272039,0.290456,0
应声虫(1946),应声虫,notion,0,1,1,0,1,1,0.001496,4,0.252204,0.25432,0
应当(1946),应当,notion,0,3,3,0,3,3,0.034311,4,0.305912,0.34148,4332.223906
应有(1946),应有,notion,0,4,4,0,5,5,0.053745,4,0.337046,0.379298,8747.649964
应毖后(1946),应毖后,notion,0,1,1,0,1,1,0.00826,4,0.264992,0.278237,0
应由(1946),应由,notion,0,1,1,0,1,1,0.013378,4,0.272039,0.290456,0
应贯澈(1946),应贯澈,notion,0,1,1,0,1,1,0.004237,4,0.256206,0.26206,0
庙会(1946),庙会,notion,0,1,1,0,1,1,0.017626,4,0.281496,0.305894,0
府上(1946),府上,notion,0,1,1,0,1,1,0.018893,4,0.282798,0.307938,0
废墟(1946),废墟,notion,0,1,1,0,1,1,0.018893,4,0.282798,0.307938,0
废止(1946),废止,notion,0,2,2,0,2,2,0.016734,4,0.276967,0.298704,731.151147
座谈会(1946),座谈会,notion,0,1,1,0,1,1,0.00826,4,0.264992,0.278237,0
康庄大道(1946),康庄大道,notion,0,1,1,0,1,1,0.0031,4,0.254504,0.258799,0
延期(1946),延期,notion,0,3,3,0,4,4,0.040898,4,0.317677,0.356613,4835.835906
建国大纲(1946),建国大纲,notion,0,1,1,0,1,1,0.018893,4,0.282798,0.307938,0
建成(1946),建成,notion,0,1,1,0,1,1,0.0031,4,0.254504,0.258799,0
建立(1946),建立,notion,0,2,2,0,2,2,0.007845,4,0.261069,0.271221,313.925463
建筑(1946),建筑,notion,0,1,1,0,1,1,0.005304,4,0.259537,0.268322,0
建议书(1946),建议书,notion,0,2,2,0,2,2,0.023271,4,0.287177,0.31475,1230.541816
建造(1946),建造,notion,0,1,1,0,1,1,0.018893,4,0.282798,0.307938,0
建都(1946),建都,notion,0,1,1,0,1,1,0.017626,4,0.281496,0.305894,0
廿七(1946),廿七,notion,0,1,1,0,1,1,0.00826,4,0.264992,0.278237,0
廿九(1946),廿九,notion,0,2,2,0,3,3,0.021363,4,0.287407,0.315098,2175.293762
廿二(1946),廿二,notion,0,1,1,0,1,1,0.00826,4,0.264992,0.278237,0
廿至(1946),廿至,notion,0,1,1,0,1,1,0.00826,4,0.264992,0.278237,0
开会(1946),开会,notion,0,2,2,0,2,2,0.036519,4,0.313896,0.3518,2490.161613
开倒车(1946),开倒车,notion,0,1,1,0,1,1,0.013634,4,0.273332,0.292631,0
开刀(1946),开刀,notion,0,1,1,0,1,1,0.00826,4,0.264992,0.278237,0
开创(1946),开创,notion,0,1,1,0,1,1,0.017626,4,0.281496,0.305894,0
开原(1946),开原,notion,0,1,1,0,1,1,0.013634,4,0.273332,0.292631,0
开场白(1946),开场白,notion,0,1,1,0,1,1,0.017626,4,0.281496,0.305894,0
开始(1946),开始,notion,0,4,4,0,8,8,0.055011,4,0.335551,0.377645,7807.958054
开学(1946),开学,notion,0,1,1,0,1,1,0.007159,4,0.261235,0.271453,0
开审(1946),开审,notion,0,1,1,0,1,1,0.017626,4,0.281496,0.305894,0
开展(1946),开展,notion,0,1,1,0,1,1,0.017626,4,0.281496,0.305894,0
开幕(1946),开幕,notion,0,3,3,0,6,6,0.049897,4,0.333295,0.375051,5595.386463
开放(1946),开放,notion,0,5,5,0,7,7,0.062773,4,0.352332,0.39546,12549.390884
开除(1946),开除,notion,0,1,1,0,1,1,0.018893,4,0.282798,0.307938,0
异同(1946),异同,notion,0,1,1,0,1,1,0.017626,4,0.281496,0.305894,0
异哉(1946),异哉,notion,0,1,1,0,1,1,0.018893,4,0.282798,0.307938,0
异点(1946),异点,notion,0,1,1,0,1,1,0.013378,4,0.272039,0.290456,0
弃世(1946),弃世,notion,0,1,1,0,1,1,0.018893,4,0.282798,0.307938,0
引言(1946),引言,notion,0,1,1,0,1,1,0.009637,4,0.265506,0.27915,0
引退(1946),引退,notion,0,1,1,0,1,1,0.004577,4,0.257676,0.264843,0
弟兄们(1946),弟兄们,notion,0,1,1,0,1,1,0.013634,4,0.273332,0.292631,0
张一麟(1946),张一麟,notion,0,1,1,0,1,1,0.013378,4,0.272039,0.290456,0
张发奎(1946),张发奎,notion,0,1,1,0,1,1,0.00826,4,0.264992,0.278237,0
张垣(1946),张垣,notion,0,1,1,0,1,1,0.004237,4,0.256206,0.26206,0
张家口(1946),张家口,notion,0,7,7,0,9,9,0.079887,4,0.378199,0.41987,26205.914741
张居正(1946),张居正,notion,0,1,1,0,1,1,0.017626,4,0.281496,0.305894,0
张文伯(1946),张文伯,notion,0,1,1,0,1,1,0.017626,4,0.281496,0.305894,0
张炎(1946),张炎,notion,0,1,1,0,1,1,0.018893,4,0.282798,0.307938,0
张群于(1946),张群于,notion,0,1,1,0,1,1,0.013378,4,0.272039,0.290456,0
张苍水(1946),张苍水,notion,0,1,1,0,1,1,0.013378,4,0.272039,0.290456,0
张莘夫(1946),张莘夫,notion,0,1,1,0,1,1,0.003608,4,0.255568,0.260842,0
张表方(1946),张表方,notion,0,1,1,0,1,1,0.004237,4,0.256206,0.26206,0
张邦翰(1946),张邦翰,notion,0,1,1,0,1,1,0.004577,4,0.257676,0.264843,0
弥天(1946),弥天,notion,0,1,1,0,1,1,0.004564,4,0.256755,0.263104,0
弥漫着(1946),弥漫着,notion,0,1,1,0,1,1,0.00826,4,0.264992,0.278237,0
弥补(1946),弥补,notion,0,1,1,0,1,1,0.005304,4,0.259537,0.268322,0
弱小民族(1946),弱小民族,notion,0,1,1,0,1,1,0.017626,4,0.281496,0.305894,0
弱点(1946),弱点,notion,0,1,1,0,1,1,0.005461,4,0.25793,0.265322,0
弹今(1946),弹今,notion,0,1,1,0,1,1,0.018893,4,0.282798,0.307938,0
强化(1946),强化,notion,0,2,2,0,2,2,0.009784,4,0.265751,0.279657,874.170092
强国(1946),强国,notion,0,1,1,0,1,1,0.013103,4,0.272684,0.291543,0
强大(1946),强大,notion,0,1,1,0,1,1,0.013103,4,0.272684,0.291543,0
强奸民意(1946),强奸民意,notion,0,1,1,0,1,1,0.00826,4,0.264992,0.278237,0
强权政治(1946),强权政治,notion,0,1,1,0,1,1,0.017626,4,0.281496,0.305894,0
强身(1946),强身,notion,0,1,1,0,2,2,0.018893,4,0.282798,0.307938,0
强迫(1946),强迫,notion,0,1,1,0,1,1,0.018893,4,0.282798,0.307938,0
归去(1946),归去,notion,0,1,1,0,1,1,0.00826,4,0.264992,0.278237,0
归户(1946),归户,notion,0,1,1,0,1,1,0.013378,4,0.272039,0.290456,0
归甲(1946),归甲,notion,0,2,2,0,2,2,0.027011,4,0.292079,0.322056,1114.922273
归绥(1946),归绥,notion,0,2,2,0,2,2,0.025886,4,0.296968,0.329101,2935.752997
当作(1946),当作,notion,0,1,1,0,2,2,0.013634,4,0.273332,0.292631,0
当兵(1946),当兵,notion,0,1,1,0,1,1,0.018893,4,0.282798,0.307938,0
当地(1946),当地,notion,0,1,1,0,1,1,0.007159,4,0.261235,0.271453,0
当夜(1946),当夜,notion,0,1,1,0,1,1,0.007159,4,0.261235,0.271453,0
当局(1946),当局,notion,0,2,2,0,3,3,0.026052,4,0.291576,0.321317,1054.556401
当心(1946),当心,notion,0,3,3,0,8,8,0.045904,4,0.321478,0.361266,4001.310187
形势(1946),形势,notion,0,5,5,0,10,10,0.061323,4,0.346848,0.38985,13843.925714
形式(1946),形式,notion,0,1,1,0,1,1,0.0031,4,0.254504,0.258799,0
形形色色(1946),形形色色,notion,0,2,2,0,2,2,0.021638,4,0.286262,0.313359,1666.282153
形态(1946),形态,notion,0,1,1,0,1,1,0.00826,4,0.264992,0.278237,0
形成(1946),形成,notion,0,1,1,0,1,1,0.013103,4,0.272684,0.291543,0
形色(1946),形色,notion,0,1,1,0,1,1,0.018893,4,0.282798,0.307938,0
形象(1946),形象,notion,0,1,1,0,1,1,0.013634,4,0.273332,0.292631,0
彭学沛(1946),彭学沛,notion,0,3,3,0,4,4,0.03675,4,0.306009,0.34161,2784.160749
彭部长(1946),彭部长,notion,0,1,1,0,1,1,0.018893,4,0.282798,0.307938,0
影剧(1946),影剧,notion,0,1,1,0,1,1,0.017626,4,0.281496,0.305894,0
影响(1946),影响,notion,0,4,4,0,6,6,0.05072,4,0.33237,0.37408,7667.008121
影展(1946),影展,notion,0,1,1,0,1,1,0.013103,4,0.272684,0.291543,0
影片(1946),影片,notion,0,1,1,0,1,1,0.018893,4,0.282798,0.307938,0
彷徨(1946),彷徨,notion,0,2,2,0,2,2,0.020536,4,0.280891,0.30501,760.639997
彼得罗夫(1946),彼得罗夫,notion,0,1,1,0,1,1,0.013103,4,0.272684,0.291543,0
往事(1946),往事,notion,0,3,3,0,3,3,0.033639,4,0.301452,0.335435,3196.708035
征人怨(1946),征人怨,notion,0,1,1,0,1,1,0.009637,4,0.265506,0.27915,0
征兵(1946),征兵,notion,0,2,2,0,4,4,0.011638,4,0.266812,0.281527,466.757155
征实(1946),征实,notion,0,5,5,0,5,5,0.056502,4,0.345099,0.388024,14523.533284
征求意见(1946),征求意见,notion,0,1,1,0,1,1,0.013103,4,0.272684,0.291543,0
征粮(1946),征粮,notion,0,1,1,0,1,1,0.00826,4,0.264992,0.278237,0
待稿(1946),待稿,notion,0,1,1,0,2,2,0.018893,4,0.282798,0.307938,0
待遇(1946),待遇,notion,0,4,4,0,5,5,0.038747,4,0.308373,0.344814,6550.971267
律务(1946),律务,notion,0,1,1,0,1,1,0.005304,4,0.259537,0.268322,0
徐家(1946),徐家,notion,0,1,1,0,1,1,0.007159,4,0.261235,0.271453,0
徐永昌(1946),徐永昌,notion,0,1,1,0,1,1,0.013378,4,0.272039,0.290456,0
徒然(1946),徒然,notion,0,1,1,0,1,1,0.004577,4,0.257676,0.264843,0
得到(1946),得到,notion,0,1,1,0,1,1,0.004577,4,0.257676,0.264843,0
得意忘形(1946),得意忘形,notion,0,1,1,0,1,1,0.004564,4,0.256755,0.263104,0
得民心(1946),得民心,notion,0,1,1,0,1,1,0.0031,4,0.254504,0.258799,0
得读(1946),得读,notion,0,1,1,0,1,1,0.004577,4,0.257676,0.264843,0
得陇望蜀(1946),得陇望蜀,notion,0,1,1,0,1,1,0.017626,4,0.281496,0.305894,0
御制(1946),御制,notion,0,1,1,0,1,1,0.004564,4,0.256755,0.263104,0
徬徨(1946),徬徨,notion,0,2,2,0,2,2,0.030729,4,0.302946,0.337407,2092.27198
徭人(1946),徭人,notion,0,1,1,0,1,1,0.017626,4,0.281496,0.305894,0
微妙(1946),微妙,notion,0,1,1,0,1,1,0.013378,4,0.272039,0.290456,0
徵收(1946),徵收,notion,0,1,1,0,1,1,0.017626,4,0.281496,0.305894,0
徵文(1946),徵文,notion,0,1,1,0,7,7,0.017626,4,0.281496,0.305894,0
徵求(1946),徵求,notion,0,1,1,0,1,1,0.017626,4,0.281496,0.305894,0
德境(1946),德境,notion,0,1,1,0,1,1,0.013103,4,0.272684,0.291543,0
德意志(1946),德意志,notion,0,1,1,0,1,1,0.017626,4,0.281496,0.305894,0
心劳日(1946),心劳日,notion,0,1,1,0,1,1,0.004237,4,0.256206,0.26206,0
心声(1946),心声,notion,0,1,1,0,1,1,0.007159,4,0.261235,0.271453,0
心得(1946),心得,notion,0,1,1,0,1,1,0.005304,4,0.259537,0.268322,0
心思(1946),心思,notion,0,1,1,0,1,1,0.00826,4,0.264992,0.278237,0
心情(1946),心情,notion,0,1,1,0,1,1,0.005304,4,0.259537,0.268322,0
心花(1946),心花,notion,0,1,1,0,1,1,0.003608,4,0.255568,0.260842,0
心里(1946),心里,notion,0,1,1,0,2,2,0.007159,4,0.261235,0.271453,0
心鬥角(1946),心鬥角,notion,0,1,1,0,1,1,0.017626,4,0.281496,0.305894,0
必先(1946),必先,notion,0,1,1,0,1,1,0.017626,4,0.281496,0.305894,0
必定(1946),必定,notion,0,1,1,0,1,1,0.004564,4,0.256755,0.263104,0
必属(1946),必属,notion,0,1,1,0,1,1,0.00826,4,0.264992,0.278237,0
必废(1946),必废,notion,0,1,1,0,1,1,0.013634,4,0.273332,0.292631,0
必死于(1946),必死于,notion,0,1,1,0,1,1,0.013378,4,0.272039,0.290456,0
必然(1946),必然,notion,0,2,2,0,2,2,0.027011,4,0.292079,0.322056,1114.922273
必胜(1946),必胜,notion,0,1,1,0,1,1,0.018893,4,0.282798,0.307938,0
必要(1946),必要,notion,0,2,2,0,2,2,0.027264,4,0.294896,0.326144,1405.794223
必遭(1946),必遭,notion,0,1,1,0,1,1,0.005461,4,0.25793,0.265322,0
必需(1946),必需,notion,0,2,2,0,2,2,0.006708,4,0.259396,0.268134,286.232035
必须(1946),必须,notion,0,9,9,0,20,20,0.090054,4,0.399819,0.437888,45739.390831
忆旧(1946),忆旧,notion,0,1,1,0,1,1,0.009637,4,0.265506,0.27915,0
忆费巩(1946),忆费巩,notion,0,1,1,0,1,1,0.013378,4,0.272039,0.290456,0
忌辰(1946),忌辰,notion,0,1,1,0,1,1,0.013103,4,0.272684,0.291543,0
忍耐(1946),忍耐,notion,0,1,1,0,1,1,0.018893,4,0.282798,0.307938,0
忍让(1946),忍让,notion,0,1,1,0,1,1,0.017626,4,0.281496,0.305894,0
忍辱负重(1946),忍辱负重,notion,0,1,1,0,1,1,0.013378,4,0.272039,0.290456,0
忏悔(1946),忏悔,notion,0,1,1,0,1,1,0.005304,4,0.259537,0.268322,0
志趣(1946),志趣,notion,0,1,1,0,1,1,0.004577,4,0.257676,0.264843,0
忘记(1946),忘记,notion,0,2,2,0,2,2,0.026481,4,0.292853,0.323187,1408.34579
忙人(1946),忙人,notion,0,1,1,0,1,1,0.005304,4,0.259537,0.268322,0
忠义(1946),忠义,notion,0,1,1,0,1,1,0.013634,4,0.273332,0.292631,0
忠告(1946),忠告,notion,0,1,1,0,1,1,0.013378,4,0.272039,0.290456,0
忠奸(1946),忠奸,notion,0,1,1,0,1,1,0.018893,4,0.282798,0.307938,0
忠实(1946),忠实,notion,0,2,2,0,2,2,0.021363,4,0.287407,0.315098,2175.293762
忧惭(1946),忧惭,notion,0,1,1,0,1,1,0.005304,4,0.259537,0.268322,0
忧虑(1946),忧虑,notion,0,1,1,0,1,1,0.017626,4,0.281496,0.305894,0
忧郁(1946),忧郁,notion,0,1,1,0,1,1,0.005304,4,0.259537,0.268322,0
忧鬱(1946),忧鬱,notion,0,1,1,0,1,1,0.003608,4,0.255568,0.260842,0
快人快语(1946),快人快语,notion,0,1,1,0,1,1,0.013634,4,0.273332,0.292631,0
快板(1946),快板,notion,0,1,1,0,1,1,0.013103,4,0.272684,0.291543,0
忽然(1946),忽然,notion,0,1,1,0,1,1,0.013634,4,0.273332,0.292631,0
忽视(1946),忽视,notion,0,1,1,0,1,1,0.018893,4,0.282798,0.307938,0
忿恨(1946),忿恨,notion,0,1,1,0,1,1,0.018893,4,0.282798,0.307938,0
怀念(1946),怀念,notion,0,2,2,0,2,2,0.016478,4,0.275375,0.296095,554.656682
怀阳(1946),怀阳,notion,0,1,1,0,1,1,0.018893,4,0.282798,0.307938,0
态度(1946),态度,notion,0,7,7,0,9,9,0.068793,4,0.355953,0.399214,20847.266606
怎么(1946),怎么,notion,0,1,1,0,1,1,0.013378,4,0.272039,0.290456,0
怎么回事(1946),怎么回事,notion,0,1,1,0,1,1,0.013378,4,0.272039,0.290456,0
怎么样(1946),怎么样,notion,0,2,2,0,2,2,0.023015,4,0.2849,0.311272,897.577022
怎样才能(1946),怎样才能,notion,0,1,1,0,1,1,0.004577,4,0.257676,0.264843,0
怎能(1946),怎能,notion,0,1,1,0,1,1,0.013103,4,0.272684,0.291543,0
怒潮(1946),怒潮,notion,0,1,1,0,1,1,0.013634,4,0.273332,0.292631,0
思乡(1946),思乡,notion,0,1,1,0,1,1,0.013103,4,0.272684,0.291543,0
思想界(1946),思想界,notion,0,1,1,0,1,1,0.017626,4,0.281496,0.305894,0
思想路线(1946),思想路线,notion,0,1,1,0,1,1,0.013378,4,0.272039,0.290456,0
思琐(1946),思琐,notion,0,1,1,0,1,1,0.018893,4,0.282798,0.307938,0
怡案(1946),怡案,notion,0,1,1,0,1,1,0.005461,4,0.25793,0.265322,0
急务(1946),急务,notion,0,1,1,0,1,1,0.018893,4,0.282798,0.307938,0
急待(1946),急待,notion,0,1,1,0,2,2,0.017626,4,0.281496,0.305894,0
急谋(1946),急谋,notion,0,1,1,0,1,1,0.013378,4,0.272039,0.290456,0
急须(1946),急须,notion,0,1,1,0,1,1,0.013378,4,0.272039,0.290456,0
性命(1946),性命,notion,0,1,1,0,1,1,0.018893,4,0.282798,0.307938,0
性格(1946),性格,notion,0,1,1,0,1,1,0.004577,4,0.257676,0.264843,0
性质(1946),性质,notion,0,1,1,0,1,1,0.005461,4,0.25793,0.265322,0
怨声(1946),怨声,notion,0,1,1,0,1,1,0.018893,4,0.282798,0.307938,0
怨愤(1946),怨愤,notion,0,1,1,0,1,1,0.00826,4,0.264992,0.278237,0
怪案(1946),怪案,notion,0,1,1,0,1,1,0.017626,4,0.281496,0.305894,0
怪现象(1946),怪现象,notion,0,1,1,0,1,1,0.004237,4,0.256206,0.26206,0
总之(1946),总之,notion,0,1,1,0,1,1,0.017626,4,0.281496,0.305894,0
总司令(1946),总司令,notion,0,1,1,0,1,1,0.013634,4,0.273332,0.292631,0
总和(1946),总和,notion,0,1,1,0,1,1,0.018893,4,0.282798,0.307938,0
总暑长(1946),总暑长,notion,0,1,1,0,1,1,0.013378,4,0.272039,0.290456,0
总有(1946),总有,notion,0,1,1,0,1,1,0.013634,4,0.273332,0.292631,0
总统(1946),总统,notion,0,1,1,0,2,2,0.009637,4,0.265506,0.27915,0
总统制(1946),总统制,notion,0,2,2,0,3,3,0.015099,4,0.271653,0.289877,456.530119
总裁(1946),总裁,notion,0,2,2,0,2,2,0.027264,4,0.294896,0.326144,1405.794223
总评(1946),总评,notion,0,1,1,0,1,1,0.017626,4,0.281496,0.305894,0
总该有(1946),总该有,notion,0,1,1,0,1,1,0.013378,4,0.272039,0.290456,0
总队(1946),总队,notion,0,1,1,0,1,1,0.013634,4,0.273332,0.292631,0
总领事(1946),总领事,notion,0,1,1,0,1,1,0.013103,4,0.272684,0.291543,0
恐怖(1946),恐怖,notion,0,5,5,0,9,9,0.059469,4,0.34815,0.391198,17466.105162
恐慌(1946),恐慌,notion,0,2,2,0,3,3,0.030729,4,0.302946,0.337407,2092.27198
恢复(1946),恢复,notion,0,4,4,0,4,4,0.05979,4,0.350314,0.393344,10177.77645
恭读(1946),恭读,notion,0,1,1,0,1,1,0.013634,4,0.273332,0.292631,0
恭述(1946),恭述,notion,0,1,1,0,1,1,0.017626,4,0.281496,0.305894,0
恶例(1946),恶例,notion,0,1,1,0,1,1,0.013634,4,0.273332,0.292631,0
恶劣(1946),恶劣,notion,0,1,1,0,1,1,0.017626,4,0.281496,0.305894,0
恶意(1946),恶意,notion,0,1,1,0,1,1,0.013103,4,0.272684,0.291543,0
恶果(1946),恶果,notion,0,1,1,0,1,1,0.004564,4,0.256755,0.263104,0
恶梦(1946),恶梦,notion,0,1,1,0,1,1,0.013634,4,0.273332,0.292631,0
恶罪(1946),恶罪,notion,0,1,1,0,1,1,0.013378,4,0.272039,0.290456,0
恶霸(1946),恶霸,notion,0,1,1,0,1,1,0.018893,4,0.282798,0.307938,0
恺撒(1946),恺撒,notion,0,1,1,0,1,1,0.013378,4,0.272039,0.290456,0
患难(1946),患难,notion,0,1,1,0,1,1,0.005304,4,0.259537,0.268322,0
悬崖勒马(1946),悬崖勒马,notion,0,1,1,0,1,1,0.018893,4,0.282798,0.307938,0
悲凉(1946),悲凉,notion,0,1,1,0,1,1,0.018893,4,0.282798,0.307938,0
悲剧(1946),悲剧,notion,0,7,7,0,10,10,0.074627,4,0.372658,0.414956,24639.097015
悲喜剧(1946),悲喜剧,notion,0,4,4,0,4,4,0.03671,4,0.301516,0.335595,3513.087054
悲惨(1946),悲惨,notion,0,1,1,0,1,1,0.00826,4,0.264992,0.278237,0
悲愤(1946),悲愤,notion,0,4,4,0,4,4,0.047273,4,0.322814,0.362947,7343.791559
悲观(1946),悲观,notion,0,3,3,0,3,3,0.025566,4,0.291369,0.321085,4028.809984
悼征军(1946),悼征军,notion,0,1,1,0,1,1,0.013634,4,0.273332,0.292631,0
悼辞(1946),悼辞,notion,0,1,1,0,1,1,0.013103,4,0.272684,0.291543,0
情势(1946),情势,notion,0,2,2,0,2,2,0.022204,4,0.287896,0.315838,1406.192172
情形(1946),情形,notion,0,2,2,0,2,2,0.020262,4,0.282243,0.30714,1027.722249
情感(1946),情感,notion,0,1,1,0,1,1,0.005304,4,0.259537,0.268322,0
情绪(1946),情绪,notion,0,1,1,0,1,1,0.009637,4,0.265506,0.27915,0
惊人(1946),惊人,notion,0,1,1,0,1,1,0.013103,4,0.272684,0.291543,0
惊喜(1946),惊喜,notion,0,1,1,0,1,1,0.018893,4,0.282798,0.307938,0
惊异(1946),惊异,notion,0,1,1,0,1,1,0.013634,4,0.273332,0.292631,0
惊弓之鸟(1946),惊弓之鸟,notion,0,1,1,0,1,1,0.018893,4,0.282798,0.307938,0
惊涛骇浪(1946),惊涛骇浪,notion,0,1,1,0,1,1,0.018893,4,0.282798,0.307938,0
惊魄(1946),惊魄,notion,0,1,1,0,1,1,0.009637,4,0.265506,0.27915,0
惜别(1946),惜别,notion,0,1,1,0,1,1,0.005461,4,0.25793,0.265322,0
惟一(1946),惟一,notion,0,1,1,0,1,1,0.009637,4,0.265506,0.27915,0
惟我独尊(1946),惟我独尊,notion,0,1,1,0,1,1,0.004237,4,0.256206,0.26206,0
惠鉴(1946),惠鉴,notion,0,1,1,0,1,1,0.004577,4,0.257676,0.264843,0
惠阳(1946),惠阳,notion,0,1,1,0,1,1,0.00826,4,0.264992,0.278237,0
惨剧(1946),惨剧,notion,0,1,1,0,3,3,0.013634,4,0.273332,0.292631,0
惨宁(1946),惨宁,notion,0,1,1,0,1,1,0.013378,4,0.272039,0.290456,0
惨痛(1946),惨痛,notion,0,1,1,0,2,2,0.013634,4,0.273332,0.292631,0
惨祸(1946),惨祸,notion,0,1,1,0,1,1,0.00826,4,0.264992,0.278237,0
惨谈(1946),惨谈,notion,0,1,1,0,1,1,0.00826,4,0.264992,0.278237,0
惨败(1946),惨败,notion,0,1,1,0,1,1,0.005461,4,0.25793,0.265322,0
惨跌(1946),惨跌,notion,0,1,1,0,1,1,0.004479,4,0.256686,0.262973,0
惨闻(1946),惨闻,notion,0,1,1,0,1,1,0.004479,4,0.256686,0.262973,0
惩前(1946),惩前,notion,0,1,1,0,1,1,0.00826,4,0.264992,0.278237,0
惭愧(1946),惭愧,notion,0,1,1,0,1,1,0.0031,4,0.254504,0.258799,0
想到(1946),想到,notion,0,2,2,0,2,2,0.009043,4,0.262236,0.273352,284.685012
想思(1946),想思,notion,0,1,1,0,1,1,0.005461,4,0.25793,0.265322,0
想想(1946),想想,notion,0,1,1,0,1,1,0.013378,4,0.272039,0.290456,0
想起(1946),想起,notion,0,5,5,0,7,7,0.061323,4,0.346848,0.38985,13843.925714
愈见(1946),愈见,notion,0,1,1,0,1,1,0.013103,4,0.272684,0.291543,0
愉快(1946),愉快,notion,0,1,1,0,1,1,0.005304,4,0.259537,0.268322,0
意南(1946),意南,notion,0,1,1,0,1,1,0.013103,4,0.272684,0.291543,0
意外(1946),意外,notion,0,2,2,0,2,2,0.012463,4,0.270274,0.287528,1220.09749
意大利(1946),意大利,notion,0,2,2,0,5,5,0.017667,4,0.277985,0.300357,781.701364
意见书(1946),意见书,notion,0,1,1,0,1,1,0.017626,4,0.281496,0.305894,0
意趣(1946),意趣,notion,0,1,1,0,1,1,0.005304,4,0.259537,0.268322,0
愚蠢(1946),愚蠢,notion,0,3,3,0,3,3,0.037988,4,0.308903,0.345437,2989.281487
感动(1946),感动,notion,0,1,1,0,1,1,0.013103,4,0.272684,0.291543,0
感应(1946),感应,notion,0,1,1,0,4,4,0.005304,4,0.259537,0.268322,0
感悟(1946),感悟,notion,0,1,1,0,3,3,0.005304,4,0.259537,0.268322,0
感情(1946),感情,notion,0,1,1,0,1,1,0.003608,4,0.255568,0.260842,0
感想(1946),感想,notion,0,7,7,0,17,17,0.074724,4,0.381613,0.422827,35066.486318
感慨(1946),感慨,notion,0,1,1,0,1,1,0.013634,4,0.273332,0.292631,0
感觉(1946),感觉,notion,0,2,2,0,2,2,0.007677,4,0.261592,0.272178,462.162807
感言(1946),感言,notion,0,5,5,0,5,5,0.059779,4,0.339194,0.381719,9574.925148
感谢(1946),感谢,notion,0,1,1,0,1,1,0.013634,4,0.273332,0.292631,0
感赋(1946),感赋,notion,0,1,1,0,1,1,0.017626,4,0.281496,0.305894,0
愤世(1946),愤世,notion,0,1,1,0,1,1,0.004577,4,0.257676,0.264843,0
愤怒(1946),愤怒,notion,0,3,3,0,3,3,0.025875,4,0.291133,0.320737,2969.211348
愤概(1946),愤概,notion,0,1,1,0,1,1,0.00826,4,0.264992,0.278237,0
愤激(1946),愤激,notion,0,1,1,0,1,1,0.00826,4,0.264992,0.278237,0
愤语(1946),愤语,notion,0,1,1,0,1,1,0.013634,4,0.273332,0.292631,0
愿意(1946),愿意,notion,0,1,1,0,1,1,0.018893,4,0.282798,0.307938,0
愿望(1946),愿望,notion,0,1,1,0,1,1,0.005304,4,0.259537,0.268322,0
慈禧太后(1946),慈禧太后,notion,0,1,1,0,1,1,0.009637,4,0.265506,0.27915,0
慧星(1946),慧星,notion,0,1,1,0,1,1,0.018893,4,0.282798,0.307938,0
慰劳(1946),慰劳,notion,0,1,1,0,1,1,0.013634,4,0.273332,0.292631,0
慰问(1946),慰问,notion,0,2,2,0,2,2,0.032271,4,0.301168,0.334971,1271.496707
慰问信(1946),慰问信,notion,0,1,1,0,1,1,0.004237,4,0.256206,0.26206,0
懦怯(1946),懦怯,notion,0,1,1,0,1,1,0.013378,4,0.272039,0.290456,0
戈培尔(1946),戈培尔,notion,0,1,1,0,1,1,0.013103,4,0.272684,0.291543,0
戈宝权(1946),戈宝权,notion,0,1,1,0,1,1,0.013103,4,0.272684,0.291543,0
戏剧节(1946),戏剧节,notion,0,1,1,0,1,1,0.013634,4,0.273332,0.292631,0
成为(1946),成为,notion,0,1,1,0,1,1,0.009637,4,0.265506,0.27915,0
成立(1946),成立,notion,0,6,6,0,6,6,0.06522,4,0.361232,0.404273,20111.560125
成绩(1946),成绩,notion,0,1,1,0,1,1,0.007159,4,0.261235,0.271453,0
成见(1946),成见,notion,0,1,1,0,1,1,0.004577,4,0.257676,0.264843,0
成败(1946),成败,notion,0,2,2,0,2,2,0.006708,4,0.259396,0.268134,286.232035
成都平原(1946),成都平原,notion,0,1,1,0,1,1,0.017626,4,0.281496,0.305894,0
成长(1946),成长,notion,0,1,1,0,1,1,0.018893,4,0.282798,0.307938,0
成问题(1946),成问题,notion,0,1,1,0,1,1,0.017626,4,0.281496,0.305894,0
我兄(1946),我兄,notion,0,1,1,0,1,1,0.004577,4,0.257676,0.264843,0
我底(1946),我底,notion,0,1,1,0,1,1,0.005304,4,0.259537,0.268322,0
我思(1946),我思,notion,0,1,1,0,1,1,0.013634,4,0.273332,0.292631,0
我是(1946),我是,notion,0,1,1,0,1,1,0.005304,4,0.259537,0.268322,0
我来(1946),我来,notion,0,2,2,0,2,2,0.008912,4,0.264602,0.277613,868.763301
或者(1946),或者,notion,0,1,1,0,1,1,0.013103,4,0.272684,0.291543,0
战乱(1946),战乱,notion,0,1,1,0,1,1,0.005304,4,0.259537,0.268322,0
战事(1946),战事,notion,0,2,2,0,2,2,0.030729,4,0.302946,0.337407,2092.27198
战从义(1946),战从义,notion,0,1,1,0,1,1,0.004577,4,0.257676,0.264843,0
战利品(1946),战利品,notion,0,1,1,0,1,1,0.017626,4,0.281496,0.305894,0
战国时代(1946),战国时代,notion,0,1,1,0,1,1,0.007159,4,0.261235,0.271453,0
战地(1946),战地,notion,0,1,1,0,1,1,0.017626,4,0.281496,0.305894,0
战场(1946),战场,notion,0,4,4,0,9,9,0.047689,4,0.324674,0.365165,8030.642763
战役(1946),战役,notion,0,1,1,0,1,1,0.007159,4,0.261235,0.271453,0
战斗力(1946),战斗力,notion,0,2,2,0,2,2,0.021894,4,0.287839,0.315751,2020.708436
战时(1946),战时,notion,0,1,1,0,1,1,0.017626,4,0.281496,0.305894,0
战是(1946),战是,notion,0,1,1,0,1,1,0.009637,4,0.265506,0.27915,0
战术(1946),战术,notion,0,1,1,0,1,1,0.013378,4,0.272039,0.290456,0
战火(1946),战火,notion,0,1,1,0,1,1,0.004564,4,0.256755,0.263104,0
战犯(1946),战犯,notion,0,1,1,0,2,2,0.017626,4,0.281496,0.305894,0
战略(1946),战略,notion,0,2,2,0,2,2,0.022204,4,0.287896,0.315838,1406.192172
战者(1946),战者,notion,0,1,1,0,1,1,0.009637,4,0.265506,0.27915,0
战胜(1946),战胜,notion,0,1,1,0,1,1,0.007159,4,0.261235,0.271453,0
战败(1946),战败,notion,0,5,5,0,5,5,0.052103,4,0.333024,0.374891,12144.770988
战门(1946),战门,notion,0,1,1,0,1,1,0.013378,4,0.272039,0.290456,0
战鬥(1946),战鬥,notion,0,1,1,0,1,1,0.003608,4,0.255568,0.260842,0
戡乱(1946),戡乱,notion,0,2,2,0,2,2,0.025886,4,0.296968,0.329101,2935.752997
戴爱莲(1946),戴爱莲,notion,0,1,1,0,1,1,0.018893,4,0.282798,0.307938,0
戴笠(1946),戴笠,notion,0,2,2,0,2,2,0.027011,4,0.292079,0.322056,1114.922273
戴高乐(1946),戴高乐,notion,0,3,3,0,3,3,0.036559,4,0.309069,0.345654,3546.560838
户口(1946),户口,notion,0,1,1,0,1,1,0.013378,4,0.272039,0.290456,0
户必(1946),户必,notion,0,2,2,0,2,2,0.027011,4,0.292079,0.322056,1114.922273
房东(1946),房东,notion,0,1,1,0,1,1,0.018893,4,0.282798,0.307938,0
房屋(1946),房屋,notion,0,1,1,0,2,2,0.017626,4,0.281496,0.305894,0
房荒(1946),房荒,notion,0,1,1,0,1,1,0.017626,4,0.281496,0.305894,0
所付(1946),所付,notion,0,1,1,0,1,1,0.007159,4,0.261235,0.271453,0
所以(1946),所以,notion,0,1,1,0,1,1,0.009637,4,0.265506,0.27915,0
所司(1946),所司,notion,0,1,1,0,1,1,0.018893,4,0.282798,0.307938,0
所在(1946),所在,notion,0,1,1,0,1,1,0.018893,4,0.282798,0.307938,0
所望(1946),所望,notion,0,2,2,0,3,3,0.018839,4,0.277904,0.300226,537.484117
所演(1946),所演,notion,0,1,1,0,1,1,0.007159,4,0.261235,0.271453,0
所见(1946),所见,notion,0,1,1,0,1,1,0.004479,4,0.256686,0.262973,0
所说(1946),所说,notion,0,1,1,0,1,1,0.009637,4,0.265506,0.27915,0
手中(1946),手中,notion,0,1,1,0,1,1,0.00826,4,0.264992,0.278237,0
手植(1946),手植,notion,0,1,1,0,1,1,0.009637,4,0.265506,0.27915,0
手段(1946),手段,notion,0,1,1,0,1,1,0.017626,4,0.281496,0.305894,0
手法(1946),手法,notion,0,1,1,0,1,1,0.013634,4,0.273332,0.292631,0
手裏(1946),手裏,notion,0,1,1,0,1,1,0.017626,4,0.281496,0.305894,0
手里(1946),手里,notion,0,1,1,0,1,1,0.018893,4,0.282798,0.307938,0
手黑(1946),手黑,notion,0,1,1,0,1,1,0.013378,4,0.272039,0.290456,0
才能(1946),才能,notion,0,2,2,0,2,2,0.009698,4,0.262356,0.273569,160.636246
扑灭(1946),扑灭,notion,0,1,1,0,1,1,0.004564,4,0.256755,0.263104,0
打仗(1946),打仗,notion,0,1,1,0,1,1,0.013634,4,0.273332,0.292631,0
打倒(1946),打倒,notion,0,1,1,0,1,1,0.018893,4,0.282798,0.307938,0
打到(1946),打到,notion,0,2,2,0,2,2,0.027153,4,0.296784,0.32884,1981.441549
打发(1946),打发,notion,0,1,1,0,1,1,0.018893,4,0.282798,0.307938,0
打声(1946),打声,notion,0,1,1,0,1,1,0.013378,4,0.272039,0.290456,0
打大(1946),打大,notion,0,1,1,0,1,1,0.00826,4,0.264992,0.278237,0
打开(1946),打开,notion,0,4,4,0,5,5,0.04489,4,0.31548,0.353946,4837.780842
打得(1946),打得,notion,0,1,1,0,1,1,0.013378,4,0.272039,0.290456,0
打手(1946),打手,notion,0,1,1,0,1,1,0.013634,4,0.273332,0.292631,0
打打(1946),打打,notion,0,1,1,0,1,1,0.013634,4,0.273332,0.292631,0
打扫(1946),打扫,notion,0,1,1,0,1,1,0.00826,4,0.264992,0.278237,0
打破(1946),打破,notion,0,1,1,0,1,1,0.018893,4,0.282798,0.307938,0
打算(1946),打算,notion,0,1,1,0,1,1,0.013378,4,0.272039,0.290456,0
托管(1946),托管,notion,0,2,2,0,4,4,0.020262,4,0.282243,0.30714,1027.722249
扣回去(1946),扣回去,notion,0,1,1,0,1,1,0.00826,4,0.264992,0.278237,0
执政者(1946),执政者,notion,0,1,1,0,1,1,0.005304,4,0.259537,0.268322,0
执法(1946),执法,notion,0,1,1,0,1,1,0.013378,4,0.272039,0.290456,0
执行(1946),执行,notion,0,1,1,0,1,1,0.013378,4,0.272039,0.290456,0
扩军(1946),扩军,notion,0,1,1,0,1,1,0.013103,4,0.272684,0.291543,0
扩大(1946),扩大,notion,0,5,5,0,7,7,0.037193,4,0.299411,0.332754,4777.343821
扩张政策(1946),扩张政策,notion,0,1,1,0,1,1,0.013103,4,0.272684,0.291543,0
扫荡(1946),扫荡,notion,0,3,3,0,3,3,0.040786,4,0.31831,0.357395,5617.041193
扭转(1946),扭转,notion,0,1,1,0,1,1,0.004479,4,0.256686,0.262973,0
扮演(1946),扮演,notion,0,1,1,0,1,1,0.013378,4,0.272039,0.290456,0
扯淡(1946),扯淡,notion,0,1,1,0,1,1,0.004564,4,0.256755,0.263104,0
扯谈(1946),扯谈,notion,0,1,1,0,1,1,0.018893,4,0.282798,0.307938,0
扰人清梦(1946),扰人清梦,notion,0,1,1,0,1,1,0.017626,4,0.281496,0.305894,0
批评(1946),批评,notion,0,6,6,0,8,8,0.048012,4,0.320154,0.359874,12233.68165
扼杀(1946),扼杀,notion,0,1,1,0,1,1,0.013378,4,0.272039,0.290456,0
找事(1946),找事,notion,0,1,1,0,1,1,0.005304,4,0.259537,0.268322,0
承德(1946),承德,notion,0,1,1,0,1,1,0.013634,4,0.273332,0.292631,0
承继(1946),承继,notion,0,1,1,0,1,1,0.013103,4,0.272684,0.291543,0
承认(1946),承认,notion,0,1,1,0,1,1,0.013378,4,0.272039,0.290456,0
技俩(1946),技俩,notion,0,1,1,0,1,1,0.013378,4,0.272039,0.290456,0
技术(1946),技术,notion,0,4,4,0,5,5,0.050934,4,0.336258,0.378428,11398.974536
抉择(1946),抉择,notion,0,2,2,0,2,2,0.023456,4,0.28781,0.315707,881.141468
把戏(1946),把戏,notion,0,3,3,0,4,4,0.036764,4,0.307845,0.344045,2893.036981
把握(1946),把握,notion,0,2,2,0,5,5,0.008912,4,0.264602,0.277613,868.763301
抑是(1946),抑是,notion,0,1,1,0,1,1,0.013634,4,0.273332,0.292631,0
投射(1946),投射,notion,0,1,1,0,1,1,0.004564,4,0.256755,0.263104,0
投笔从戎(1946),投笔从戎,notion,0,1,1,0,1,1,0.007159,4,0.261235,0.271453,0
投降(1946),投降,notion,0,4,4,0,9,9,0.051266,4,0.333256,0.37508,8533.450998
抗争(1946),抗争,notion,0,1,1,0,1,1,0.004577,4,0.257676,0.264843,0
抗战时期(1946),抗战时期,notion,0,2,2,0,2,2,0.031004,4,0.302277,0.336493,1833.728143
抗日(1946),抗日,notion,0,3,3,0,3,3,0.034023,4,0.304841,0.340045,2961.289954
抗着(1946),抗着,notion,0,1,1,0,1,1,0.013634,4,0.273332,0.292631,0
折衝(1946),折衝,notion,0,1,1,0,1,1,0.017626,4,0.281496,0.305894,0
抚慰(1946),抚慰,notion,0,1,1,0,1,1,0.013634,4,0.273332,0.292631,0
抛锚(1946),抛锚,notion,0,2,2,0,2,2,0.024197,4,0.292198,0.32223,2288.2854
抢救(1946),抢救,notion,0,3,3,0,3,3,0.041908,4,0.31393,0.351916,3405.961451
抢水(1946),抢水,notion,0,1,1,0,1,1,0.018893,4,0.282798,0.307938,0
护宪(1946),护宪,notion,0,1,1,0,1,1,0.009637,4,0.265506,0.27915,0
报上(1946),报上,notion,0,1,1,0,1,1,0.013634,4,0.273332,0.292631,0
报业(1946),报业,notion,0,1,1,0,1,1,0.017626,4,0.281496,0.305894,0
报导(1946),报导,notion,0,1,1,0,1,1,0.0031,4,0.254504,0.258799,0
报晓(1946),报晓,notion,0,1,1,0,1,1,0.00826,4,0.264992,0.278237,0
报社(1946),报社,notion,0,1,1,0,1,1,0.009637,4,0.265506,0.27915,0
报纸(1946),报纸,notion,0,8,8,0,11,11,0.095153,4,0.416987,0.450687,40255.595409
报馆(1946),报馆,notion,0,1,1,0,1,1,0.005304,4,0.259537,0.268322,0
抱不平(1946),抱不平,notion,0,1,1,0,1,1,0.013634,4,0.273332,0.292631,0
抱住不放(1946),抱住不放,notion,0,1,1,0,1,1,0.013634,4,0.273332,0.292631,0
抱负(1946),抱负,notion,0,1,1,0,1,1,0.009637,4,0.265506,0.27915,0
抵华(1946),抵华,notion,0,1,1,0,1,1,0.009637,4,0.265506,0.27915,0
抽丁(1946),抽丁,notion,0,1,1,0,1,1,0.00826,4,0.264992,0.278237,0
抽壮丁(1946),抽壮丁,notion,0,1,1,0,1,1,0.0031,4,0.254504,0.258799,0
抽税(1946),抽税,notion,0,1,1,0,1,1,0.007159,4,0.261235,0.271453,0
担当(1946),担当,notion,0,1,1,0,1,1,0.005304,4,0.259537,0.268322,0
担忧(1946),担忧,notion,0,1,1,0,1,1,0.013378,4,0.272039,0.290456,0
拉丁美洲(1946),拉丁美洲,notion,0,1,1,0,1,1,0.013103,4,0.272684,0.291543,0
拉得(1946),拉得,notion,0,1,1,0,1,1,0.013378,4,0.272039,0.290456,0
拉托尔(1946),拉托尔,notion,0,1,1,0,1,1,0.013103,4,0.272684,0.291543,0
拒绝(1946),拒绝,notion,0,1,1,0,1,1,0.013378,4,0.272039,0.290456,0
拓荒(1946),拓荒,notion,0,1,1,0,1,1,0.017626,4,0.281496,0.305894,0
拔萃(1946),拔萃,notion,0,1,1,0,7,7,0.017626,4,0.281496,0.305894,0
拖下去(1946),拖下去,notion,0,1,1,0,1,1,0.013634,4,0.273332,0.292631,0
拖人下水(1946),拖人下水,notion,0,1,1,0,1,1,0.018893,4,0.282798,0.307938,0
拖塌(1946),拖塌,notion,0,1,1,0,1,1,0.013378,4,0.272039,0.290456,0
拖延(1946),拖延,notion,0,1,1,0,1,1,0.004237,4,0.256206,0.26206,0
拖拖(1946),拖拖,notion,0,1,1,0,1,1,0.013634,4,0.273332,0.292631,0
拘禁(1946),拘禁,notion,0,1,1,0,1,1,0.013634,4,0.273332,0.292631,0
招会记(1946),招会记,notion,0,1,1,0,1,1,0.005461,4,0.25793,0.265322,0
招供(1946),招供,notion,0,1,1,0,1,1,0.018893,4,0.282798,0.307938,0
招待(1946),招待,notion,0,1,1,0,1,1,0.013634,4,0.273332,0.292631,0
招待会(1946),招待会,notion,0,1,1,0,1,1,0.00826,4,0.264992,0.278237,0
招魂(1946),招魂,notion,0,1,1,0,1,1,0.018893,4,0.282798,0.307938,0
拜然(1946),拜然,notion,0,1,1,0,1,1,0.017626,4,0.281496,0.305894,0
拟议(1946),拟议,notion,0,1,1,0,2,2,0.017626,4,0.281496,0.305894,0
拥护(1946),拥护,notion,0,3,3,0,3,3,0.030872,4,0.299443,0.332652,3216.500619
择生(1946),择生,notion,0,1,1,0,1,1,0.004564,4,0.256755,0.263104,0
拭目(1946),拭目,notion,0,1,1,0,1,1,0.00826,4,0.264992,0.278237,0
拿出(1946),拿出,notion,0,2,2,0,4,4,0.027264,4,0.294896,0.326144,1405.794223
挂绿(1946),挂绿,notion,0,1,1,0,1,1,0.004564,4,0.256755,0.263104,0
指定(1946),指定,notion,0,1,1,0,1,1,0.005461,4,0.25793,0.265322,0
指挥(1946),指挥,notion,0,1,1,0,1,1,0.013103,4,0.272684,0.291543,0
指示(1946),指示,notion,0,1,1,0,1,1,0.013103,4,0.272684,0.291543,0
挑动(1946),挑动,notion,0,1,1,0,1,1,0.017626,4,0.281496,0.305894,0
挑战(1946),挑战,notion,0,1,1,0,1,1,0.013378,4,0.272039,0.290456,0
挑拨(1946),挑拨,notion,0,1,1,0,1,1,0.003608,4,0.255568,0.260842,0
挑衅(1946),挑衅,notion,0,1,1,0,1,1,0.018893,4,0.282798,0.307938,0
挣扎(1946),挣扎,notion,0,2,2,0,2,2,0.011638,4,0.266812,0.281527,466.757155
振黄哥(1946),振黄哥,notion,0,1,1,0,1,1,0.018893,4,0.282798,0.307938,0
挺经(1946),挺经,notion,0,1,1,0,1,1,0.017626,4,0.281496,0.305894,0
挽出(1946),挽出,notion,0,1,1,0,1,1,0.018893,4,0.282798,0.307938,0
挽救(1946),挽救,notion,0,3,3,0,3,3,0.036559,4,0.309069,0.345654,3546.560838
挽歌(1946),挽歌,notion,0,1,1,0,1,1,0.018893,4,0.282798,0.307938,0
捐税(1946),捐税,notion,0,1,1,0,1,1,0.018893,4,0.282798,0.307938,0
损害(1946),损害,notion,0,1,1,0,1,1,0.013103,4,0.272684,0.291543,0
换汤不换药(1946),换汤不换药,notion,0,1,1,0,1,1,0.005461,4,0.25793,0.265322,0
捣毁(1946),捣毁,notion,0,1,1,0,1,1,0.004237,4,0.256206,0.26206,0
捷克(1946),捷克,notion,0,1,1,0,4,4,0.013103,4,0.272684,0.291543,0
掀起(1946),掀起,notion,0,2,2,0,2,2,0.032527,4,0.303393,0.338015,1614.891208
掉包(1946),掉包,notion,0,1,1,0,1,1,0.003608,4,0.255568,0.260842,0
掌握(1946),掌握,notion,0,1,1,0,1,1,0.013378,4,0.272039,0.290456,0
排场(1946),排场,notion,0,1,1,0,1,1,0.004577,4,0.257676,0.264843,0
排演(1946),排演,notion,0,1,1,0,1,1,0.005461,4,0.25793,0.265322,0
掠影(1946),掠影,notion,0,1,1,0,1,1,0.007159,4,0.261235,0.271453,0
探索(1946),探索,notion,0,1,1,0,1,1,0.005304,4,0.259537,0.268322,0
探讨(1946),探讨,notion,0,2,2,0,2,2,0.036519,4,0.313896,0.3518,2490.161613
探险(1946),探险,notion,0,1,1,0,1,1,0.013103,4,0.272684,0.291543,0
接到(1946),接到,notion,0,1,1,0,1,1,0.017626,4,0.281496,0.305894,0
接受(1946),接受,notion,0,1,1,0,1,1,0.009637,4,0.265506,0.27915,0
接受批评(1946),接受批评,notion,0,1,1,0,1,1,0.017626,4,0.281496,0.305894,0
接收(1946),接收,notion,0,2,2,0,2,2,0.032271,4,0.301168,0.334971,1271.496707
接收者(1946),接收者,notion,0,1,1,0,1,1,0.013634,4,0.273332,0.292631,0
接着(1946),接着,notion,0,2,2,0,2,2,0.021363,4,0.287407,0.315098,2175.293762
接近(1946),接近,notion,0,1,1,0,1,1,0.00826,4,0.264992,0.278237,0
控告(1946),控告,notion,0,2,2,0,2,2,0.011396,4,0.26654,0.281049,423.548007
控拆(1946),控拆,notion,0,1,1,0,1,1,0.005461,4,0.25793,0.265322,0
推展(1946),推展,notion,0,1,1,0,1,1,0.005304,4,0.259537,0.268322,0
推广(1946),推广,notion,0,1,1,0,1,1,0.005304,4,0.259537,0.268322,0
推翻(1946),推翻,notion,0,1,1,0,1,1,0.018893,4,0.282798,0.307938,0
推进(1946),推进,notion,0,1,1,0,1,1,0.013378,4,0.272039,0.290456,0
掮客(1946),掮客,notion,0,1,1,0,1,1,0.009637,4,0.265506,0.27915,0
掺杂(1946),掺杂,notion,0,1,1,0,1,1,0.013378,4,0.272039,0.290456,0
提倡(1946),提倡,notion,0,2,2,0,2,2,0.024785,4,0.291398,0.321056,1410.74284
提出(1946),提出,notion,0,4,4,0,14,14,0.046061,4,0.328683,0.369861,9230.152642
提审(1946),提审,notion,0,1,1,0,1,1,0.018893,4,0.282798,0.307938,0
提府(1946),提府,notion,0,1,1,0,1,1,0.005461,4,0.25793,0.265322,0
提得起(1946),提得起,notion,0,1,1,0,1,1,0.004577,4,0.257676,0.264843,0
提网(1946),提网,notion,0,1,1,0,1,1,0.013378,4,0.272039,0.290456,0
提要(1946),提要,notion,0,2,2,0,2,2,0.012739,4,0.270758,0.288354,795.473237
提议(1946),提议,notion,0,3,3,0,3,3,0.032473,4,0.297614,0.330086,2243.405035
提起(1946),提起,notion,0,1,1,0,1,1,0.017626,4,0.281496,0.305894,0
提醒(1946),提醒,notion,0,1,1,0,1,1,0.004564,4,0.256755,0.263104,0
提高(1946),提高,notion,0,3,3,0,5,5,0.039429,4,0.309669,0.346437,3086.693105
插曲(1946),插曲,notion,0,1,1,0,1,1,0.013378,4,0.272039,0.290456,0
握手(1946),握手,notion,0,1,1,0,1,1,0.005461,4,0.25793,0.265322,0
揭发(1946),揭发,notion,0,2,2,0,3,3,0.027153,4,0.296784,0.32884,1981.441549
揭幕(1946),揭幕,notion,0,1,1,0,1,1,0.003608,4,0.255568,0.260842,0
揭开(1946),揭开,notion,0,1,1,0,1,1,0.017626,4,0.281496,0.305894,0
揭穿(1946),揭穿,notion,0,3,3,0,4,4,0.027099,4,0.292079,0.322128,3015.150396
揭露(1946),揭露,notion,0,1,1,0,1,1,0.007159,4,0.261235,0.271453,0
援助(1946),援助,notion,0,3,3,0,3,3,0.040114,4,0.313896,0.351873,4492.668279
援华(1946),援华,notion,0,2,2,0,2,2,0.016986,4,0.276434,0.297834,735.895741
援救(1946),援救,notion,0,2,2,0,2,2,0.027153,4,0.296784,0.32884,1981.441549
搏斗(1946),搏斗,notion,0,1,1,0,1,1,0.005461,4,0.25793,0.265322,0
搔首(1946),搔首,notion,0,1,1,0,1,1,0.009637,4,0.265506,0.27915,0
搜查(1946),搜查,notion,0,3,3,0,3,3,0.028833,4,0.293631,0.32439,1900.302815
搜集(1946),搜集,notion,0,1,1,0,1,1,0.004564,4,0.256755,0.263104,0
搬兵(1946),搬兵,notion,0,1,1,0,1,1,0.001496,4,0.252204,0.25432,0
摇篮(1946),摇篮,notion,0,1,1,0,1,1,0.017626,4,0.281496,0.305894,0
摈弃(1946),摈弃,notion,0,1,1,0,1,1,0.00826,4,0.264992,0.278237,0
摊牌(1946),摊牌,notion,0,1,1,0,1,1,0.009637,4,0.265506,0.27915,0
摊贩(1946),摊贩,notion,0,4,4,0,4,4,0.049259,4,0.334731,0.376732,10142.152859
摧残(1946),摧残,notion,0,1,1,0,1,1,0.018893,4,0.282798,0.307938,0
摧毁(1946),摧毁,notion,0,1,1,0,1,1,0.018893,4,0.282798,0.307938,0
摩登(1946),摩登,notion,0,1,1,0,1,1,0.013634,4,0.273332,0.292631,0
撒谎(1946),撒谎,notion,0,1,1,0,1,1,0.013103,4,0.272684,0.291543,0
撤兵(1946),撤兵,notion,0,1,1,0,1,1,0.004564,4,0.256755,0.263104,0
撤军(1946),撤军,notion,0,2,2,0,2,2,0.030729,4,0.302946,0.337407,2092.27198
撤离(1946),撤离,notion,0,2,2,0,2,2,0.012739,4,0.270758,0.288354,795.473237
撤退(1946),撤退,notion,0,4,4,0,6,6,0.054275,4,0.337046,0.379298,8682.063344
撤销(1946),撤销,notion,0,1,1,0,1,1,0.004479,4,0.256686,0.262973,0
操刀(1946),操刀,notion,0,1,1,0,1,1,0.009637,4,0.265506,0.27915,0
操纵(1946),操纵,notion,0,2,2,0,2,2,0.024354,4,0.288822,0.317229,783.391635
支持(1946),支持,notion,0,1,1,0,1,1,0.017626,4,0.281496,0.305894,0
支持者(1946),支持者,notion,0,1,1,0,1,1,0.003608,4,0.255568,0.260842,0
支部(1946),支部,notion,0,1,1,0,1,1,0.005461,4,0.25793,0.265322,0
支配(1946),支配,notion,0,1,1,0,1,1,0.017626,4,0.281496,0.305894,0
收住(1946),收住,notion,0,1,1,0,1,1,0.013634,4,0.273332,0.292631,0
收到(1946),收到,notion,0,1,1,0,1,1,0.004577,4,0.257676,0.264843,0
收十起(1946),收十起,notion,0,1,1,0,1,1,0.005304,4,0.259537,0.268322,0
收复(1946),收复,notion,0,1,1,0,1,1,0.017626,4,0.281496,0.305894,0
收复区(1946),收复区,notion,0,2,2,0,3,3,0.009698,4,0.262356,0.273569,160.636246
收拾(1946),收拾,notion,0,1,1,0,1,1,0.017626,4,0.281496,0.305894,0
收获(1946),收获,notion,0,2,2,0,2,2,0.018564,4,0.2792,0.302313,744.038498
改变(1946),改变,notion,0,5,5,0,6,6,0.064312,4,0.355601,0.398722,16754.838839
改善(1946),改善,notion,0,3,3,0,3,3,0.035837,4,0.310975,0.348133,5214.773728
改善生活(1946),改善生活,notion,0,1,1,0,1,1,0.013378,4,0.272039,0.290456,0
改期(1946),改期,notion,0,1,1,0,1,1,0.009637,4,0.265506,0.27915,0
改良(1946),改良,notion,0,1,1,0,1,1,0.013634,4,0.273332,0.292631,0
改进(1946),改进,notion,0,1,1,0,1,1,0.005304,4,0.259537,0.268322,0
改选(1946),改选,notion,0,2,2,0,2,2,0.031004,4,0.302277,0.336493,1833.728143
改革(1946),改革,notion,0,6,6,0,7,7,0.056645,4,0.335473,0.377703,12633.641133
攻入(1946),攻入,notion,0,1,1,0,1,1,0.013103,4,0.272684,0.291543,0
攻击(1946),攻击,notion,0,1,1,0,3,3,0.013103,4,0.272684,0.291543,0
攻势(1946),攻势,notion,0,3,3,0,3,3,0.026348,4,0.290368,0.319606,2651.613741
放下(1946),放下,notion,0,1,1,0,2,2,0.013634,4,0.273332,0.292631,0
放弃(1946),放弃,notion,0,2,2,0,2,2,0.013245,4,0.269995,0.28705,596.681008
放心(1946),放心,notion,0,1,1,0,1,1,0.00826,4,0.264992,0.278237,0
放手(1946),放手,notion,0,1,1,0,1,1,0.013378,4,0.272039,0.290456,0
放松(1946),放松,notion,0,1,1,0,1,1,0.004564,4,0.256755,0.263104,0
放歌(1946),放歌,notion,0,1,1,0,1,1,0.013378,4,0.272039,0.290456,0
放谈(1946),放谈,notion,0,1,1,0,1,1,0.013103,4,0.272684,0.291543,0
放长(1946),放长,notion,0,1,1,0,1,1,0.013378,4,0.272039,0.290456,0
政与(1946),政与,notion,0,1,1,0,1,1,0.013378,4,0.272039,0.290456,0
政争(1946),政争,notion,0,1,1,0,1,1,0.013634,4,0.273332,0.292631,0
政事(1946),政事,notion,0,1,1,0,1,1,0.013634,4,0.273332,0.292631,0
政党(1946),政党,notion,0,4,4,0,5,5,0.059535,4,0.346806,0.389734,9135.64543
政学系(1946),政学系,notion,0,1,1,0,1,1,0.018893,4,0.282798,0.307938,0
政情(1946),政情,notion,0,1,1,0,1,1,0.013634,4,0.273332,0.292631,0
政权(1946),政权,notion,0,2,2,0,3,3,0.023456,4,0.28781,0.315707,881.141468
政权机关(1946),政权机关,notion,0,1,1,0,1,1,0.013103,4,0.272684,0.291543,0
政治势力(1946),政治势力,notion,0,1,1,0,1,1,0.009637,4,0.265506,0.27915,0
政治协商(1946),政治协商,notion,0,2,2,0,2,2,0.03126,4,0.304035,0.338885,2199.499867
政治家(1946),政治家,notion,0,3,3,0,3,3,0.042164,4,0.316662,0.355352,4082.320747
政治局面(1946),政治局面,notion,0,1,1,0,1,1,0.009637,4,0.265506,0.27915,0
政治犯(1946),政治犯,notion,0,3,3,0,4,4,0.036764,4,0.307845,0.344045,2893.036981
政治立场(1946),政治立场,notion,0,1,1,0,1,1,0.013378,4,0.272039,0.290456,0
政治路线(1946),政治路线,notion,0,2,2,0,2,2,0.02853,4,0.295746,0.327361,1236.887723
政治阴谋(1946),政治阴谋,notion,0,1,1,0,1,1,0.017626,4,0.281496,0.305894,0
政潮(1946),政潮,notion,0,4,4,0,4,4,0.05926,4,0.34976,0.392778,10218.766352
政略(1946),政略,notion,0,1,1,0,1,1,0.017626,4,0.281496,0.305894,0
政绩(1946),政绩,notion,0,1,1,0,1,1,0.00826,4,0.264992,0.278237,0
政论(1946),政论,notion,0,1,1,0,1,1,0.013634,4,0.273332,0.292631,0
故事(1946),故事,notion,0,7,7,0,11,11,0.081738,4,0.388787,0.428872,26907.292405
故居(1946),故居,notion,0,1,1,0,2,2,0.013634,4,0.273332,0.292631,0
故意(1946),故意,notion,0,1,1,0,1,1,0.004237,4,0.256206,0.26206,0
效力(1946),效力,notion,0,1,1,0,1,1,0.009637,4,0.265506,0.27915,0
敌产(1946),敌产,notion,0,1,1,0,1,1,0.013103,4,0.272684,0.291543,0
敌人(1946),敌人,notion,0,2,2,0,2,2,0.031004,4,0.302277,0.336493,1833.728143
敌伪(1946),敌伪,notion,0,2,2,0,2,2,0.023088,4,0.287867,0.315794,912.175655
敌后工作(1946),敌后工作,notion,0,1,1,0,1,1,0.005304,4,0.259537,0.268322,0
敌国(1946),敌国,notion,0,1,1,0,1,1,0.013103,4,0.272684,0.291543,0
敎育(1946),敎育,notion,0,2,2,0,4,4,0.022204,4,0.287896,0.315838,1406.192172
救救(1946),救救,notion,0,1,1,0,1,1,0.017626,4,0.281496,0.305894,0
救火(1946),救火,notion,0,2,2,0,3,3,0.023271,4,0.287177,0.31475,1230.541816
救灾(1946),救灾,notion,0,1,1,0,1,1,0.013634,4,0.273332,0.292631,0
救荒(1946),救荒,notion,0,1,1,0,1,1,0.017626,4,0.281496,0.305894,0
教即(1946),教即,notion,0,1,1,0,1,1,0.005304,4,0.259537,0.268322,0
教学(1946),教学,notion,0,2,2,0,3,3,0.031004,4,0.302277,0.336493,1833.728143
教学相长(1946),教学相长,notion,0,1,1,0,1,1,0.005304,4,0.259537,0.268322,0
教师(1946),教师,notion,0,1,1,0,1,1,0.007159,4,0.261235,0.271453,0
教师节(1946),教师节,notion,0,1,1,0,1,1,0.017626,4,0.281496,0.305894,0
教徒(1946),教徒,notion,0,1,1,0,1,1,0.004577,4,0.257676,0.264843,0
教授(1946),教授,notion,0,7,7,0,12,12,0.082237,4,0.381562,0.422784,23444.103318
教派(1946),教派,notion,0,1,1,0,1,1,0.018893,4,0.282798,0.307938,0
教科书(1946),教科书,notion,0,1,1,0,1,1,0.013378,4,0.272039,0.290456,0
教练(1946),教练,notion,0,1,1,0,1,1,0.018893,4,0.282798,0.307938,0
教职员(1946),教职员,notion,0,1,1,0,1,1,0.013378,4,0.272039,0.290456,0
教育家(1946),教育家,notion,0,1,1,0,1,1,0.004564,4,0.256755,0.263104,0
教育方针(1946),教育方针,notion,0,1,1,0,1,1,0.017626,4,0.281496,0.305894,0
教育界(1946),教育界,notion,0,1,1,0,1,1,0.018893,4,0.282798,0.307938,0
教训(1946),教训,notion,0,2,2,0,2,2,0.02274,4,0.286006,0.312967,1109.932808
散会(1946),散会,notion,0,1,1,0,1,1,0.018893,4,0.282798,0.307938,0
散发传单(1946),散发传单,notion,0,1,1,0,1,1,0.013103,4,0.272684,0.291543,0
散工(1946),散工,notion,0,1,1,0,1,1,0.00826,4,0.264992,0.278237,0
散文(1946),散文,notion,0,1,1,0,1,1,0.017626,4,0.281496,0.305894,0
散稿(1946),散稿,notion,0,1,1,0,1,1,0.004564,4,0.256755,0.263104,0
敬书(1946),敬书,notion,0,1,1,0,1,1,0.013378,4,0.272039,0.290456,0
敬告(1946),敬告,notion,0,2,2,0,2,2,0.031004,4,0.302277,0.336493,1833.728143
敬啓者(1946),敬啓者,notion,0,1,1,0,1,1,0.017626,4,0.281496,0.305894,0
敬悼(1946),敬悼,notion,0,2,2,0,3,3,0.032271,4,0.301168,0.334971,1271.496707
数目字(1946),数目字,notion,0,1,1,0,1,1,0.004564,4,0.256755,0.263104,0
敲击(1946),敲击,notion,0,1,1,0,1,1,0.009637,4,0.265506,0.27915,0
整军(1946),整军,notion,0,5,5,0,5,5,0.043357,4,0.312973,0.350844,7600.083199
整理(1946),整理,notion,0,2,2,0,3,3,0.023088,4,0.287867,0.315794,912.175655
整编(1946),整编,notion,0,2,2,0,2,2,0.016986,4,0.276434,0.297834,735.895741
文化区(1946),文化区,notion,0,1,1,0,2,2,0.017626,4,0.281496,0.305894,0
文化圈(1946),文化圈,notion,0,1,1,0,5,5,0.017626,4,0.281496,0.305894,0
文化城(1946),文化城,notion,0,1,1,0,2,2,0.018893,4,0.282798,0.307938,0
文化界(1946),文化界,notion,0,2,2,0,2,2,0.021864,4,0.286576,0.313837,872.776367
文告(1946),文告,notion,0,4,4,0,6,6,0.053063,4,0.330573,0.372036,6879.26762
文坛(1946),文坛,notion,0,1,1,0,1,1,0.013103,4,0.272684,0.291543,0
文士(1946),文士,notion,0,1,1,0,1,1,0.017626,4,0.281496,0.305894,0
文学创作(1946),文学创作,notion,0,2,2,0,2,2,0.01768,4,0.279308,0.302487,1220.085569
文学史(1946),文学史,notion,0,1,1,0,1,1,0.013103,4,0.272684,0.291543,0
文学运动(1946),文学运动,notion,0,1,1,0,1,1,0.004577,4,0.257676,0.264843,0
文学遗产(1946),文学遗产,notion,0,1,1,0,1,1,0.013103,4,0.272684,0.291543,0
文教(1946),文教,notion,0,1,1,0,1,1,0.017626,4,0.281496,0.305894,0
文明(1946),文明,notion,0,1,1,0,1,1,0.018893,4,0.282798,0.307938,0
文汇报(1946),文汇报,notion,0,2,2,0,2,2,0.032527,4,0.303393,0.338015,1614.891208
文艺创作(1946),文艺创作,notion,0,1,1,0,1,1,0.013103,4,0.272684,0.291543,0
文艺工作者(1946),文艺工作者,notion,0,1,1,0,1,1,0.003608,4,0.255568,0.260842,0
文讯(1946),文讯,notion,0,1,1,0,2,2,0.017626,4,0.281496,0.305894,0
文豪(1946),文豪,notion,0,1,1,0,1,1,0.018893,4,0.282798,0.307938,0
文选集(1946),文选集,notion,0,1,1,0,1,1,0.013103,4,0.272684,0.291543,0
斐斐怨(1946),斐斐怨,notion,0,1,1,0,1,1,0.018893,4,0.282798,0.307938,0
斗士(1946),斗士,notion,0,1,1,0,1,1,0.005304,4,0.259537,0.268322,0
断片(1946),断片,notion,0,2,2,0,2,2,0.022204,4,0.287896,0.315838,1406.192172
斯大林(1946),斯大林,notion,0,2,2,0,2,2,0.02853,4,0.295746,0.327361,1236.887723
斯拉夫(1946),斯拉夫,notion,0,1,1,0,1,1,0.017626,4,0.281496,0.305894,0
斯特(1946),斯特,notion,0,1,1,0,1,1,0.009637,4,0.265506,0.27915,0
斯特林(1946),斯特林,notion,0,1,1,0,1,1,0.013103,4,0.272684,0.291543,0
斯莫尔(1946),斯莫尔,notion,0,1,1,0,1,1,0.013103,4,0.272684,0.291543,0
新中国(1946),新中国,notion,0,3,3,0,4,4,0.034612,4,0.306859,0.342741,3783.649272
新人(1946),新人,notion,0,1,1,0,1,1,0.017626,4,0.281496,0.305894,0
新人生观(1946),新人生观,notion,0,1,1,0,1,1,0.00826,4,0.264992,0.278237,0
新会员(1946),新会员,notion,0,1,1,0,1,1,0.013103,4,0.272684,0.291543,0
新兴(1946),新兴,notion,0,1,1,0,1,1,0.017626,4,0.281496,0.305894,0
新兴事业(1946),新兴事业,notion,0,1,1,0,1,1,0.018893,4,0.282798,0.307938,0
新军(1946),新军,notion,0,2,2,0,2,2,0.008405,4,0.263655,0.275918,766.419601
新动向(1946),新动向,notion,0,1,1,0,1,1,0.017626,4,0.281496,0.305894,0
新华日报(1946),新华日报,notion,0,1,1,0,1,1,0.004237,4,0.256206,0.26206,0
新名词(1946),新名词,notion,0,1,1,0,1,1,0.018893,4,0.282798,0.307938,0
新四军(1946),新四军,notion,0,2,2,0,2,2,0.021894,4,0.287839,0.315751,2020.708436
新型(1946),新型,notion,0,2,2,0,2,2,0.026481,4,0.292853,0.323187,1408.34579
新宪(1946),新宪,notion,0,1,1,0,1,1,0.017626,4,0.281496,0.305894,0
新屋(1946),新屋,notion,0,1,1,0,1,1,0.013103,4,0.272684,0.291543,0
新年(1946),新年,notion,0,3,3,0,3,3,0.034105,4,0.305359,0.34074,3178.005801
新形势下(1946),新形势下,notion,0,1,1,0,1,1,0.005461,4,0.25793,0.265322,0
新战(1946),新战,notion,0,1,1,0,1,1,0.013378,4,0.272039,0.290456,0
新政(1946),新政,notion,0,1,1,0,1,1,0.018893,4,0.282798,0.307938,0
新旧(1946),新旧,notion,0,1,1,0,1,1,0.018893,4,0.282798,0.307938,0
新春(1946),新春,notion,0,2,2,0,3,3,0.016734,4,0.276967,0.298704,731.151147
新景(1946),新景,notion,0,1,1,0,1,1,0.017626,4,0.281496,0.305894,0
新案(1946),新案,notion,0,1,1,0,1,1,0.0031,4,0.254504,0.258799,0
新欢(1946),新欢,notion,0,1,1,0,1,1,0.013634,4,0.273332,0.292631,0
新版(1946),新版,notion,0,1,1,0,1,1,0.004479,4,0.256686,0.262973,0
新献(1946),新献,notion,0,1,1,0,1,1,0.017626,4,0.281496,0.305894,0
新生(1946),新生,notion,0,6,6,0,8,8,0.081938,4,0.393632,0.432756,27473.164335
新疆(1946),新疆,notion,0,5,5,0,7,7,0.055045,4,0.334575,0.376631,11509.061024
新的(1946),新的,notion,0,1,1,0,1,1,0.004479,4,0.256686,0.262973,0
新着(1946),新着,notion,0,1,1,0,1,1,0.009637,4,0.265506,0.27915,0
新纪元(1946),新纪元,notion,0,1,1,0,1,1,0.018893,4,0.282798,0.307938,0
新花样(1946),新花样,notion,0,2,2,0,2,2,0.024354,4,0.288822,0.317229,783.391635
新装(1946),新装,notion,0,1,1,0,1,1,0.013634,4,0.273332,0.292631,0
新解(1946),新解,notion,0,2,2,0,2,2,0.026052,4,0.291576,0.321317,1054.556401
新谱(1946),新谱,notion,0,1,1,0,1,1,0.013103,4,0.272684,0.291543,0
新貌(1946),新貌,notion,0,1,1,0,1,1,0.005461,4,0.25793,0.265322,0
新途径(1946),新途径,notion,0,1,1,0,1,1,0.005304,4,0.259537,0.268322,0
新闻(1946),新闻,notion,0,8,8,0,9,9,0.08944,4,0.409794,0.445425,43840.482527
新闻事业(1946),新闻事业,notion,0,1,1,0,1,1,0.017626,4,0.281496,0.305894,0
新闻报导(1946),新闻报导,notion,0,1,1,0,1,1,0.009637,4,0.265506,0.27915,0
新闻界(1946),新闻界,notion,0,2,2,0,2,2,0.036519,4,0.313896,0.3518,2490.161613
新闻记者(1946),新闻记者,notion,0,1,1,0,1,1,0.018893,4,0.282798,0.307938,0
新页(1946),新页,notion,0,1,1,0,1,1,0.017626,4,0.281496,0.305894,0
方兴未艾(1946),方兴未艾,notion,0,1,1,0,1,1,0.00826,4,0.264992,0.278237,0
方向(1946),方向,notion,0,4,4,0,4,4,0.022488,4,0.282215,0.307242,4325.752882
方式(1946),方式,notion,0,2,2,0,3,3,0.014214,4,0.272194,0.29079,872.497436
方生(1946),方生,notion,0,1,1,0,1,1,0.018893,4,0.282798,0.307938,0
方针(1946),方针,notion,0,2,2,0,2,2,0.024785,4,0.291398,0.321056,1410.74284
施政纲领(1946),施政纲领,notion,0,2,2,0,2,2,0.021234,4,0.286205,0.313272,1214.025388
施行(1946),施行,notion,0,1,1,0,1,1,0.017626,4,0.281496,0.305894,0
旁听(1946),旁听,notion,0,2,2,0,2,2,0.018938,4,0.282437,0.307445,1861.68946
旁听者(1946),旁听者,notion,0,1,1,0,1,1,0.0031,4,0.254504,0.258799,0
旅印(1946),旅印,notion,0,1,1,0,1,1,0.004564,4,0.256755,0.263104,0
旅美(1946),旅美,notion,0,1,1,0,1,1,0.013378,4,0.272039,0.290456,0
旗子(1946),旗子,notion,0,1,1,0,1,1,0.005461,4,0.25793,0.265322,0
旗帜(1946),旗帜,notion,0,1,1,0,1,1,0.00826,4,0.264992,0.278237,0
无中(1946),无中,notion,0,1,1,0,1,1,0.009637,4,0.265506,0.27915,0
无事(1946),无事,notion,0,1,1,0,1,1,0.018893,4,0.282798,0.307938,0
无可奈何(1946),无可奈何,notion,0,2,2,0,2,2,0.022501,4,0.28712,0.314663,997.953629
无名(1946),无名,notion,0,1,1,0,1,1,0.013378,4,0.272039,0.290456,0
无名肿毒(1946),无名肿毒,notion,0,1,1,0,1,1,0.013378,4,0.272039,0.290456,0
无告(1946),无告,notion,0,1,1,0,1,1,0.017626,4,0.281496,0.305894,0
无家(1946),无家,notion,0,1,1,0,1,1,0.013103,4,0.272684,0.291543,0
无尽(1946),无尽,notion,0,1,1,0,1,1,0.00826,4,0.264992,0.278237,0
无敌(1946),无敌,notion,0,1,1,0,1,1,0.005304,4,0.259537,0.268322,0
无条件(1946),无条件,notion,0,1,1,0,1,1,0.018893,4,0.282798,0.307938,0
无法无天(1946),无法无天,notion,0,2,2,0,3,3,0.032271,4,0.301168,0.334971,1271.496707
无涉(1946),无涉,notion,0,1,1,0,1,1,0.018893,4,0.282798,0.307938,0
无用(1946),无用,notion,0,1,1,0,1,1,0.018893,4,0.282798,0.307938,0
无穹(1946),无穹,notion,0,1,1,0,1,1,0.005461,4,0.25793,0.265322,0
无罪(1946),无罪,notion,0,1,1,0,1,1,0.013634,4,0.273332,0.292631,0
无耻(1946),无耻,notion,0,3,3,0,3,3,0.011195,4,0.26397,0.276555,594.89749
无聊(1946),无聊,notion,0,1,1,0,1,1,0.017626,4,0.281496,0.305894,0
无能(1946),无能,notion,0,2,2,0,2,2,0.02347,4,0.289958,0.318925,1721.315005
无花果(1946),无花果,notion,0,1,1,0,1,1,0.003608,4,0.255568,0.260842,0
无话可说(1946),无话可说,notion,0,1,1,0,1,1,0.018893,4,0.282798,0.307938,0
无锡(1946),无锡,notion,0,3,3,0,3,3,0.03417,4,0.301011,0.334826,2938.323304
无闲田(1946),无闲田,notion,0,1,1,0,1,1,0.018893,4,0.282798,0.307938,0
无题(1946),无题,notion,0,1,1,0,2,2,0.013634,4,0.273332,0.292631,0
既要(1946),既要,notion,0,1,1,0,1,1,0.00826,4,0.264992,0.278237,0
日侨(1946),日侨,notion,0,1,1,0,1,1,0.004577,4,0.257676,0.264843,0
日刊(1946),日刊,notion,0,1,1,0,1,1,0.001496,4,0.252204,0.25432,0
日子(1946),日子,notion,0,3,3,0,3,3,0.025029,4,0.287579,0.315432,2067.232814
日寇(1946),日寇,notion,0,1,1,0,2,2,0.017626,4,0.281496,0.305894,0
日报(1946),日报,notion,0,1,1,0,1,1,0.017626,4,0.281496,0.305894,0
日暮途穷(1946),日暮途穷,notion,0,1,1,0,1,1,0.013378,4,0.272039,0.290456,0
日烈(1946),日烈,notion,0,1,1,0,1,1,0.004577,4,0.257676,0.264843,0
日益(1946),日益,notion,0,1,1,0,1,1,0.013103,4,0.272684,0.291543,0
日耳曼(1946),日耳曼,notion,0,1,1,0,1,1,0.013103,4,0.272684,0.291543,0
日至(1946),日至,notion,0,1,1,0,1,1,0.013103,4,0.272684,0.291543,0
日警(1946),日警,notion,0,1,1,0,1,1,0.018893,4,0.282798,0.307938,0
旧戏(1946),旧戏,notion,0,1,1,0,1,1,0.007159,4,0.261235,0.271453,0
旧歌(1946),旧歌,notion,0,1,1,0,1,1,0.013103,4,0.272684,0.291543,0
旧途(1946),旧途,notion,0,1,1,0,1,1,0.017626,4,0.281496,0.305894,0
旧金山(1946),旧金山,notion,0,1,1,0,1,1,0.004479,4,0.256686,0.262973,0
早已(1946),早已,notion,0,1,1,0,1,1,0.013634,4,0.273332,0.292631,0
早晨(1946),早晨,notion,0,1,1,0,1,1,0.007159,4,0.261235,0.271453,0
时中(1946),时中,notion,0,1,1,0,1,1,0.017626,4,0.281496,0.305894,0
时候(1946),时候,notion,0,5,5,0,6,6,0.063271,4,0.352116,0.395243,15396.851261
时期(1946),时期,notion,0,4,4,0,5,5,0.045219,4,0.321766,0.361686,7573.559243
时节(1946),时节,notion,0,1,1,0,1,1,0.018893,4,0.282798,0.307938,0
时装(1946),时装,notion,0,1,1,0,1,1,0.013634,4,0.273332,0.292631,0
时间(1946),时间,notion,0,2,2,0,2,2,0.018211,4,0.280617,0.304575,1609.081689
明亮(1946),明亮,notion,0,1,1,0,1,1,0.005461,4,0.25793,0.265322,0
明暗(1946),明暗,notion,0,1,1,0,1,1,0.013378,4,0.272039,0.290456,0
易手(1946),易手,notion,0,1,1,0,1,1,0.013103,4,0.272684,0.291543,0
星五(1946),星五,notion,0,1,1,0,1,1,0.009637,4,0.265506,0.27915,0
星海(1946),星海,notion,0,1,1,0,1,1,0.013634,4,0.273332,0.292631,0
春到(1946),春到,notion,0,1,1,0,1,1,0.018893,4,0.282798,0.307938,0
春天(1946),春天,notion,0,2,2,0,4,4,0.031996,4,0.303907,0.338711,1883.718005
春寒(1946),春寒,notion,0,1,1,0,1,1,0.013634,4,0.273332,0.292631,0
春日(1946),春日,notion,0,1,1,0,1,1,0.005304,4,0.259537,0.268322,0
春景(1946),春景,notion,0,1,1,0,1,1,0.017626,4,0.281496,0.305894,0
春节(1946),春节,notion,0,1,1,0,1,1,0.017626,4,0.281496,0.305894,0
春草(1946),春草,notion,0,1,1,0,1,1,0.018893,4,0.282798,0.307938,0
春风(1946),春风,notion,0,2,2,0,3,3,0.03126,4,0.304035,0.338885,2199.499867
昭君(1946),昭君,notion,0,1,1,0,1,1,0.009637,4,0.265506,0.27915,0
是不是(1946),是不是,notion,0,3,3,0,3,3,0.035837,4,0.310975,0.348133,5214.773728
是非(1946),是非,notion,0,1,1,0,2,2,0.018893,4,0.282798,0.307938,0
晋东南(1946),晋东南,notion,0,1,1,0,1,1,0.017626,4,0.281496,0.305894,0
晋京(1946),晋京,notion,0,1,1,0,1,1,0.013634,4,0.273332,0.292631,0
晋绥(1946),晋绥,notion,0,1,1,0,1,1,0.00826,4,0.264992,0.278237,0
晚会(1946),晚会,notion,0,1,1,0,1,1,0.005304,4,0.259537,0.268322,0
晚明(1946),晚明,notion,0,1,1,0,1,1,0.017626,4,0.281496,0.305894,0
普拉格(1946),普拉格,notion,0,1,1,0,1,1,0.013103,4,0.272684,0.291543,0
普选(1946),普选,notion,0,1,1,0,2,2,0.017626,4,0.281496,0.305894,0
景象(1946),景象,notion,0,1,1,0,1,1,0.013634,4,0.273332,0.292631,0
晴雨(1946),晴雨,notion,0,1,1,0,1,1,0.0031,4,0.254504,0.258799,0
智慧(1946),智慧,notion,0,2,2,0,2,2,0.016796,4,0.275164,0.295747,753.735684
智识(1946),智识,notion,0,1,1,0,1,1,0.017626,4,0.281496,0.305894,0
暂别(1946),暂别,notion,0,1,1,0,1,1,0.013634,4,0.273332,0.292631,0
暂时(1946),暂时,notion,0,1,1,0,1,1,0.013103,4,0.272684,0.291543,0
暂行办法(1946),暂行办法,notion,0,1,1,0,1,1,0.017626,4,0.281496,0.305894,0
暑假(1946),暑假,notion,0,1,1,0,1,1,0.007159,4,0.261235,0.271453,0
暖流(1946),暖流,notion,0,1,1,0,1,1,0.003608,4,0.255568,0.260842,0
暗无天日(1946),暗无天日,notion,0,1,1,0,1,1,0.004479,4,0.256686,0.262973,0
暗杀(1946),暗杀,notion,0,5,5,0,6,6,0.068992,4,0.361641,0.404592,13348.749862
暗流(1946),暗流,notion,0,1,1,0,1,1,0.013103,4,0.272684,0.291543,0
暗礁(1946),暗礁,notion,0,1,1,0,1,1,0.017626,4,0.281496,0.305894,0
暴力(1946),暴力,notion,0,1,1,0,1,1,0.018893,4,0.282798,0.307938,0
暴动(1946),暴动,notion,0,1,1,0,1,1,0.00826,4,0.264992,0.278237,0
暴君(1946),暴君,notion,0,1,1,0,1,1,0.018893,4,0.282798,0.307938,0
暴徒(1946),暴徒,notion,0,3,3,0,3,3,0.027977,4,0.294503,0.325651,2762.477446
暴戾(1946),暴戾,notion,0,2,2,0,2,2,0.024354,4,0.288822,0.317229,783.391635
暴政(1946),暴政,notion,0,1,1,0,1,1,0.004479,4,0.256686,0.262973,0
暴死(1946),暴死,notion,0,1,1,0,1,1,0.004237,4,0.256206,0.26206,0
暴虐(1946),暴虐,notion,0,1,1,0,1,1,0.004564,4,0.256755,0.263104,0
暴行(1946),暴行,notion,0,5,5,0,11,11,0.055845,4,0.332024,0.373761,8442.706907
暴露(1946),暴露,notion,0,1,1,0,1,1,0.005461,4,0.25793,0.265322,0
暴风(1946),暴风,notion,0,1,1,0,2,2,0.013103,4,0.272684,0.291543,0
暴风雨(1946),暴风雨,notion,0,5,5,0,5,5,0.052587,4,0.332832,0.374674,9985.776791
暹侨监(1946),暹侨监,notion,0,1,1,0,1,1,0.00826,4,0.264992,0.278237,0
曙光(1946),曙光,notion,0,1,1,0,1,1,0.013634,4,0.273332,0.292631,0
曲子(1946),曲子,notion,0,1,1,0,1,1,0.013103,4,0.272684,0.291543,0
曲折(1946),曲折,notion,0,1,1,0,1,1,0.013378,4,0.272039,0.290456,0
更动(1946),更动,notion,0,1,1,0,1,1,0.009637,4,0.265506,0.27915,0
更惨(1946),更惨,notion,0,1,1,0,1,1,0.018893,4,0.282798,0.307938,0
曹聚仁(1946),曹聚仁,notion,0,1,1,0,1,1,0.018893,4,0.282798,0.307938,0
曼农(1946),曼农,notion,0,1,1,0,1,1,0.00826,4,0.264992,0.278237,0
曼谷(1946),曼谷,notion,0,1,1,0,1,1,0.00826,4,0.264992,0.278237,0
曾琦(1946),曾琦,notion,0,1,1,0,1,1,0.018893,4,0.282798,0.307938,0
最低(1946),最低,notion,0,1,1,0,1,1,0.004564,4,0.256755,0.263104,0
最使(1946),最使,notion,0,1,1,0,1,1,0.007159,4,0.261235,0.271453,0
最切(1946),最切,notion,0,1,1,0,1,1,0.013103,4,0.272684,0.291543,0
最多(1946),最多,notion,0,1,1,0,1,1,0.013103,4,0.272684,0.291543,0
最大(1946),最大,notion,0,3,3,0,3,3,0.034423,4,0.304874,0.340088,3570.272748
最起码(1946),最起码,notion,0,1,1,0,1,1,0.005304,4,0.259537,0.268322,0
最近(1946),最近,notion,0,7,7,0,11,11,0.08173,4,0.38025,0.421653,22215.480249
最须(1946),最须,notion,0,1,1,0,8,8,0.005304,4,0.259537,0.268322,0
有个(1946),有个,notion,0,1,1,0,1,1,0.018893,4,0.282798,0.307938,0
有些(1946),有些,notion,0,1,1,0,1,1,0.009637,4,0.265506,0.27915,0
有人(1946),有人,notion,0,2,2,0,2,2,0.026052,4,0.291576,0.321317,1054.556401
有何(1946),有何,notion,0,1,1,0,1,1,0.018893,4,0.282798,0.307938,0
有作(1946),有作,notion,0,1,1,0,1,1,0.018893,4,0.282798,0.307938,0
有关(1946),有关,notion,0,1,1,0,1,1,0.017626,4,0.281496,0.305894,0
有功(1946),有功,notion,0,1,1,0,1,1,0.018893,4,0.282798,0.307938,0
有幸(1946),有幸,notion,0,1,1,0,1,1,0.013378,4,0.272039,0.290456,0
有意无意(1946),有意无意,notion,0,1,1,0,1,1,0.003608,4,0.255568,0.260842,0
有感(1946),有感,notion,0,5,5,0,8,8,0.073168,4,0.370258,0.412637,15295.500594
有效(1946),有效,notion,0,1,1,0,1,1,0.00826,4,0.264992,0.278237,0
有没有(1946),有没有,notion,0,2,2,0,2,2,0.032527,4,0.303393,0.338015,1614.891208
有饭(1946),有饭,notion,0,1,1,0,1,1,0.007159,4,0.261235,0.271453,0
服务(1946),服务,notion,0,4,4,0,6,6,0.035933,4,0.308671,0.345205,8552.929916
服装(1946),服装,notion,0,1,1,0,1,1,0.013634,4,0.273332,0.292631,0
朝天宫(1946),朝天宫,notion,0,1,1,0,1,1,0.017626,4,0.281496,0.305894,0
朝山(1946),朝山,notion,0,1,1,0,1,1,0.017626,4,0.281496,0.305894,0
朝贺(1946),朝贺,notion,0,1,1,0,1,1,0.013378,4,0.272039,0.290456,0
期中(1946),期中,notion,0,1,1,0,1,1,0.017626,4,0.281496,0.305894,0
期内(1946),期内,notion,0,1,1,0,1,1,0.013378,4,0.272039,0.290456,0
期待(1946),期待,notion,0,2,2,0,2,2,0.027264,4,0.294896,0.326144,1405.794223
期望(1946),期望,notion,0,2,2,0,2,2,0.008561,4,0.261568,0.272134,253.060362
期满(1946),期满,notion,0,1,1,0,1,1,0.017626,4,0.281496,0.305894,0
期间(1946),期间,notion,0,1,1,0,1,1,0.017626,4,0.281496,0.305894,0
木林(1946),木林,notion,0,1,1,0,1,1,0.004577,4,0.257676,0.264843,0
未了(1946),未了,notion,0,2,2,0,2,2,0.011736,4,0.268181,0.283919,845.796027
未完(1946),未完,notion,0,1,1,0,1,1,0.004577,4,0.257676,0.264843,0
未知(1946),未知,notion,0,1,1,0,1,1,0.004479,4,0.256686,0.262973,0
未经(1946),未经,notion,0,1,1,0,1,1,0.009637,4,0.265506,0.27915,0
未释(1946),未释,notion,0,1,1,0,1,1,0.018893,4,0.282798,0.307938,0
末代(1946),末代,notion,0,1,1,0,1,1,0.013634,4,0.273332,0.292631,0
末日(1946),末日,notion,0,3,3,0,3,3,0.050153,4,0.336337,0.378443,6304.552689
末路(1946),末路,notion,0,1,1,0,1,1,0.013634,4,0.273332,0.292631,0
本人(1946),本人,notion,0,1,1,0,1,1,0.017626,4,0.281496,0.305894,0
本位(1946),本位,notion,0,3,3,0,3,3,0.036034,4,0.312361,0.349916,5975.926118
本号(1946),本号,notion,0,1,1,0,1,1,0.018893,4,0.282798,0.307938,0
本届(1946),本届,notion,0,1,1,0,1,1,0.017626,4,0.281496,0.305894,0
本市(1946),本市,notion,0,1,1,0,1,1,0.007159,4,0.261235,0.271453,0
本月(1946),本月,notion,0,1,1,0,1,1,0.003608,4,0.255568,0.260842,0
本港(1946),本港,notion,0,1,1,0,1,1,0.00826,4,0.264992,0.278237,0
本省(1946),本省,notion,0,1,1,0,1,1,0.007159,4,0.261235,0.271453,0
本节(1946),本节,notion,0,1,1,0,1,1,0.004577,4,0.257676,0.264843,0
本质(1946),本质,notion,0,4,4,0,4,4,0.053859,4,0.340883,0.383472,8750.030919
朱东润(1946),朱东润,notion,0,1,1,0,1,1,0.017626,4,0.281496,0.305894,0
朱学范(1946),朱学范,notion,0,2,2,0,3,3,0.027153,4,0.296784,0.32884,1981.441549
朱富胜(1946),朱富胜,notion,0,1,1,0,1,1,0.013378,4,0.272039,0.290456,0
朱德(1946),朱德,notion,0,1,1,0,2,2,0.00826,4,0.264992,0.278237,0
朱总司令(1946),朱总司令,notion,0,1,1,0,4,4,0.00826,4,0.264992,0.278237,0
朱明(1946),朱明,notion,0,1,1,0,1,1,0.018893,4,0.282798,0.307938,0
机会(1946),机会,notion,0,3,3,0,4,4,0.020404,4,0.279689,0.303169,1970.576102
机关枪(1946),机关枪,notion,0,1,1,0,1,1,0.013634,4,0.273332,0.292631,0
机来(1946),机来,notion,0,1,1,0,1,1,0.013634,4,0.273332,0.292631,0
杀人(1946),杀人,notion,0,2,2,0,3,3,0.027153,4,0.296784,0.32884,1981.441549
杀人犯(1946),杀人犯,notion,0,1,1,0,2,2,0.00826,4,0.264992,0.278237,0
杀人者(1946),杀人者,notion,0,1,1,0,1,1,0.018893,4,0.282798,0.307938,0
杀戮(1946),杀戮,notion,0,1,1,0,1,1,0.013378,4,0.272039,0.290456,0
杀死(1946),杀死,notion,0,1,1,0,1,1,0.018893,4,0.282798,0.307938,0
杂写(1946),杂写,notion,0,1,1,0,1,1,0.017626,4,0.281496,0.305894,0
杂志(1946),杂志,notion,0,2,2,0,2,2,0.017582,4,0.278308,0.300878,864.242178
杂景(1946),杂景,notion,0,1,1,0,2,2,0.013634,4,0.273332,0.292631,0
杂缀(1946),杂缀,notion,0,1,1,0,1,1,0.017626,4,0.281496,0.305894,0
杂谈(1946),杂谈,notion,0,2,2,0,2,2,0.023015,4,0.2849,0.311272,897.577022
权威(1946),权威,notion,0,1,1,0,1,1,0.004577,4,0.257676,0.264843,0
权应(1946),权应,notion,0,1,1,0,1,1,0.013378,4,0.272039,0.290456,0
权贵(1946),权贵,notion,0,1,1,0,1,1,0.009637,4,0.265506,0.27915,0
权须(1946),权须,notion,0,1,1,0,1,1,0.017626,4,0.281496,0.305894,0
李健吾(1946),李健吾,notion,0,1,1,0,2,2,0.013634,4,0.273332,0.292631,0
李兆麟(1946),李兆麟,notion,0,1,1,0,1,1,0.003608,4,0.255568,0.260842,0
李冰(1946),李冰,notion,0,1,1,0,1,1,0.017626,4,0.281496,0.305894,0
李大妈(1946),李大妈,notion,0,1,1,0,1,1,0.018893,4,0.282798,0.307938,0
李家(1946),李家,notion,0,1,1,0,1,1,0.018893,4,0.282798,0.307938,0
李少石(1946),李少石,notion,0,1,1,0,1,1,0.00826,4,0.264992,0.278237,0
李成(1946),李成,notion,0,1,1,0,1,1,0.013103,4,0.272684,0.291543,0
李泽是(1946),李泽是,notion,0,1,1,0,1,1,0.018893,4,0.282798,0.307938,0
李闻案(1946),李闻案,notion,0,3,3,0,3,3,0.037006,4,0.308307,0.344654,3214.406986
李陵(1946),李陵,notion,0,1,1,0,1,1,0.009637,4,0.265506,0.27915,0
李鸿章(1946),李鸿章,notion,0,1,1,0,1,1,0.013634,4,0.273332,0.292631,0
村过(1946),村过,notion,0,1,1,0,1,1,0.00826,4,0.264992,0.278237,0
杜会(1946),杜会,notion,0,1,1,0,1,1,0.017626,4,0.281496,0.305894,0
杜威(1946),杜威,notion,0,1,1,0,1,1,0.017626,4,0.281496,0.305894,0
杜鲁门(1946),杜鲁门,notion,0,6,6,0,9,9,0.063572,4,0.344809,0.387792,13098.153122
条件(1946),条件,notion,0,3,3,0,5,5,0.041824,4,0.323942,0.364223,6881.110907
条约(1946),条约,notion,0,2,2,0,2,2,0.011638,4,0.266812,0.281527,466.757155
来临(1946),来临,notion,0,1,1,0,1,1,0.007159,4,0.261235,0.271453,0
来信(1946),来信,notion,0,4,4,0,4,4,0.045334,4,0.325667,0.366339,7759.261443
来到(1946),来到,notion,0,1,1,0,1,1,0.00826,4,0.264992,0.278237,0
来华(1946),来华,notion,0,1,1,0,1,1,0.007159,4,0.261235,0.271453,0
来挽(1946),来挽,notion,0,1,1,0,1,1,0.013378,4,0.272039,0.290456,0
来的(1946),来的,notion,0,1,1,0,1,1,0.007159,4,0.261235,0.271453,0
来的我(1946),来的我,notion,0,1,1,0,3,3,0.017626,4,0.281496,0.305894,0
来自(1946),来自,notion,0,1,1,0,1,1,0.017626,4,0.281496,0.305894,0
来谈(1946),来谈,notion,0,1,1,0,1,1,0.007159,4,0.261235,0.271453,0
来鸿(1946),来鸿,notion,0,2,2,0,2,2,0.022204,4,0.287896,0.315838,1406.192172
杨文道(1946),杨文道,notion,0,1,1,0,1,1,0.013634,4,0.273332,0.292631,0
杨杰(1946),杨杰,notion,0,1,1,0,1,1,0.018893,4,0.282798,0.307938,0
杨森(1946),杨森,notion,0,1,1,0,1,1,0.018893,4,0.282798,0.307938,0
杨椒山(1946),杨椒山,notion,0,1,1,0,1,1,0.013634,4,0.273332,0.292631,0
杨泉(1946),杨泉,notion,0,1,1,0,1,1,0.004564,4,0.256755,0.263104,0
杨潮(1946),杨潮,notion,0,3,3,0,3,3,0.036764,4,0.307845,0.344045,2893.036981
杭州(1946),杭州,notion,0,3,3,0,5,5,0.02229,4,0.285494,0.312257,3165.758578
杰作(1946),杰作,notion,0,1,1,0,1,1,0.007159,4,0.261235,0.271453,0
松懈(1946),松懈,notion,0,1,1,0,1,1,0.005304,4,0.259537,0.268322,0
极度(1946),极度,notion,0,1,1,0,1,1,0.017626,4,0.281496,0.305894,0
析疑(1946),析疑,notion,0,1,1,0,1,1,0.013634,4,0.273332,0.292631,0
林溪(1946),林溪,notion,0,1,1,0,1,1,0.004577,4,0.257676,0.264843,0
林语堂(1946),林语堂,notion,0,1,1,0,1,1,0.018893,4,0.282798,0.307938,0
果园(1946),果园,notion,0,1,1,0,1,1,0.013634,4,0.273332,0.292631,0
枪杀(1946),枪杀,notion,0,1,1,0,1,1,0.018893,4,0.282798,0.307938,0
枪杆(1946),枪杆,notion,0,1,1,0,1,1,0.013634,4,0.273332,0.292631,0
枪炮(1946),枪炮,notion,0,1,1,0,1,1,0.013634,4,0.273332,0.292631,0
枯竭(1946),枯竭,notion,0,1,1,0,1,1,0.0031,4,0.254504,0.258799,0
枷锁(1946),枷锁,notion,0,1,1,0,1,1,0.00826,4,0.264992,0.278237,0
某大学(1946),某大学,notion,0,1,1,0,1,1,0.007159,4,0.261235,0.271453,0
某种(1946),某种,notion,0,1,1,0,1,1,0.009637,4,0.265506,0.27915,0
查禁(1946),查禁,notion,0,1,1,0,1,1,0.018893,4,0.282798,0.307938,0
柱石(1946),柱石,notion,0,1,1,0,1,1,0.013103,4,0.272684,0.291543,0
柳亚子(1946),柳亚子,notion,0,1,1,0,1,1,0.013634,4,0.273332,0.292631,0
柳州(1946),柳州,notion,0,1,1,0,1,1,0.017626,4,0.281496,0.305894,0
柴苏勃烈(1946),柴苏勃烈,notion,0,1,1,0,1,1,0.013103,4,0.272684,0.291543,0
标本(1946),标本,notion,0,2,2,0,2,2,0.022501,4,0.28712,0.314663,997.953629
标题(1946),标题,notion,0,1,1,0,1,1,0.004577,4,0.257676,0.264843,0
树胶(1946),树胶,notion,0,1,1,0,1,1,0.00826,4,0.264992,0.278237,0
校场口(1946),校场口,notion,0,1,1,0,1,1,0.013378,4,0.272039,0.290456,0
核心(1946),核心,notion,0,1,1,0,1,1,0.004564,4,0.256755,0.263104,0
根据(1946),根据,notion,0,2,2,0,2,2,0.027264,4,0.294896,0.326144,1405.794223
根本(1946),根本,notion,0,2,2,0,2,2,0.014874,4,0.273619,0.293181,536.806795
根源(1946),根源,notion,0,2,2,0,4,4,0.01768,4,0.279308,0.302487,1220.085569
根绝(1946),根绝,notion,0,1,1,0,1,1,0.003608,4,0.255568,0.260842,0
格言(1946),格言,notion,0,1,1,0,1,1,0.018893,4,0.282798,0.307938,0
格雷(1946),格雷,notion,0,1,1,0,1,1,0.009637,4,0.265506,0.27915,0
桂东(1946),桂东,notion,0,1,1,0,1,1,0.007159,4,0.261235,0.271453,0
桂林(1946),桂林,notion,0,4,4,0,6,6,0.047945,4,0.327896,0.368948,9030.584584
桂系(1946),桂系,notion,0,1,1,0,1,1,0.018893,4,0.282798,0.307938,0
案外(1946),案外,notion,0,1,1,0,1,1,0.013634,4,0.273332,0.292631,0
案开审(1946),案开审,notion,0,2,2,0,2,2,0.01513,4,0.274953,0.295399,633.585998
案欢(1946),案欢,notion,0,1,1,0,1,1,0.001496,4,0.252204,0.25432,0
案的(1946),案的,notion,0,1,1,0,1,1,0.018893,4,0.282798,0.307938,0
桌子(1946),桌子,notion,0,1,1,0,1,1,0.003608,4,0.255568,0.260842,0
桎梏(1946),桎梏,notion,0,1,1,0,1,1,0.013634,4,0.273332,0.292631,0
桐庐(1946),桐庐,notion,0,1,1,0,1,1,0.013634,4,0.273332,0.292631,0
桐油(1946),桐油,notion,0,1,1,0,1,1,0.017626,4,0.281496,0.305894,0
桥梁(1946),桥梁,notion,0,1,1,0,1,1,0.005304,4,0.259537,0.268322,0
梁漱溟(1946),梁漱溟,notion,0,1,1,0,1,1,0.018893,4,0.282798,0.307938,0
梅光迪(1946),梅光迪,notion,0,1,1,0,1,1,0.004577,4,0.257676,0.264843,0
梅十雨(1946),梅十雨,notion,0,1,1,0,1,1,0.013378,4,0.272039,0.290456,0
梅花(1946),梅花,notion,0,1,1,0,1,1,0.00826,4,0.264992,0.278237,0
检举(1946),检举,notion,0,2,2,0,4,4,0.032271,4,0.301168,0.334971,1271.496707
检察官(1946),检察官,notion,0,1,1,0,1,1,0.013103,4,0.272684,0.291543,0
检讨(1946),检讨,notion,0,9,9,0,15,15,0.089096,4,0.396674,0.435409,39801.984225
检阅(1946),检阅,notion,0,1,1,0,1,1,0.013103,4,0.272684,0.291543,0
棉花(1946),棉花,notion,0,1,1,0,1,1,0.017626,4,0.281496,0.305894,0
棒喝(1946),棒喝,notion,0,1,1,0,1,1,0.004564,4,0.256755,0.263104,0
棘手(1946),棘手,notion,0,1,1,0,1,1,0.017626,4,0.281496,0.305894,0
概略(1946),概略,notion,0,1,1,0,1,1,0.017626,4,0.281496,0.305894,0
概述(1946),概述,notion,0,1,1,0,1,1,0.013634,4,0.273332,0.292631,0
榨干(1946),榨干,notion,0,1,1,0,1,1,0.007159,4,0.261235,0.271453,0
榨油(1946),榨油,notion,0,1,1,0,1,1,0.00826,4,0.264992,0.278237,0
横行(1946),横行,notion,0,2,2,0,2,2,0.021894,4,0.287839,0.315751,2020.708436
横行无忌(1946),横行无忌,notion,0,1,1,0,1,1,0.018893,4,0.282798,0.307938,0
欢迎(1946),欢迎,notion,0,6,6,0,8,8,0.044317,4,0.317151,0.356178,9526.005018
欣慰(1946),欣慰,notion,0,1,1,0,1,1,0.004564,4,0.256755,0.263104,0
欣赏(1946),欣赏,notion,0,1,1,0,1,1,0.004564,4,0.256755,0.263104,0
欧打(1946),欧打,notion,0,1,1,0,1,1,0.013378,4,0.272039,0.290456,0
欧罗巴(1946),欧罗巴,notion,0,1,1,0,1,1,0.017626,4,0.281496,0.305894,0
欧阳予倩(1946),欧阳予倩,notion,0,1,1,0,1,1,0.018893,4,0.282798,0.307938,0
欲望(1946),欲望,notion,0,1,1,0,1,1,0.005461,4,0.25793,0.265322,0
欲求(1946),欲求,notion,0,1,1,0,1,1,0.017626,4,0.281496,0.305894,0
欺骗(1946),欺骗,notion,0,2,2,0,2,2,0.012823,4,0.270988,0.288746,913.401999
歇手(1946),歇手,notion,0,1,1,0,1,1,0.013378,4,0.272039,0.290456,0
歌唱(1946),歌唱,notion,0,1,1,0,1,1,0.018893,4,0.282798,0.307938,0
歌声(1946),歌声,notion,0,2,2,0,11,11,0.030729,4,0.302946,0.337407,2092.27198
歌谣(1946),歌谣,notion,0,1,1,0,1,1,0.018893,4,0.282798,0.307938,0
歌谱(1946),歌谱,notion,0,1,1,0,1,1,0.004577,4,0.257676,0.264843,0
歌颂(1946),歌颂,notion,0,1,1,0,1,1,0.013634,4,0.273332,0.292631,0
止步(1946),止步,notion,0,1,1,0,1,1,0.004564,4,0.256755,0.263104,0
正义(1946),正义,notion,0,3,3,0,3,3,0.044638,4,0.323432,0.363614,5148.150283
正传(1946),正传,notion,0,1,1,0,1,1,0.007159,4,0.261235,0.271453,0
正唇(1946),正唇,notion,0,1,1,0,1,1,0.003608,4,0.255568,0.260842,0
正在(1946),正在,notion,0,1,1,0,1,1,0.017626,4,0.281496,0.305894,0
正气(1946),正气,notion,0,1,1,0,1,1,0.018893,4,0.282798,0.307938,0
正视(1946),正视,notion,0,1,1,0,1,1,0.004564,4,0.256755,0.263104,0
此举(1946),此举,notion,0,1,1,0,1,1,0.009637,4,0.265506,0.27915,0
此之谓(1946),此之谓,notion,0,1,1,0,1,1,0.018893,4,0.282798,0.307938,0
此次(1946),此次,notion,0,1,1,0,2,2,0.017626,4,0.281496,0.305894,0
步伐(1946),步伐,notion,0,2,2,0,2,2,0.021363,4,0.287407,0.315098,2175.293762
步武(1946),步武,notion,0,1,1,0,1,1,0.018893,4,0.282798,0.307938,0
步骤(1946),步骤,notion,0,1,1,0,1,1,0.005304,4,0.259537,0.268322,0
武剧(1946),武剧,notion,0,1,1,0,1,1,0.009637,4,0.265506,0.27915,0
武力(1946),武力,notion,0,6,6,0,7,7,0.075399,4,0.379297,0.420754,24397.426081
武士道(1946),武士道,notion,0,1,1,0,1,1,0.009637,4,0.265506,0.27915,0
武威(1946),武威,notion,0,1,1,0,1,1,0.017626,4,0.281496,0.305894,0
武汉(1946),武汉,notion,0,2,2,0,3,3,0.032271,4,0.301168,0.334971,1271.496707
歧路(1946),歧路,notion,0,2,2,0,2,2,0.02274,4,0.286006,0.312967,1109.932808
歧途(1946),歧途,notion,0,1,1,0,1,1,0.004577,4,0.257676,0.264843,0
歪曲(1946),歪曲,notion,0,1,1,0,1,1,0.001496,4,0.252204,0.25432,0
歪风(1946),歪风,notion,0,1,1,0,1,1,0.00826,4,0.264992,0.278237,0
死刑(1946),死刑,notion,0,1,1,0,1,1,0.017626,4,0.281496,0.305894,0
死耗(1946),死耗,notion,0,1,1,0,1,1,0.013634,4,0.273332,0.292631,0
死难(1946),死难,notion,0,2,2,0,3,3,0.026052,4,0.291576,0.321317,1054.556401
歼灭(1946),歼灭,notion,0,1,1,0,1,1,0.00826,4,0.264992,0.278237,0
歼灭战(1946),歼灭战,notion,0,1,1,0,1,1,0.00826,4,0.264992,0.278237,0
殃民(1946),殃民,notion,0,2,2,0,2,2,0.027153,4,0.296784,0.32884,1981.441549
殉难(1946),殉难,notion,0,3,3,0,3,3,0.027936,4,0.292585,0.322868,2015.610819
残堡(1946),残堡,notion,0,1,1,0,1,1,0.018893,4,0.282798,0.307938,0
残年暮景(1946),残年暮景,notion,0,1,1,0,1,1,0.00826,4,0.264992,0.278237,0
残酷(1946),残酷,notion,0,1,1,0,1,1,0.005461,4,0.25793,0.265322,0
殖民地化(1946),殖民地化,notion,0,1,1,0,1,1,0.018893,4,0.282798,0.307938,0
殖民政策(1946),殖民政策,notion,0,1,1,0,1,1,0.004479,4,0.256686,0.262973,0
殴打(1946),殴打,notion,0,1,1,0,1,1,0.004237,4,0.256206,0.26206,0
毁减(1946),毁减,notion,0,2,2,0,2,2,0.013721,4,0.272039,0.290529,811.384126
毁灭(1946),毁灭,notion,0,2,2,0,2,2,0.012497,4,0.270554,0.288007,774.807195
母体(1946),母体,notion,0,1,1,0,1,1,0.005304,4,0.259537,0.268322,0
毒焰(1946),毒焰,notion,0,1,1,0,1,1,0.0031,4,0.254504,0.258799,0
毒瘤(1946),毒瘤,notion,0,1,1,0,1,1,0.017626,4,0.281496,0.305894,0
毒素(1946),毒素,notion,0,1,1,0,1,1,0.018893,4,0.282798,0.307938,0
比做(1946),比做,notion,0,1,1,0,1,1,0.004577,4,0.257676,0.264843,0
比基尼(1946),比基尼,notion,0,2,2,0,2,2,0.032527,4,0.303393,0.338015,1614.891208
比较(1946),比较,notion,0,4,4,0,4,4,0.051522,4,0.336691,0.378906,9762.398187
毕业生(1946),毕业生,notion,0,1,1,0,1,1,0.017626,4,0.281496,0.305894,0
毛泽东(1946),毛泽东,notion,0,1,1,0,1,1,0.00826,4,0.264992,0.278237,0
氏谈(1946),氏谈,notion,0,1,1,0,1,1,0.0031,4,0.254504,0.258799,0
民主主义(1946),民主主义,notion,0,2,2,0,2,2,0.017897,4,0.280261,0.304009,1765.875744
民主作风(1946),民主作风,notion,0,4,4,0,5,5,0.035183,4,0.301832,0.336029,4860.646334
民主同盟(1946),民主同盟,notion,0,6,6,0,9,9,0.05547,4,0.330345,0.37192,10986.390678
民主思想(1946),民主思想,notion,0,2,2,0,2,2,0.011722,4,0.266812,0.281527,472.501913
民主潮流(1946),民主潮流,notion,0,1,1,0,1,1,0.013103,4,0.272684,0.291543,0
民主社会党(1946),民主社会党,notion,0,2,2,0,3,3,0.02853,4,0.295746,0.327361,1236.887723
民主自由(1946),民主自由,notion,0,1,1,0,1,1,0.013634,4,0.273332,0.292631,0
民主运动(1946),民主运动,notion,0,7,7,0,12,12,0.085677,4,0.393578,0.432785,26663.746317
民主选举(1946),民主选举,notion,0,1,1,0,1,1,0.005461,4,0.25793,0.265322,0
民主革命(1946),民主革命,notion,0,1,1,0,1,1,0.004479,4,0.256686,0.262973,0
民乱(1946),民乱,notion,0,1,1,0,1,1,0.004577,4,0.257676,0.264843,0
民众(1946),民众,notion,0,2,2,0,4,4,0.020536,4,0.280891,0.30501,760.639997
民兵(1946),民兵,notion,0,2,2,0,2,2,0.009756,4,0.266812,0.281527,695.700178
民初(1946),民初,notion,0,1,1,0,1,1,0.007159,4,0.261235,0.271453,0
民力(1946),民力,notion,0,1,1,0,1,1,0.013634,4,0.273332,0.292631,0
民变(1946),民变,notion,0,3,3,0,4,4,0.040786,4,0.31831,0.357395,5617.041193
民国(1946),民国,notion,0,4,4,0,4,4,0.0282,4,0.289054,0.317722,3121.658247
民意机构(1946),民意机构,notion,0,1,1,0,1,1,0.017626,4,0.281496,0.305894,0
民意测验(1946),民意测验,notion,0,1,1,0,1,1,0.007159,4,0.261235,0.271453,0
民族主义(1946),民族主义,notion,0,2,2,0,2,2,0.008655,4,0.263004,0.274743,415.877318
民族压迫(1946),民族压迫,notion,0,1,1,0,1,1,0.00826,4,0.264992,0.278237,0
民族形式(1946),民族形式,notion,0,1,1,0,1,1,0.013103,4,0.272684,0.291543,0
民族解放(1946),民族解放,notion,0,1,1,0,1,1,0.013103,4,0.272684,0.291543,0
民权初步(1946),民权初步,notion,0,1,1,0,1,1,0.013634,4,0.273332,0.292631,0
民死(1946),民死,notion,0,1,1,0,1,1,0.00826,4,0.264992,0.278237,0
民生(1946),民生,notion,0,5,5,0,7,7,0.058558,4,0.350613,0.393721,15708.142215
民生主义(1946),民生主义,notion,0,2,2,0,3,3,0.02219,4,0.287062,0.314576,1087.606545
民盟(1946),民盟,notion,0,5,5,0,11,11,0.053618,4,0.334731,0.376805,9754.44759
民盟二中全会(1946),民盟二中全会,notion,0,2,2,0,2,2,0.008716,4,0.262045,0.273004,282.22732
民社党(1946),民社党,notion,0,3,3,0,3,3,0.03301,4,0.300633,0.334305,2669.091886
民联轮(1946),民联轮,notion,0,1,1,0,1,1,0.013378,4,0.272039,0.290456,0
民衆(1946),民衆,notion,0,1,1,0,1,1,0.017626,4,0.281496,0.305894,0
民警(1946),民警,notion,0,1,1,0,1,1,0.013634,4,0.273332,0.292631,0
民谣(1946),民谣,notion,0,1,1,0,1,1,0.018893,4,0.282798,0.307938,0
民运(1946),民运,notion,0,1,1,0,1,1,0.004479,4,0.256686,0.262973,0
民间(1946),民间,notion,0,2,2,0,2,2,0.03126,4,0.304035,0.338885,2199.499867
民间文学(1946),民间文学,notion,0,1,1,0,1,1,0.013103,4,0.272684,0.291543,0
民食(1946),民食,notion,0,1,1,0,1,1,0.013378,4,0.272039,0.290456,0
气候(1946),气候,notion,0,1,1,0,1,1,0.013103,4,0.272684,0.291543,0
气力(1946),气力,notion,0,1,1,0,1,1,0.009637,4,0.265506,0.27915,0
气味(1946),气味,notion,0,1,1,0,1,1,0.013378,4,0.272039,0.290456,0
气氛(1946),气氛,notion,0,2,2,0,2,2,0.018407,4,0.281634,0.306184,1780.990245
气派(1946),气派,notion,0,1,1,0,1,1,0.018893,4,0.282798,0.307938,0
水准(1946),水准,notion,0,1,1,0,1,1,0.018893,4,0.282798,0.307938,0
水利(1946),水利,notion,0,1,1,0,1,1,0.017626,4,0.281496,0.305894,0
水族(1946),水族,notion,0,1,1,0,1,1,0.018893,4,0.282798,0.307938,0
水能载舟(1946),水能载舟,notion,0,1,1,0,1,1,0.017626,4,0.281496,0.305894,0
水落石出(1946),水落石出,notion,0,1,1,0,1,1,0.017626,4,0.281496,0.305894,0
水银(1946),水银,notion,0,1,1,0,1,1,0.017626,4,0.281496,0.305894,0
水鸟(1946),水鸟,notion,0,1,1,0,1,1,0.013378,4,0.272039,0.290456,0
永不(1946),永不,notion,0,1,1,0,1,1,0.005304,4,0.259537,0.268322,0
永久(1946),永久,notion,0,2,2,0,3,3,0.023088,4,0.287867,0.315794,912.175655
永在(1946),永在,notion,0,1,1,0,1,1,0.013378,4,0.272039,0.290456,0
永生(1946),永生,notion,0,1,1,0,1,1,0.018893,4,0.282798,0.307938,0
永登(1946),永登,notion,0,1,1,0,1,1,0.017626,4,0.281496,0.305894,0
永远(1946),永远,notion,0,3,3,0,3,3,0.037006,4,0.308307,0.344654,3214.406986
求爱(1946),求爱,notion,0,1,1,0,1,1,0.003608,4,0.255568,0.260842,0
求生(1946),求生,notion,0,2,2,0,2,2,0.009141,4,0.263752,0.276091,604.443087
求胜(1946),求胜,notion,0,1,1,0,1,1,0.004577,4,0.257676,0.264843,0
汇合(1946),汇合,notion,0,1,1,0,1,1,0.018893,4,0.282798,0.307938,0
汇率(1946),汇率,notion,0,2,2,0,2,2,0.027011,4,0.292079,0.322056,1114.922273
汉书(1946),汉书,notion,0,1,1,0,1,1,0.013634,4,0.273332,0.292631,0
汉口(1946),汉口,notion,0,2,2,0,2,2,0.022204,4,0.287896,0.315838,1406.192172
汉奸(1946),汉奸,notion,0,5,5,0,10,10,0.068992,4,0.361641,0.404592,13348.749862
江北(1946),江北,notion,0,1,1,0,1,1,0.018893,4,0.282798,0.307938,0
江南(1946),江南,notion,0,1,1,0,1,1,0.013634,4,0.273332,0.292631,0
江苏(1946),江苏,notion,0,2,2,0,3,3,0.024197,4,0.292198,0.32223,2288.2854
江苏省(1946),江苏省,notion,0,1,1,0,2,2,0.005304,4,0.259537,0.268322,0
江西(1946),江西,notion,0,1,1,0,1,1,0.013634,4,0.273332,0.292631,0
污点(1946),污点,notion,0,1,1,0,1,1,0.009637,4,0.265506,0.27915,0
汹涌(1946),汹涌,notion,0,1,1,0,1,1,0.013634,4,0.273332,0.292631,0
汹涌澎湃(1946),汹涌澎湃,notion,0,1,1,0,1,1,0.009637,4,0.265506,0.27915,0
汽车团(1946),汽车团,notion,0,1,1,0,1,1,0.013634,4,0.273332,0.292631,0
沁园春(1946),沁园春,notion,0,1,1,0,1,1,0.003608,4,0.255568,0.260842,0
沃克兰(1946),沃克兰,notion,0,1,1,0,1,1,0.005304,4,0.259537,0.268322,0
沈钧儒(1946),沈钧儒,notion,0,2,2,0,2,2,0.023372,4,0.287781,0.315664,849.784339
沉潜(1946),沉潜,notion,0,1,1,0,1,1,0.004479,4,0.256686,0.262973,0
沉痛(1946),沉痛,notion,0,1,1,0,1,1,0.013378,4,0.272039,0.290456,0
沉重(1946),沉重,notion,0,1,1,0,1,1,0.017626,4,0.281496,0.305894,0
沉静(1946),沉静,notion,0,1,1,0,1,1,0.004577,4,0.257676,0.264843,0
沙坪坝(1946),沙坪坝,notion,0,1,1,0,2,2,0.017626,4,0.281496,0.305894,0
沙城(1946),沙城,notion,0,2,2,0,2,2,0.009698,4,0.262356,0.273569,160.636246
沙湾(1946),沙湾,notion,0,1,1,0,1,1,0.00826,4,0.264992,0.278237,0
沙赫特(1946),沙赫特,notion,0,1,1,0,1,1,0.013103,4,0.272684,0.291543,0
沙龙(1946),沙龙,notion,0,1,1,0,1,1,0.004577,4,0.257676,0.264843,0
没出息(1946),没出息,notion,0,1,1,0,1,1,0.013634,4,0.273332,0.292631,0
没落(1946),没落,notion,0,1,1,0,1,1,0.013103,4,0.272684,0.291543,0
没饭(1946),没饭,notion,0,1,1,0,1,1,0.0031,4,0.254504,0.258799,0
河内(1946),河内,notion,0,1,1,0,1,1,0.00826,4,0.264992,0.278237,0
河山(1946),河山,notion,0,1,1,0,1,1,0.013103,4,0.272684,0.291543,0
河流(1946),河流,notion,0,1,1,0,1,1,0.013103,4,0.272684,0.291543,0
治学(1946),治学,notion,0,1,1,0,1,1,0.017626,4,0.281496,0.305894,0
治安(1946),治安,notion,0,2,2,0,2,2,0.027153,4,0.296784,0.32884,1981.441549
治家格言(1946),治家格言,notion,0,1,1,0,1,1,0.018893,4,0.282798,0.307938,0
治法(1946),治法,notion,0,1,1,0,1,1,0.017626,4,0.281496,0.305894,0
沿革(1946),沿革,notion,0,1,1,0,1,1,0.013634,4,0.273332,0.292631,0
泄漏(1946),泄漏,notion,0,1,1,0,1,1,0.013103,4,0.272684,0.291543,0
泉源(1946),泉源,notion,0,1,1,0,1,1,0.013103,4,0.272684,0.291543,0
法人(1946),法人,notion,0,1,1,0,1,1,0.005304,4,0.259537,0.268322,0
法共(1946),法共,notion,0,1,1,0,1,1,0.017626,4,0.281496,0.305894,0
法则(1946),法则,notion,0,1,1,0,1,1,0.013103,4,0.272684,0.291543,0
法国共产党(1946),法国共产党,notion,0,1,1,0,1,1,0.009637,4,0.265506,0.27915,0
法学(1946),法学,notion,0,1,1,0,1,1,0.017626,4,0.281496,0.305894,0
法定代理(1946),法定代理,notion,0,1,1,0,1,1,0.005304,4,0.259537,0.268322,0
法宝(1946),法宝,notion,0,1,1,0,1,1,0.013634,4,0.273332,0.292631,0
法币(1946),法币,notion,0,4,4,0,4,4,0.050636,4,0.33237,0.37408,7654.586847
法律(1946),法律,notion,0,4,4,0,6,6,0.038229,4,0.3051,0.340465,3737.008349
法案(1946),法案,notion,0,3,3,0,3,3,0.027494,4,0.290163,0.319302,2142.87655
法治(1946),法治,notion,0,3,3,0,3,3,0.035581,4,0.308903,0.345437,4397.690562
法统(1946),法统,notion,0,4,4,0,4,4,0.037631,4,0.309435,0.346205,5259.185645
法西(1946),法西,notion,0,1,1,0,1,1,0.018893,4,0.282798,0.307938,0
法西斯主义(1946),法西斯主义,notion,0,1,1,0,2,2,0.013103,4,0.272684,0.291543,0
法语(1946),法语,notion,0,1,1,0,1,1,0.013634,4,0.273332,0.292631,0
法郎(1946),法郎,notion,0,1,1,0,1,1,0.013103,4,0.272684,0.291543,0
法院(1946),法院,notion,0,1,1,0,1,1,0.013634,4,0.273332,0.292631,0
泗礁(1946),泗礁,notion,0,1,1,0,1,1,0.005304,4,0.259537,0.268322,0
波兰(1946),波兰,notion,0,1,1,0,2,2,0.013103,4,0.272684,0.291543,0
波动(1946),波动,notion,0,1,1,0,1,1,0.018893,4,0.282798,0.307938,0
波地(1946),波地,notion,0,1,1,0,1,1,0.013103,4,0.272684,0.291543,0
注于(1946),注于,notion,0,1,1,0,1,1,0.005304,4,0.259537,0.268322,0
注意(1946),注意,notion,0,2,2,0,3,3,0.032271,4,0.301168,0.334971,1271.496707
注视(1946),注视,notion,0,3,3,0,3,3,0.028045,4,0.295472,0.327042,4450.420228
泰兴(1946),泰兴,notion,0,1,1,0,1,1,0.004577,4,0.257676,0.264843,0
泰山(1946),泰山,notion,0,1,1,0,1,1,0.018893,4,0.282798,0.307938,0
泽被(1946),泽被,notion,0,1,1,0,1,1,0.013634,4,0.273332,0.292631,0
洋货(1946),洋货,notion,0,1,1,0,1,1,0.018893,4,0.282798,0.307938,0
洗澡(1946),洗澡,notion,0,1,1,0,1,1,0.013634,4,0.273332,0.292631,0
洛维奇(1946),洛维奇,notion,0,1,1,0,1,1,0.013103,4,0.272684,0.291543,0
洪泽湖(1946),洪泽湖,notion,0,1,1,0,1,1,0.00826,4,0.264992,0.278237,0
洱海(1946),洱海,notion,0,1,1,0,1,1,0.017626,4,0.281496,0.305894,0
活动(1946),活动,notion,0,4,4,0,4,4,0.04556,4,0.329097,0.37034,12195.017403
活地狱(1946),活地狱,notion,0,1,1,0,1,1,0.00826,4,0.264992,0.278237,0
活埋(1946),活埋,notion,0,1,1,0,1,1,0.013634,4,0.273332,0.292631,0
活得(1946),活得,notion,0,1,1,0,1,1,0.004479,4,0.256686,0.262973,0
活泼(1946),活泼,notion,0,1,1,0,1,1,0.017626,4,0.281496,0.305894,0
活着(1946),活着,notion,0,1,1,0,1,1,0.013634,4,0.273332,0.292631,0
派的(1946),派的,notion,0,1,1,0,1,1,0.004479,4,0.256686,0.262973,0
派遣(1946),派遣,notion,0,1,1,0,1,1,0.009637,4,0.265506,0.27915,0
流产(1946),流产,notion,0,2,2,0,2,2,0.026481,4,0.292853,0.323187,1408.34579
流域(1946),流域,notion,0,1,1,0,1,1,0.009637,4,0.265506,0.27915,0
流年似水(1946),流年似水,notion,0,1,1,0,1,1,0.013103,4,0.272684,0.291543,0
流毒(1946),流毒,notion,0,1,1,0,1,1,0.013378,4,0.272039,0.290456,0
流氓(1946),流氓,notion,0,1,1,0,1,1,0.018893,4,0.282798,0.307938,0
流血(1946),流血,notion,0,1,1,0,2,2,0.007159,4,0.261235,0.271453,0
浅近(1946),浅近,notion,0,1,1,0,1,1,0.013378,4,0.272039,0.290456,0
浅释(1946),浅释,notion,0,1,1,0,1,1,0.005304,4,0.259537,0.268322,0
测校(1946),测校,notion,0,1,1,0,1,1,0.017626,4,0.281496,0.305894,0
测隐(1946),测隐,notion,0,1,1,0,1,1,0.018893,4,0.282798,0.307938,0
济南(1946),济南,notion,0,1,1,0,1,1,0.018893,4,0.282798,0.307938,0
浙大(1946),浙大,notion,0,1,1,0,1,1,0.017626,4,0.281496,0.305894,0
浙江(1946),浙江,notion,0,2,2,0,3,3,0.027011,4,0.292079,0.322056,1114.922273
浙道(1946),浙道,notion,0,1,1,0,1,1,0.013634,4,0.273332,0.292631,0
浦东(1946),浦东,notion,0,1,1,0,2,2,0.005304,4,0.259537,0.268322,0
浦建(1946),浦建,notion,0,1,1,0,2,2,0.005304,4,0.259537,0.268322,0
浦斯(1946),浦斯,notion,0,2,2,0,2,2,0.02313,4,0.287378,0.315055,697.222
浦江(1946),浦江,notion,0,1,1,0,1,1,0.013634,4,0.273332,0.292631,0
浪岗(1946),浪岗,notion,0,1,1,0,1,1,0.005304,4,0.259537,0.268322,0
浪岗山(1946),浪岗山,notion,0,1,1,0,1,1,0.005304,4,0.259537,0.268322,0
浪涛(1946),浪涛,notion,0,1,1,0,1,1,0.003608,4,0.255568,0.260842,0
浪潮(1946),浪潮,notion,0,1,1,0,1,1,0.013378,4,0.272039,0.290456,0
浪费(1946),浪费,notion,0,2,2,0,2,2,0.014214,4,0.272194,0.29079,872.497436
浮雕(1946),浮雕,notion,0,1,1,0,1,1,0.018893,4,0.282798,0.307938,0
海关(1946),海关,notion,0,1,1,0,1,1,0.007159,4,0.261235,0.271453,0
海南(1946),海南,notion,0,1,1,0,1,1,0.004479,4,0.256686,0.262973,0
海峡(1946),海峡,notion,0,2,2,0,2,2,0.02853,4,0.295746,0.327361,1236.887723
海德公园(1946),海德公园,notion,0,1,1,0,1,1,0.003608,4,0.255568,0.260842,0
海战(1946),海战,notion,0,1,1,0,1,1,0.018893,4,0.282798,0.307938,0
海燕(1946),海燕,notion,0,1,1,0,2,2,0.013103,4,0.272684,0.291543,0
海防(1946),海防,notion,0,1,1,0,1,1,0.013634,4,0.273332,0.292631,0
海陆空(1946),海陆空,notion,0,1,1,0,1,1,0.009637,4,0.265506,0.27915,0
消息(1946),消息,notion,0,1,1,0,1,1,0.00826,4,0.264992,0.278237,0
消灭(1946),消灭,notion,0,3,3,0,3,3,0.023362,4,0.285551,0.312344,2108.642616
消长(1946),消长,notion,0,1,1,0,1,1,0.004577,4,0.257676,0.264843,0
消除(1946),消除,notion,0,1,1,0,1,1,0.009637,4,0.265506,0.27915,0
涌起(1946),涌起,notion,0,1,1,0,1,1,0.013378,4,0.272039,0.290456,0
淡菜(1946),淡菜,notion,0,1,1,0,1,1,0.005304,4,0.259537,0.268322,0
淮阴(1946),淮阴,notion,0,1,1,0,1,1,0.013634,4,0.273332,0.292631,0
深入(1946),深入,notion,0,3,3,0,3,3,0.026097,4,0.292169,0.322259,4144.547984
深刻(1946),深刻,notion,0,2,2,0,2,2,0.018407,4,0.281634,0.306184,1780.990245
深化(1946),深化,notion,0,1,1,0,1,1,0.018893,4,0.282798,0.307938,0
深圳(1946),深圳,notion,0,1,1,0,1,1,0.00826,4,0.264992,0.278237,0
深渊(1946),深渊,notion,0,1,1,0,1,1,0.013378,4,0.272039,0.290456,0
深闺(1946),深闺,notion,0,1,1,0,1,1,0.013634,4,0.273332,0.292631,0
混为一谈(1946),混为一谈,notion,0,1,1,0,1,1,0.017626,4,0.281496,0.305894,0
混乱(1946),混乱,notion,0,3,3,0,3,3,0.045374,4,0.322561,0.36257,4563.560502
混淆(1946),混淆,notion,0,1,1,0,1,1,0.004237,4,0.256206,0.26206,0
淹没(1946),淹没,notion,0,1,1,0,1,1,0.00826,4,0.264992,0.278237,0
清乡(1946),清乡,notion,0,2,2,0,2,2,0.031004,4,0.302277,0.336493,1833.728143
清代(1946),清代,notion,0,1,1,0,1,1,0.017626,4,0.281496,0.305894,0
清凉(1946),清凉,notion,0,1,1,0,1,1,0.009637,4,0.265506,0.27915,0
清出(1946),清出,notion,0,1,1,0,1,1,0.017626,4,0.281496,0.305894,0
清政府(1946),清政府,notion,0,1,1,0,1,1,0.013103,4,0.272684,0.291543,0
清晨(1946),清晨,notion,0,1,1,0,1,1,0.013378,4,0.272039,0.290456,0
清末(1946),清末,notion,0,1,1,0,1,1,0.004479,4,0.256686,0.262973,0
清查(1946),清查,notion,0,2,2,0,3,3,0.036519,4,0.313896,0.3518,2490.161613
清正(1946),清正,notion,0,1,1,0,1,1,0.004479,4,0.256686,0.262973,0
清算(1946),清算,notion,0,2,2,0,2,2,0.023015,4,0.2849,0.311272,897.577022
清脆(1946),清脆,notion,0,1,1,0,1,1,0.018893,4,0.282798,0.307938,0
清议(1946),清议,notion,0,1,1,0,1,1,0.018893,4,0.282798,0.307938,0
清谈(1946),清谈,notion,0,1,1,0,1,1,0.018893,4,0.282798,0.307938,0
清醒(1946),清醒,notion,0,1,1,0,2,2,0.005304,4,0.259537,0.268322,0
清除(1946),清除,notion,0,2,2,0,2,2,0.023088,4,0.287867,0.315794,912.175655
渊源(1946),渊源,notion,0,1,1,0,1,1,0.005461,4,0.25793,0.265322,0
渐趋(1946),渐趋,notion,0,1,1,0,1,1,0.007159,4,0.261235,0.271453,0
渔家(1946),渔家,notion,0,1,1,0,1,1,0.00826,4,0.264992,0.278237,0
渡过(1946),渡过,notion,0,1,1,0,1,1,0.007159,4,0.261235,0.271453,0
温和(1946),温和,notion,0,1,1,0,1,1,0.013103,4,0.272684,0.291543,0
温情(1946),温情,notion,0,1,1,0,1,1,0.013634,4,0.273332,0.292631,0
温故知新(1946),温故知新,notion,0,1,1,0,1,1,0.007159,4,0.261235,0.271453,0
温暖(1946),温暖,notion,0,1,1,0,1,1,0.004564,4,0.256755,0.263104,0
温泉(1946),温泉,notion,0,1,1,0,1,1,0.017626,4,0.281496,0.305894,0
港九(1946),港九,notion,0,1,1,0,1,1,0.00826,4,0.264992,0.278237,0
港星(1946),港星,notion,0,1,1,0,1,1,0.00826,4,0.264992,0.278237,0
渴望(1946),渴望,notion,0,1,1,0,1,1,0.0031,4,0.254504,0.258799,0
游行(1946),游行,notion,0,4,4,0,5,5,0.050141,4,0.325889,0.3666,5807.577961
游行示威(1946),游行示威,notion,0,1,1,0,1,1,0.004237,4,0.256206,0.26206,0
游街(1946),游街,notion,0,1,1,0,1,1,0.013103,4,0.272684,0.291543,0
湄南(1946),湄南,notion,0,1,1,0,1,1,0.00826,4,0.264992,0.278237,0
湖上(1946),湖上,notion,0,1,1,0,1,1,0.004577,4,0.257676,0.264843,0
湖北(1946),湖北,notion,0,1,1,0,1,1,0.017626,4,0.281496,0.305894,0
湖匪(1946),湖匪,notion,0,1,1,0,1,1,0.013634,4,0.273332,0.292631,0
湖南(1946),湖南,notion,0,1,1,0,1,1,0.017626,4,0.281496,0.305894,0
湖南省(1946),湖南省,notion,0,1,1,0,1,1,0.018893,4,0.282798,0.307938,0
湘南(1946),湘南,notion,0,1,1,0,1,1,0.018893,4,0.282798,0.307938,0
湘西(1946),湘西,notion,0,2,2,0,2,2,0.02347,4,0.289958,0.318925,1721.315005
源泉(1946),源泉,notion,0,1,1,0,1,1,0.001496,4,0.252204,0.25432,0
源流(1946),源流,notion,0,1,1,0,1,1,0.018893,4,0.282798,0.307938,0
溪边(1946),溪边,notion,0,1,1,0,1,1,0.005304,4,0.259537,0.268322,0
滋味(1946),滋味,notion,0,1,1,0,1,1,0.013634,4,0.273332,0.292631,0
滑稽(1946),滑稽,notion,0,1,1,0,1,1,0.004479,4,0.256686,0.262973,0
满天飞(1946),满天飞,notion,0,1,1,0,1,1,0.018893,4,0.282798,0.307938,0
满江红(1946),满江红,notion,0,1,1,0,1,1,0.003608,4,0.255568,0.260842,0
滥用(1946),滥用,notion,0,1,1,0,1,1,0.013378,4,0.272039,0.290456,0
滴滴涕(1946),滴滴涕,notion,0,1,1,0,1,1,0.013634,4,0.273332,0.292631,0
漂亮(1946),漂亮,notion,0,1,1,0,1,1,0.004237,4,0.256206,0.26206,0
漏网(1946),漏网,notion,0,1,1,0,1,1,0.013634,4,0.273332,0.292631,0
演不完(1946),演不完,notion,0,1,1,0,1,1,0.004479,4,0.256686,0.262973,0
演出(1946),演出,notion,0,3,3,0,3,3,0.023362,4,0.285551,0.312344,2108.642616
演剧(1946),演剧,notion,0,1,1,0,1,1,0.013634,4,0.273332,0.292631,0
演变(1946),演变,notion,0,1,1,0,2,2,0.017626,4,0.281496,0.305894,0
演员(1946),演员,notion,0,1,1,0,1,1,0.013634,4,0.273332,0.292631,0
演奏(1946),演奏,notion,0,1,1,0,1,1,0.013103,4,0.272684,0.291543,0
演讲(1946),演讲,notion,0,2,2,0,2,2,0.022106,4,0.287091,0.31462,1089.539125
演讲稿(1946),演讲稿,notion,0,1,1,0,1,1,0.009637,4,0.265506,0.27915,0
演讲词(1946),演讲词,notion,0,1,1,0,1,1,0.009637,4,0.265506,0.27915,0
漫天(1946),漫天,notion,0,1,1,0,1,1,0.004564,4,0.256755,0.263104,0
漫忆(1946),漫忆,notion,0,2,2,0,2,2,0.013564,4,0.274324,0.294356,2085.288442
漫谭(1946),漫谭,notion,0,1,1,0,1,1,0.017626,4,0.281496,0.305894,0
潮流(1946),潮流,notion,0,2,2,0,2,2,0.012837,4,0.272632,0.291529,2112.615352
潮浪(1946),潮浪,notion,0,1,1,0,1,1,0.013378,4,0.272039,0.290456,0
澈底(1946),澈底,notion,0,4,4,0,5,5,0.039822,4,0.312939,0.350728,5476.506654
激动(1946),激动,notion,0,1,1,0,1,1,0.018893,4,0.282798,0.307938,0
激盪(1946),激盪,notion,0,1,1,0,1,1,0.017626,4,0.281496,0.305894,0
激荡(1946),激荡,notion,0,1,1,0,1,1,0.009637,4,0.265506,0.27915,0
灌县(1946),灌县,notion,0,1,1,0,1,1,0.017626,4,0.281496,0.305894,0
火山(1946),火山,notion,0,2,2,0,2,2,0.01734,4,0.277877,0.300183,713.880954
火急(1946),火急,notion,0,1,1,0,1,1,0.00826,4,0.264992,0.278237,0
火把节(1946),火把节,notion,0,1,1,0,1,1,0.017626,4,0.281496,0.305894,0
火气(1946),火气,notion,0,1,1,0,1,1,0.007159,4,0.261235,0.271453,0
火炬(1946),火炬,notion,0,1,1,0,1,1,0.013634,4,0.273332,0.292631,0
火线(1946),火线,notion,0,1,1,0,1,1,0.018893,4,0.282798,0.307938,0
火药(1946),火药,notion,0,1,1,0,1,1,0.013378,4,0.272039,0.290456,0
火药库(1946),火药库,notion,0,1,1,0,1,1,0.017626,4,0.281496,0.305894,0
火葬(1946),火葬,notion,0,1,1,0,1,1,0.013634,4,0.273332,0.292631,0
灭星(1946),灭星,notion,0,1,1,0,1,1,0.017626,4,0.281496,0.305894,0
灾害(1946),灾害,notion,0,1,1,0,2,2,0.018893,4,0.282798,0.307938,0
灾民(1946),灾民,notion,0,1,1,0,1,1,0.013378,4,0.272039,0.290456,0
灾荒(1946),灾荒,notion,0,3,3,0,3,3,0.02585,4,0.290192,0.319345,1731.819358
灾难(1946),灾难,notion,0,4,4,0,4,4,0.031336,4,0.296172,0.328115,4478.715837
灾黎(1946),灾黎,notion,0,1,1,0,1,1,0.003608,4,0.255568,0.260842,0
炬火(1946),炬火,notion,0,1,1,0,1,1,0.013103,4,0.272684,0.291543,0
炮声(1946),炮声,notion,0,1,1,0,1,1,0.00826,4,0.264992,0.278237,0
炮火(1946),炮火,notion,0,1,1,0,1,1,0.018893,4,0.282798,0.307938,0
炸弹(1946),炸弹,notion,0,3,3,0,3,3,0.028649,4,0.298231,0.330956,3389.954475
点滴(1946),点滴,notion,0,1,1,0,1,1,0.0031,4,0.254504,0.258799,0
点点滴滴(1946),点点滴滴,notion,0,1,1,0,1,1,0.017626,4,0.281496,0.305894,0
烈士(1946),烈士,notion,0,2,2,0,3,3,0.026052,4,0.291576,0.321317,1054.556401
烟枪(1946),烟枪,notion,0,1,1,0,1,1,0.009637,4,0.265506,0.27915,0
烟莱道(1946),烟莱道,notion,0,1,1,0,1,1,0.018893,4,0.282798,0.307938,0
热情(1946),热情,notion,0,1,1,0,1,1,0.005304,4,0.259537,0.268322,0
热狂(1946),热狂,notion,0,1,1,0,1,1,0.00826,4,0.264992,0.278237,0
焦急(1946),焦急,notion,0,1,1,0,1,1,0.009637,4,0.265506,0.27915,0
焦点(1946),焦点,notion,0,1,1,0,1,1,0.013103,4,0.272684,0.291543,0
焦虑(1946),焦虑,notion,0,1,1,0,1,1,0.005304,4,0.259537,0.268322,0
煎迫(1946),煎迫,notion,0,1,1,0,1,1,0.004479,4,0.256686,0.262973,0
煞有介事(1946),煞有介事,notion,0,1,1,0,1,1,0.018893,4,0.282798,0.307938,0
照临(1946),照临,notion,0,1,1,0,1,1,0.018893,4,0.282798,0.307938,0
照登(1946),照登,notion,0,1,1,0,1,1,0.017626,4,0.281496,0.305894,0
照镜子(1946),照镜子,notion,0,1,1,0,1,1,0.009637,4,0.265506,0.27915,0
照顾(1946),照顾,notion,0,1,1,0,2,2,0.007159,4,0.261235,0.271453,0
熊猫(1946),熊猫,notion,0,1,1,0,1,1,0.018893,4,0.282798,0.307938,0
爆发(1946),爆发,notion,0,3,3,0,4,4,0.036508,4,0.305457,0.340871,2496.840707
爱人(1946),爱人,notion,0,1,1,0,1,1,0.018893,4,0.282798,0.307938,0
爱国(1946),爱国,notion,0,3,3,0,3,3,0.03139,4,0.301358,0.335305,3453.470743
爱国主义(1946),爱国主义,notion,0,1,1,0,1,1,0.00826,4,0.264992,0.278237,0
爱国主义者(1946),爱国主义者,notion,0,1,1,0,1,1,0.005461,4,0.25793,0.265322,0
爱国者(1946),爱国者,notion,0,2,2,0,2,2,0.017857,4,0.277314,0.299269,662.879703
爱好(1946),爱好,notion,0,2,2,0,2,2,0.024785,4,0.291398,0.321056,1410.74284
爱好和平(1946),爱好和平,notion,0,1,1,0,1,1,0.007159,4,0.261235,0.271453,0
爱好者(1946),爱好者,notion,0,2,2,0,2,2,0.02219,4,0.287062,0.314576,1087.606545
爱憎(1946),爱憎,notion,0,2,2,0,2,2,0.030729,4,0.302946,0.337407,2092.27198
爱护(1946),爱护,notion,0,1,1,0,1,1,0.018893,4,0.282798,0.307938,0
爱敬(1946),爱敬,notion,0,1,1,0,1,1,0.013634,4,0.273332,0.292631,0
爱着(1946),爱着,notion,0,1,1,0,1,1,0.013103,4,0.272684,0.291543,0
爱祖国(1946),爱祖国,notion,0,1,1,0,1,1,0.00826,4,0.264992,0.278237,0
父子(1946),父子,notion,0,2,2,0,2,2,0.03126,4,0.304035,0.338885,2199.499867
父老(1946),父老,notion,0,1,1,0,1,1,0.013634,4,0.273332,0.292631,0
片段(1946),片段,notion,0,1,1,0,4,4,0.005304,4,0.259537,0.268322,0
片面(1946),片面,notion,0,1,1,0,1,1,0.003608,4,0.255568,0.260842,0
版界(1946),版界,notion,0,1,1,0,1,1,0.013378,4,0.272039,0.290456,0
牌图(1946),牌图,notion,0,1,1,0,1,1,0.013378,4,0.272039,0.290456,0
牛羊(1946),牛羊,notion,0,1,1,0,1,1,0.004564,4,0.256755,0.263104,0
牛肉(1946),牛肉,notion,0,1,1,0,1,1,0.00826,4,0.264992,0.278237,0
牛郎织女(1946),牛郎织女,notion,0,1,1,0,1,1,0.004577,4,0.257676,0.264843,0
牧合译(1946),牧合译,notion,0,1,1,0,1,1,0.013378,4,0.272039,0.290456,0
物以类聚(1946),物以类聚,notion,0,1,1,0,1,1,0.013378,4,0.272039,0.290456,0
物臭(1946),物臭,notion,0,1,1,0,1,1,0.013634,4,0.273332,0.292631,0
物质(1946),物质,notion,0,1,1,0,1,1,0.013103,4,0.272684,0.291543,0
牯岭(1946),牯岭,notion,0,2,2,0,2,2,0.018407,4,0.281634,0.306184,1780.990245
特使(1946),特使,notion,0,3,3,0,4,4,0.036465,4,0.30801,0.344263,3283.387915
特别(1946),特别,notion,0,1,1,0,1,1,0.013378,4,0.272039,0.290456,0
特点(1946),特点,notion,0,1,1,0,1,1,0.00826,4,0.264992,0.278237,0
特种(1946),特种,notion,0,1,1,0,1,1,0.004237,4,0.256206,0.26206,0
特约(1946),特约,notion,0,1,1,0,1,1,0.00826,4,0.264992,0.278237,0
特质(1946),特质,notion,0,3,3,0,3,3,0.049897,4,0.333295,0.375051,5595.386463
犯人(1946),犯人,notion,0,1,1,0,1,1,0.007159,4,0.261235,0.271453,0
犹太人(1946),犹太人,notion,0,1,1,0,1,1,0.009637,4,0.265506,0.27915,0
犹里(1946),犹里,notion,0,1,1,0,1,1,0.013103,4,0.272684,0.291543,0
狂涨(1946),狂涨,notion,0,1,1,0,1,1,0.004237,4,0.256206,0.26206,0
狂潮(1946),狂潮,notion,0,2,2,0,2,2,0.027153,4,0.296784,0.32884,1981.441549
狄托(1946),狄托,notion,0,1,1,0,1,1,0.018893,4,0.282798,0.307938,0
狐狸(1946),狐狸,notion,0,1,1,0,1,1,0.018893,4,0.282798,0.307938,0
狙案(1946),狙案,notion,0,1,1,0,1,1,0.013634,4,0.273332,0.292631,0
狠话(1946),狠话,notion,0,1,1,0,1,1,0.009637,4,0.265506,0.27915,0
独占(1946),独占,notion,0,4,4,0,5,5,0.053634,4,0.338236,0.380602,10386.577965
独唱(1946),独唱,notion,0,1,1,0,1,1,0.018893,4,0.282798,0.307938,0
独幕(1946),独幕,notion,0,1,1,0,1,1,0.007159,4,0.261235,0.271453,0
独断(1946),独断,notion,0,1,1,0,1,1,0.013634,4,0.273332,0.292631,0
独裁(1946),独裁,notion,0,4,4,0,4,4,0.036196,4,0.306532,0.342378,5705.927604
狱中(1946),狱中,notion,0,1,1,0,1,1,0.013634,4,0.273332,0.292631,0
猜忌(1946),猜忌,notion,0,1,1,0,1,1,0.009637,4,0.265506,0.27915,0
猪猡(1946),猪猡,notion,0,1,1,0,1,1,0.013634,4,0.273332,0.292631,0
猫腻(1946),猫腻,notion,0,1,1,0,1,1,0.00826,4,0.264992,0.278237,0
玄武湖(1946),玄武湖,notion,0,1,1,0,1,1,0.004577,4,0.257676,0.264843,0
玄黄(1946),玄黄,notion,0,1,1,0,1,1,0.018893,4,0.282798,0.307938,0
玉门关(1946),玉门关,notion,0,1,1,0,1,1,0.017626,4,0.281496,0.305894,0
玉阶(1946),玉阶,notion,0,1,1,0,1,1,0.00826,4,0.264992,0.278237,0
王小二(1946),王小二,notion,0,1,1,0,1,1,0.018893,4,0.282798,0.307938,0
王座(1946),王座,notion,0,1,1,0,1,1,0.007159,4,0.261235,0.271453,0
王牌(1946),王牌,notion,0,1,1,0,1,1,0.018893,4,0.282798,0.307938,0
王秦(1946),王秦,notion,0,1,1,0,1,1,0.013378,4,0.272039,0.290456,0
王芸生(1946),王芸生,notion,0,2,2,0,2,2,0.032527,4,0.303393,0.338015,1614.891208
王若飞(1946),王若飞,notion,0,1,1,0,1,1,0.001496,4,0.252204,0.25432,0
玩具(1946),玩具,notion,0,1,1,0,1,1,0.013378,4,0.272039,0.290456,0
玩手段(1946),玩手段,notion,0,1,1,0,1,1,0.013378,4,0.272039,0.290456,0
玩法(1946),玩法,notion,0,1,1,0,1,1,0.013378,4,0.272039,0.290456,0
玫瑰花(1946),玫瑰花,notion,0,1,1,0,2,2,0.018893,4,0.282798,0.307938,0
环境(1946),环境,notion,0,2,2,0,2,2,0.008912,4,0.264602,0.277613,868.763301
环绕(1946),环绕,notion,0,3,3,0,3,3,0.036559,4,0.309069,0.345654,3546.560838
环绕着(1946),环绕着,notion,0,1,1,0,1,1,0.013634,4,0.273332,0.292631,0
现代(1946),现代,notion,0,2,2,0,3,3,0.03126,4,0.304035,0.338885,2199.499867
现代化(1946),现代化,notion,0,1,1,0,1,1,0.013634,4,0.273332,0.292631,0
现势(1946),现势,notion,0,4,4,0,4,4,0.044594,4,0.319052,0.358381,6769.5216
现实主义(1946),现实主义,notion,0,2,2,0,2,2,0.030729,4,0.302946,0.337407,2092.27198
现局(1946),现局,notion,0,1,1,0,1,1,0.013634,4,0.273332,0.292631,0
现状(1946),现状,notion,0,5,5,0,6,6,0.036366,4,0.30768,0.343973,11039.481774
现状及(1946),现状及,notion,0,1,1,0,1,1,0.018893,4,0.282798,0.307938,0
现相(1946),现相,notion,0,1,1,0,1,1,0.00826,4,0.264992,0.278237,0
现象(1946),现象,notion,0,2,2,0,3,3,0.032271,4,0.301168,0.334971,1271.496707
现阶段(1946),现阶段,notion,0,3,3,0,3,3,0.041083,4,0.319158,0.358439,4458.909627
珊瑚(1946),珊瑚,notion,0,1,1,0,1,1,0.009637,4,0.265506,0.27915,0
珊瑚岛(1946),珊瑚岛,notion,0,1,1,0,1,1,0.018893,4,0.282798,0.307938,0
珍珠港(1946),珍珠港,notion,0,1,1,0,1,1,0.017626,4,0.281496,0.305894,0
珍贵(1946),珍贵,notion,0,1,1,0,1,1,0.017626,4,0.281496,0.305894,0
珠江(1946),珠江,notion,0,2,2,0,2,2,0.025886,4,0.296968,0.329101,2935.752997
理学(1946),理学,notion,0,1,1,0,1,1,0.004577,4,0.257676,0.264843,0
理想(1946),理想,notion,0,5,5,0,10,10,0.059049,4,0.347477,0.390503,15751.900813
理想主义(1946),理想主义,notion,0,1,1,0,1,1,0.017626,4,0.281496,0.305894,0
理智(1946),理智,notion,0,1,1,0,1,1,0.003608,4,0.255568,0.260842,0
理由(1946),理由,notion,0,2,2,0,2,2,0.021864,4,0.286576,0.313837,872.776367
理解(1946),理解,notion,0,2,2,0,4,4,0.018938,4,0.282437,0.307445,1861.68946
理论(1946),理论,notion,0,2,2,0,2,2,0.018682,4,0.280974,0.30514,1561.099535
琐谈(1946),琐谈,notion,0,1,1,0,1,1,0.00826,4,0.264992,0.278237,0
琼崖(1946),琼崖,notion,0,1,1,0,4,4,0.00826,4,0.264992,0.278237,0
瓦砾(1946),瓦砾,notion,0,1,1,0,1,1,0.018893,4,0.282798,0.307938,0
生产(1946),生产,notion,0,3,3,0,3,3,0.022546,4,0.287091,0.314692,3735.726968
生前(1946),生前,notion,0,1,1,0,1,1,0.018893,4,0.282798,0.307938,0
生吞(1946),生吞,notion,0,1,1,0,1,1,0.00826,4,0.264992,0.278237,0
生命(1946),生命,notion,0,1,1,0,1,1,0.013634,4,0.273332,0.292631,0
生意(1946),生意,notion,0,1,1,0,2,2,0.004479,4,0.256686,0.262973,0
生活态度(1946),生活态度,notion,0,1,1,0,1,1,0.004479,4,0.256686,0.262973,0
生涯(1946),生涯,notion,0,2,2,0,2,2,0.032527,4,0.303393,0.338015,1614.891208
生育(1946),生育,notion,0,1,1,0,1,1,0.004577,4,0.257676,0.264843,0
生路(1946),生路,notion,0,1,1,0,1,1,0.013378,4,0.272039,0.290456,0
用不着(1946),用不着,notion,0,1,1,0,1,1,0.003608,4,0.255568,0.260842,0
用力(1946),用力,notion,0,1,1,0,1,1,0.005304,4,0.259537,0.268322,0
用处(1946),用处,notion,0,1,1,0,1,1,0.004479,4,0.256686,0.262973,0
用尽方法(1946),用尽方法,notion,0,1,1,0,1,1,0.00826,4,0.264992,0.278237,0
用意(1946),用意,notion,0,1,1,0,1,1,0.009637,4,0.265506,0.27915,0
田制(1946),田制,notion,0,1,1,0,1,1,0.017626,4,0.281496,0.305894,0
田宅(1946),田宅,notion,0,1,1,0,1,1,0.004577,4,0.257676,0.264843,0
田汉(1946),田汉,notion,0,2,2,0,2,2,0.022501,4,0.28712,0.314663,997.953629
田赋(1946),田赋,notion,0,4,4,0,5,5,0.048242,4,0.328721,0.369905,7396.710782
由八(1946),由八,notion,0,1,1,0,1,1,0.009637,4,0.265506,0.27915,0
由族(1946),由族,notion,0,1,1,0,1,1,0.017626,4,0.281496,0.305894,0
由来(1946),由来,notion,0,2,2,0,2,2,0.036519,4,0.313896,0.3518,2490.161613
由衷(1946),由衷,notion,0,1,1,0,1,1,0.013378,4,0.272039,0.290456,0
申报(1946),申报,notion,0,1,1,0,1,1,0.009637,4,0.265506,0.27915,0
申斥(1946),申斥,notion,0,1,1,0,1,1,0.00826,4,0.264992,0.278237,0
申明(1946),申明,notion,0,1,1,0,1,1,0.013378,4,0.272039,0.290456,0
申论(1946),申论,notion,0,1,1,0,1,1,0.017626,4,0.281496,0.305894,0
申诉(1946),申诉,notion,0,1,1,0,1,1,0.013378,4,0.272039,0.290456,0
电影(1946),电影,notion,0,1,1,0,1,1,0.013634,4,0.273332,0.292631,0
电流(1946),电流,notion,0,1,1,0,1,1,0.004577,4,0.257676,0.264843,0
男女之间(1946),男女之间,notion,0,1,1,0,1,1,0.013634,4,0.273332,0.292631,0
画谱(1946),画谱,notion,0,1,1,0,1,1,0.013103,4,0.272684,0.291543,0
留在(1946),留在,notion,0,1,1,0,1,1,0.018893,4,0.282798,0.307938,0
留学(1946),留学,notion,0,1,1,0,1,1,0.004577,4,0.257676,0.264843,0
留学生(1946),留学生,notion,0,2,2,0,2,2,0.014214,4,0.272194,0.29079,872.497436
留恋(1946),留恋,notion,0,1,1,0,1,1,0.018893,4,0.282798,0.307938,0
留粤记(1946),留粤记,notion,0,1,1,0,1,1,0.018893,4,0.282798,0.307938,0
畜者(1946),畜者,notion,0,1,1,0,1,1,0.018893,4,0.282798,0.307938,0
略谈(1946),略谈,notion,0,3,3,0,3,3,0.0251,4,0.285778,0.312692,1844.866426
畲儿(1946),畲儿,notion,0,1,1,0,1,1,0.018893,4,0.282798,0.307938,0
疆界(1946),疆界,notion,0,1,1,0,1,1,0.013103,4,0.272684,0.291543,0
疗养院(1946),疗养院,notion,0,1,1,0,1,1,0.013103,4,0.272684,0.291543,0
疯人(1946),疯人,notion,0,1,1,0,1,1,0.003608,4,0.255568,0.260842,0
疯狂(1946),疯狂,notion,0,1,1,0,2,2,0.00826,4,0.264992,0.278237,0
疾苦(1946),疾苦,notion,0,1,1,0,1,1,0.017626,4,0.281496,0.305894,0
病情(1946),病情,notion,0,1,1,0,1,1,0.013634,4,0.273332,0.292631,0
病根(1946),病根,notion,0,1,1,0,1,1,0.013378,4,0.272039,0.290456,0
病院(1946),病院,notion,0,1,1,0,1,1,0.005304,4,0.259537,0.268322,0
症结(1946),症结,notion,0,4,4,0,6,6,0.049067,4,0.322778,0.362904,5974.893534
症结所在(1946),症结所在,notion,0,1,1,0,1,1,0.013634,4,0.273332,0.292631,0
痊愈(1946),痊愈,notion,0,1,1,0,1,1,0.013103,4,0.272684,0.291543,0
痛哭(1946),痛哭,notion,0,1,1,0,1,1,0.018893,4,0.282798,0.307938,0
痛痒相关(1946),痛痒相关,notion,0,1,1,0,1,1,0.005304,4,0.259537,0.268322,0
痛苦(1946),痛苦,notion,0,2,2,0,2,2,0.020727,4,0.284759,0.311054,789.620977
痨病(1946),痨病,notion,0,1,1,0,1,1,0.017626,4,0.281496,0.305894,0
癌症(1946),癌症,notion,0,1,1,0,1,1,0.004577,4,0.257676,0.264843,0
登岸(1946),登岸,notion,0,1,1,0,1,1,0.005304,4,0.259537,0.268322,0
登扫(1946),登扫,notion,0,1,1,0,1,1,0.017626,4,0.281496,0.305894,0
登记(1946),登记,notion,0,2,2,0,2,2,0.02313,4,0.287378,0.315055,697.222
登错(1946),登错,notion,0,1,1,0,1,1,0.00826,4,0.264992,0.278237,0
白崇禧(1946),白崇禧,notion,0,1,1,0,1,1,0.018893,4,0.282798,0.307938,0
白旗(1946),白旗,notion,0,1,1,0,1,1,0.001496,4,0.252204,0.25432,0
白沙镇(1946),白沙镇,notion,0,1,1,0,1,1,0.003608,4,0.255568,0.260842,0
百万(1946),百万,notion,0,1,1,0,1,1,0.018893,4,0.282798,0.307938,0
百岁(1946),百岁,notion,0,1,1,0,1,1,0.017626,4,0.281496,0.305894,0
的事(1946),的事,notion,0,2,2,0,2,2,0.018407,4,0.281634,0.306184,1780.990245
的人(1946),的人,notion,0,1,1,0,1,1,0.013103,4,0.272684,0.291543,0
的士(1946),的士,notion,0,1,1,0,1,1,0.017626,4,0.281496,0.305894,0
的病(1946),的病,notion,0,1,1,0,1,1,0.017626,4,0.281496,0.305894,0
的话(1946),的话,notion,0,5,5,0,5,5,0.057542,4,0.335512,0.377674,9608.420256
皆曰(1946),皆曰,notion,0,1,1,0,1,1,0.013103,4,0.272684,0.291543,0
皇帝(1946),皇帝,notion,0,2,2,0,2,2,0.031004,4,0.302277,0.336493,1833.728143
皮杜尔(1946),皮杜尔,notion,0,1,1,0,1,1,0.013634,4,0.273332,0.292631,0
监察(1946),监察,notion,0,1,1,0,1,1,0.017626,4,0.281496,0.305894,0
盖世太保(1946),盖世太保,notion,0,1,1,0,1,1,0.013634,4,0.273332,0.292631,0
盛世才(1946),盛世才,notion,0,1,1,0,1,1,0.013634,4,0.273332,0.292631,0
盟友(1946),盟友,notion,0,1,1,0,1,1,0.00826,4,0.264992,0.278237,0
盟国(1946),盟国,notion,0,1,1,0,3,3,0.013103,4,0.272684,0.291543,0
目光(1946),目光,notion,0,1,1,0,1,1,0.017626,4,0.281496,0.305894,0
目击记(1946),目击记,notion,0,2,2,0,3,3,0.017871,4,0.277958,0.300313,580.923774
目前(1946),目前,notion,0,5,5,0,8,8,0.065316,4,0.35983,0.402853,16701.028357
目无法纪(1946),目无法纪,notion,0,1,1,0,1,1,0.013634,4,0.273332,0.292631,0
目标(1946),目标,notion,0,3,3,0,5,5,0.045904,4,0.321478,0.361266,4001.310187
目的(1946),目的,notion,0,2,2,0,2,2,0.013564,4,0.274324,0.294356,2085.288442
目睹(1946),目睹,notion,0,1,1,0,1,1,0.013634,4,0.273332,0.292631,0
盲人(1946),盲人,notion,0,1,1,0,1,1,0.017626,4,0.281496,0.305894,0
直接(1946),直接,notion,0,1,1,0,1,1,0.009637,4,0.265506,0.27915,0
直接税(1946),直接税,notion,0,1,1,0,1,1,0.017626,4,0.281496,0.305894,0
相处(1946),相处,notion,0,1,1,0,1,1,0.017626,4,0.281496,0.305894,0
相当严重(1946),相当严重,notion,0,1,1,0,1,1,0.017626,4,0.281496,0.305894,0
相片(1946),相片,notion,0,1,1,0,1,1,0.013103,4,0.272684,0.291543,0
相辅而行(1946),相辅而行,notion,0,1,1,0,1,1,0.017626,4,0.281496,0.305894,0
省县(1946),省县,notion,0,1,1,0,1,1,0.017626,4,0.281496,0.305894,0
看了(1946),看了,notion,0,1,1,0,1,1,0.007159,4,0.261235,0.271453,0
看做(1946),看做,notion,0,2,2,0,2,2,0.027011,4,0.292079,0.322056,1114.922273
看向(1946),看向,notion,0,1,1,0,1,1,0.005304,4,0.259537,0.268322,0
看报(1946),看报,notion,0,1,1,0,1,1,0.017626,4,0.281496,0.305894,0
看杂誌(1946),看杂誌,notion,0,1,1,0,1,1,0.017626,4,0.281496,0.305894,0
看法(1946),看法,notion,0,5,5,0,8,8,0.058512,4,0.341613,0.384328,11066.226111
看看(1946),看看,notion,0,2,2,0,2,2,0.026481,4,0.292853,0.323187,1408.34579
看着(1946),看着,notion,0,1,1,0,1,1,0.013378,4,0.272039,0.290456,0
看轻(1946),看轻,notion,0,1,1,0,1,1,0.013378,4,0.272039,0.290456,0
看齐(1946),看齐,notion,0,1,1,0,1,1,0.00826,4,0.264992,0.278237,0
真假(1946),真假,notion,0,2,2,0,2,2,0.014874,4,0.273619,0.293181,536.806795
真戏(1946),真戏,notion,0,1,1,0,1,1,0.0031,4,0.254504,0.258799,0
真是(1946),真是,notion,0,1,1,0,1,1,0.007159,4,0.261235,0.271453,0
真正(1946),真正,notion,0,4,4,0,4,4,0.04556,4,0.329097,0.37034,12195.017403
真理(1946),真理,notion,0,4,4,0,6,6,0.045419,4,0.323541,0.363817,9696.447519
真空(1946),真空,notion,0,1,1,0,1,1,0.013634,4,0.273332,0.292631,0
真谛(1946),真谛,notion,0,1,1,0,1,1,0.017626,4,0.281496,0.305894,0
真面目(1946),真面目,notion,0,1,1,0,1,1,0.013103,4,0.272684,0.291543,0
眼中(1946),眼中,notion,0,5,5,0,6,6,0.058665,4,0.347225,0.390242,12304.85163
眼光(1946),眼光,notion,0,1,1,0,1,1,0.0031,4,0.254504,0.258799,0
眼看(1946),眼看,notion,0,1,1,0,1,1,0.018893,4,0.282798,0.307938,0
眼睛(1946),眼睛,notion,0,3,3,0,3,3,0.013306,4,0.266886,0.28173,792.754289
着席(1946),着席,notion,0,1,1,0,1,1,0.004577,4,0.257676,0.264843,0
睁开眼睛(1946),睁开眼睛,notion,0,1,1,0,1,1,0.009637,4,0.265506,0.27915,0
睦谊(1946),睦谊,notion,0,1,1,0,1,1,0.013378,4,0.272039,0.290456,0
瞻望(1946),瞻望,notion,0,1,1,0,1,1,0.013634,4,0.273332,0.292631,0
矛盾(1946),矛盾,notion,0,7,7,0,8,8,0.077617,4,0.387008,0.427393,32730.194354
矛盾重重(1946),矛盾重重,notion,0,1,1,0,1,1,0.00826,4,0.264992,0.278237,0
矢誓(1946),矢誓,notion,0,1,1,0,1,1,0.005304,4,0.259537,0.268322,0
知之(1946),知之,notion,0,1,1,0,1,1,0.004577,4,0.257676,0.264843,0
知慧(1946),知慧,notion,0,1,1,0,1,1,0.009637,4,0.265506,0.27915,0
知识(1946),知识,notion,0,1,1,0,1,1,0.009637,4,0.265506,0.27915,0
知识份子(1946),知识份子,notion,0,2,2,0,2,2,0.027153,4,0.296784,0.32884,1981.441549
知识青年(1946),知识青年,notion,0,1,1,0,1,1,0.003608,4,0.255568,0.260842,0
短剧(1946),短剧,notion,0,1,1,0,1,1,0.003608,4,0.255568,0.260842,0
短期(1946),短期,notion,0,1,1,0,1,1,0.005461,4,0.25793,0.265322,0
短简(1946),短简,notion,0,1,1,0,1,1,0.017626,4,0.281496,0.305894,0
石东(1946),石东,notion,0,1,1,0,1,1,0.018893,4,0.282798,0.307938,0
石挥书(1946),石挥书,notion,0,1,1,0,1,1,0.013634,4,0.273332,0.292631,0
石沉大海(1946),石沉大海,notion,0,1,1,0,1,1,0.004237,4,0.256206,0.26206,0
石油(1946),石油,notion,0,1,1,0,1,1,0.009637,4,0.265506,0.27915,0
矿工(1946),矿工,notion,0,1,1,0,1,1,0.013103,4,0.272684,0.291543,0
码头(1946),码头,notion,0,1,1,0,1,1,0.018893,4,0.282798,0.307938,0
研究院(1946),研究院,notion,0,2,2,0,2,2,0.027264,4,0.294896,0.326144,1405.794223
破产(1946),破产,notion,0,2,2,0,2,2,0.032271,4,0.301168,0.334971,1271.496707
破坏(1946),破坏,notion,0,3,3,0,3,3,0.036191,4,0.309136,0.345741,3748.486132
确定(1946),确定,notion,0,1,1,0,1,1,0.007159,4,0.261235,0.271453,0
确立(1946),确立,notion,0,3,3,0,3,3,0.023202,4,0.289812,0.31878,5410.661361
碰壁(1946),碰壁,notion,0,1,1,0,1,1,0.00826,4,0.264992,0.278237,0
磨坊(1946),磨坊,notion,0,1,1,0,1,1,0.018893,4,0.282798,0.307938,0
礁石(1946),礁石,notion,0,1,1,0,1,1,0.007159,4,0.261235,0.271453,0
示威(1946),示威,notion,0,4,4,0,4,4,0.053889,4,0.342019,0.38469,11645.453176
礼物(1946),礼物,notion,0,1,1,0,2,2,0.013634,4,0.273332,0.292631,0
社会党(1946),社会党,notion,0,1,1,0,1,1,0.018893,4,0.282798,0.307938,0
社会化(1946),社会化,notion,0,1,1,0,1,1,0.017626,4,0.281496,0.305894,0
社会性(1946),社会性,notion,0,1,1,0,1,1,0.004577,4,0.257676,0.264843,0
社会福利(1946),社会福利,notion,0,1,1,0,1,1,0.017626,4,0.281496,0.305894,0
社会科学(1946),社会科学,notion,0,1,1,0,1,1,0.005304,4,0.259537,0.268322,0
社会观(1946),社会观,notion,0,2,2,0,2,2,0.019095,4,0.279064,0.302096,590.998645
社大(1946),社大,notion,0,1,1,0,1,1,0.013378,4,0.272039,0.290456,0
社长(1946),社长,notion,0,1,1,0,1,1,0.013103,4,0.272684,0.291543,0
祕史(1946),祕史,notion,0,1,1,0,1,1,0.017626,4,0.281496,0.305894,0
祖国(1946),祖国,notion,0,3,3,0,4,4,0.035307,4,0.309669,0.346437,4718.549721
祝玉阶(1946),祝玉阶,notion,0,1,1,0,1,1,0.00826,4,0.264992,0.278237,0
祝胜(1946),祝胜,notion,0,1,1,0,1,1,0.005304,4,0.259537,0.268322,0
祝词(1946),祝词,notion,0,1,1,0,1,1,0.00826,4,0.264992,0.278237,0
祝贺(1946),祝贺,notion,0,2,2,0,2,2,0.025886,4,0.296968,0.329101,2935.752997
神枪手(1946),神枪手,notion,0,1,1,0,1,1,0.00826,4,0.264992,0.278237,0
神灭论(1946),神灭论,notion,0,1,1,0,1,1,0.004564,4,0.256755,0.263104,0
祸不单行(1946),祸不单行,notion,0,1,1,0,1,1,0.00826,4,0.264992,0.278237,0
祸国殃民(1946),祸国殃民,notion,0,1,1,0,1,1,0.017626,4,0.281496,0.305894,0
禁娼(1946),禁娼,notion,0,1,1,0,1,1,0.017626,4,0.281496,0.305894,0
禁忌(1946),禁忌,notion,0,1,1,0,1,1,0.013634,4,0.273332,0.292631,0
禁毒(1946),禁毒,notion,0,1,1,0,1,1,0.013634,4,0.273332,0.292631,0
福利(1946),福利,notion,0,1,1,0,2,2,0.017626,4,0.281496,0.305894,0
福斯(1946),福斯,notion,0,3,3,0,4,4,0.032316,4,0.301294,0.335218,4537.711267
离京(1946),离京,notion,0,1,1,0,1,1,0.00826,4,0.264992,0.278237,0
离开(1946),离开,notion,0,3,3,0,3,3,0.031513,4,0.297552,0.329999,2268.160021
离愁(1946),离愁,notion,0,1,1,0,1,1,0.005461,4,0.25793,0.265322,0
秀才(1946),秀才,notion,0,2,2,0,2,2,0.022501,4,0.28712,0.314663,997.953629
秋天(1946),秋天,notion,0,1,1,0,1,1,0.004577,4,0.257676,0.264843,0
秋月(1946),秋月,notion,0,1,1,0,1,1,0.004577,4,0.257676,0.264843,0
秋水(1946),秋水,notion,0,1,1,0,1,1,0.009637,4,0.265506,0.27915,0
秋遊(1946),秋遊,notion,0,1,1,0,1,1,0.004577,4,0.257676,0.264843,0
种种(1946),种种,notion,0,3,3,0,6,6,0.042164,4,0.316662,0.355352,4082.320747
科学(1946),科学,notion,0,9,9,0,15,15,0.080217,4,0.377503,0.419406,31569.303421
科里(1946),科里,notion,0,1,1,0,1,1,0.013103,4,0.272684,0.291543,0
秘密文件(1946),秘密文件,notion,0,1,1,0,1,1,0.013378,4,0.272039,0.290456,0
秘记(1946),秘记,notion,0,1,1,0,1,1,0.013634,4,0.273332,0.292631,0
秘闻(1946),秘闻,notion,0,1,1,0,1,1,0.013634,4,0.273332,0.292631,0
租借(1946),租借,notion,0,1,1,0,1,1,0.013378,4,0.272039,0.290456,0
秦邦宪(1946),秦邦宪,notion,0,1,1,0,1,1,0.001496,4,0.252204,0.25432,0
秧歌剧(1946),秧歌剧,notion,0,2,2,0,2,2,0.027153,4,0.296784,0.32884,1981.441549
积极(1946),积极,notion,0,1,1,0,1,1,0.005304,4,0.259537,0.268322,0
稀疏(1946),稀疏,notion,0,1,1,0,1,1,0.013103,4,0.272684,0.291543,0
程序(1946),程序,notion,0,1,1,0,1,1,0.003608,4,0.255568,0.260842,0
程懋型(1946),程懋型,notion,0,1,1,0,1,1,0.018893,4,0.282798,0.307938,0
稍稍(1946),稍稍,notion,0,1,1,0,1,1,0.017626,4,0.281496,0.305894,0
税则(1946),税则,notion,0,1,1,0,1,1,0.007159,4,0.261235,0.271453,0
稳固(1946),稳固,notion,0,1,1,0,1,1,0.013103,4,0.272684,0.291543,0
稳定物价(1946),稳定物价,notion,0,1,1,0,1,1,0.017626,4,0.281496,0.305894,0
究竟(1946),究竟,notion,0,3,3,0,3,3,0.036834,4,0.305879,0.341436,2764.36269
空军(1946),空军,notion,0,3,3,0,3,3,0.039685,4,0.312463,0.350046,3732.208643
空前(1946),空前,notion,0,4,4,0,5,5,0.045576,4,0.319549,0.35899,6365.189539
空山(1946),空山,notion,0,1,1,0,1,1,0.018893,4,0.282798,0.307938,0
空想(1946),空想,notion,0,1,1,0,1,1,0.013103,4,0.272684,0.291543,0
空气(1946),空气,notion,0,2,2,0,2,2,0.031996,4,0.303907,0.338711,1883.718005
空洞(1946),空洞,notion,0,1,1,0,1,1,0.018893,4,0.282798,0.307938,0
空灵(1946),空灵,notion,0,1,1,0,1,1,0.004577,4,0.257676,0.264843,0
空白(1946),空白,notion,0,1,1,0,1,1,0.018893,4,0.282798,0.307938,0
突兀(1946),突兀,notion,0,1,1,0,1,1,0.005304,4,0.259537,0.268322,0
突变(1946),突变,notion,0,1,1,0,1,1,0.017626,4,0.281496,0.305894,0
突起(1946),突起,notion,0,1,1,0,1,1,0.017626,4,0.281496,0.305894,0
窒息(1946),窒息,notion,0,3,3,0,4,4,0.039685,4,0.312463,0.350046,3732.208643
窗子(1946),窗子,notion,0,1,1,0,1,1,0.007159,4,0.261235,0.271453,0
立刻(1946),立刻,notion,0,2,2,0,2,2,0.032271,4,0.301168,0.334971,1271.496707
立即(1946),立即,notion,0,2,2,0,2,2,0.023015,4,0.2849,0.311272,897.577022
立志(1946),立志,notion,0,1,1,0,1,1,0.004577,4,0.257676,0.264843,0
立此存照(1946),立此存照,notion,0,1,1,0,1,1,0.007159,4,0.261235,0.271453,0
立法院(1946),立法院,notion,0,2,2,0,2,2,0.02853,4,0.295746,0.327361,1236.887723
立鹤兄(1946),立鹤兄,notion,0,1,1,0,1,1,0.013378,4,0.272039,0.290456,0
竞争(1946),竞争,notion,0,2,2,0,2,2,0.027264,4,0.294896,0.326144,1405.794223
竞赛(1946),竞赛,notion,0,1,1,0,1,1,0.013103,4,0.272684,0.291543,0
竞选(1946),竞选,notion,0,2,2,0,2,2,0.031996,4,0.303907,0.338711,1883.718005
竟要(1946),竟要,notion,0,1,1,0,1,1,0.018893,4,0.282798,0.307938,0
章伯钧(1946),章伯钧,notion,0,1,1,0,1,1,0.018893,4,0.282798,0.307938,0
童子(1946),童子,notion,0,1,1,0,1,1,0.009637,4,0.265506,0.27915,0
童芷苓(1946),童芷苓,notion,0,1,1,0,1,1,0.013634,4,0.273332,0.292631,0
童谣(1946),童谣,notion,0,1,1,0,1,1,0.003608,4,0.255568,0.260842,0
笑话(1946),笑话,notion,0,1,1,0,1,1,0.013634,4,0.273332,0.292631,0
笑里藏刀(1946),笑里藏刀,notion,0,1,1,0,1,1,0.007159,4,0.261235,0.271453,0
笔战(1946),笔战,notion,0,1,1,0,1,1,0.018893,4,0.282798,0.307938,0
笔来(1946),笔来,notion,0,1,1,0,1,1,0.017626,4,0.281496,0.305894,0
第一(1946),第一,notion,0,6,6,0,9,9,0.081938,4,0.393632,0.432756,27473.164335
第一个(1946),第一个,notion,0,1,1,0,1,1,0.005304,4,0.259537,0.268322,0
第一件(1946),第一件,notion,0,1,1,0,1,1,0.018893,4,0.282798,0.307938,0
第一号(1946),第一号,notion,0,1,1,0,1,1,0.013634,4,0.273332,0.292631,0
第一天(1946),第一天,notion,0,1,1,0,1,1,0.00826,4,0.264992,0.278237,0
第一年(1946),第一年,notion,0,1,1,0,1,1,0.0031,4,0.254504,0.258799,0
第一次(1946),第一次,notion,0,2,2,0,2,2,0.018407,4,0.281634,0.306184,1780.990245
第一篇(1946),第一篇,notion,0,1,1,0,1,1,0.017626,4,0.281496,0.305894,0
第一课(1946),第一课,notion,0,1,1,0,1,1,0.017626,4,0.281496,0.305894,0
第三党(1946),第三党,notion,0,1,1,0,1,1,0.004564,4,0.256755,0.263104,0
第三师(1946),第三师,notion,0,1,1,0,1,1,0.00826,4,0.264992,0.278237,0
第三方面(1946),第三方面,notion,0,4,4,0,8,8,0.046472,4,0.318804,0.358077,5464.243983
第三次(1946),第三次,notion,0,1,1,0,1,1,0.018893,4,0.282798,0.307938,0
第三章(1946),第三章,notion,0,1,1,0,1,1,0.018893,4,0.282798,0.307938,0
第三篇(1946),第三篇,notion,0,1,1,0,1,1,0.017626,4,0.281496,0.305894,0
第三者(1946),第三者,notion,0,2,2,0,2,2,0.02853,4,0.295746,0.327361,1236.887723
第二(1946),第二,notion,0,5,5,0,5,5,0.054903,4,0.337402,0.379762,12827.755316
第二期(1946),第二期,notion,0,1,1,0,1,1,0.005461,4,0.25793,0.265322,0
第二次(1946),第二次,notion,0,2,2,0,2,2,0.009698,4,0.262356,0.273569,160.636246
第二步(1946),第二步,notion,0,1,1,0,1,1,0.0031,4,0.254504,0.258799,0
第二篇(1946),第二篇,notion,0,1,1,0,1,1,0.017626,4,0.281496,0.305894,0
第五次(1946),第五次,notion,0,1,1,0,1,1,0.007159,4,0.261235,0.271453,0
第五章(1946),第五章,notion,0,1,1,0,1,1,0.018893,4,0.282798,0.307938,0
第八(1946),第八,notion,0,1,1,0,1,1,0.013634,4,0.273332,0.292631,0
第六号(1946),第六号,notion,0,1,1,0,1,1,0.013103,4,0.272684,0.291543,0
第十八(1946),第十八,notion,0,2,2,0,2,2,0.01768,4,0.279308,0.302487,1220.085569
第四(1946),第四,notion,0,1,1,0,1,1,0.004564,4,0.256755,0.263104,0
第四届(1946),第四届,notion,0,1,1,0,4,4,0.017626,4,0.281496,0.305894,0
第四章(1946),第四章,notion,0,1,1,0,1,1,0.018893,4,0.282798,0.307938,0
笼罩着(1946),笼罩着,notion,0,1,1,0,1,1,0.00826,4,0.264992,0.278237,0
等于(1946),等于,notion,0,1,1,0,1,1,0.018893,4,0.282798,0.307938,0
等着瞧(1946),等着瞧,notion,0,1,1,0,1,1,0.018893,4,0.282798,0.307938,0
筑坝(1946),筑坝,notion,0,1,1,0,1,1,0.013634,4,0.273332,0.292631,0
答丐(1946),答丐,notion,0,1,1,0,1,1,0.013634,4,0.273332,0.292631,0
答客(1946),答客,notion,0,2,2,0,2,2,0.02313,4,0.287378,0.315055,697.222
答案(1946),答案,notion,0,1,1,0,1,1,0.017626,4,0.281496,0.305894,0
答联(1946),答联,notion,0,1,1,0,1,1,0.013378,4,0.272039,0.290456,0
答覆(1946),答覆,notion,0,3,3,0,4,4,0.027317,4,0.292496,0.322737,3202.515812
策士(1946),策士,notion,0,1,1,0,1,1,0.003608,4,0.255568,0.260842,0
筹备会(1946),筹备会,notion,0,1,1,0,1,1,0.013634,4,0.273332,0.292631,0
签字(1946),签字,notion,0,1,1,0,1,1,0.013634,4,0.273332,0.292631,0
签让(1946),签让,notion,0,1,1,0,1,1,0.018893,4,0.282798,0.307938,0
简介(1946),简介,notion,0,1,1,0,1,1,0.005304,4,0.259537,0.268322,0
简史(1946),简史,notion,0,1,1,0,1,1,0.013103,4,0.272684,0.291543,0
简方林(1946),简方林,notion,0,1,1,0,1,1,0.00826,4,0.264992,0.278237,0
简记(1946),简记,notion,0,1,1,0,1,1,0.017626,4,0.281496,0.305894,0
简述(1946),简述,notion,0,1,1,0,1,1,0.00826,4,0.264992,0.278237,0
算了(1946),算了,notion,0,1,1,0,1,1,0.017626,4,0.281496,0.305894,0
算清(1946),算清,notion,0,1,1,0,1,1,0.004237,4,0.256206,0.26206,0
算账(1946),算账,notion,0,1,1,0,1,1,0.013634,4,0.273332,0.292631,0
管兵(1946),管兵,notion,0,1,1,0,1,1,0.003608,4,0.255568,0.260842,0
管束(1946),管束,notion,0,1,1,0,2,2,0.013634,4,0.273332,0.292631,0
管理权(1946),管理权,notion,0,1,1,0,1,1,0.007159,4,0.261235,0.271453,0
管见(1946),管见,notion,0,2,2,0,2,2,0.031004,4,0.302277,0.336493,1833.728143
箱子(1946),箱子,notion,0,1,1,0,1,1,0.013103,4,0.272684,0.291543,0
箴言(1946),箴言,notion,0,1,1,0,1,1,0.009637,4,0.265506,0.27915,0
範围(1946),範围,notion,0,1,1,0,1,1,0.017626,4,0.281496,0.305894,0
米价(1946),米价,notion,0,1,1,0,1,1,0.007159,4,0.261235,0.271453,0
粉传(1946),粉传,notion,0,1,1,0,1,1,0.00826,4,0.264992,0.278237,0
粉碎(1946),粉碎,notion,0,1,1,0,1,1,0.013103,4,0.272684,0.291543,0
粉饰(1946),粉饰,notion,0,1,1,0,1,1,0.013634,4,0.273332,0.292631,0
粟裕将军(1946),粟裕将军,notion,0,1,1,0,1,1,0.00826,4,0.264992,0.278237,0
粤东(1946),粤东,notion,0,1,1,0,1,1,0.017626,4,0.281496,0.305894,0
粤省(1946),粤省,notion,0,1,1,0,1,1,0.00826,4,0.264992,0.278237,0
粮荒(1946),粮荒,notion,0,2,2,0,4,4,0.03126,4,0.304035,0.338885,2199.499867
粮食(1946),粮食,notion,0,3,3,0,4,4,0.035307,4,0.309669,0.346437,4718.549721
精兵(1946),精兵,notion,0,1,1,0,1,1,0.017626,4,0.281496,0.305894,0
精神枷锁(1946),精神枷锁,notion,0,1,1,0,1,1,0.018893,4,0.282798,0.307938,0
精神食粮(1946),精神食粮,notion,0,1,1,0,1,1,0.005304,4,0.259537,0.268322,0
糟到(1946),糟到,notion,0,1,1,0,1,1,0.013378,4,0.272039,0.290456,0
索性(1946),索性,notion,0,1,1,0,1,1,0.004237,4,0.256206,0.26206,0
索薪(1946),索薪,notion,0,1,1,0,1,1,0.004479,4,0.256686,0.262973,0
索迷离(1946),索迷离,notion,0,1,1,0,1,1,0.013634,4,0.273332,0.292631,0
索隐(1946),索隐,notion,0,1,1,0,1,1,0.013378,4,0.272039,0.290456,0
紧张(1946),紧张,notion,0,3,3,0,3,3,0.026031,4,0.293871,0.324738,3658.704472
紧张局势(1946),紧张局势,notion,0,1,1,0,1,1,0.013103,4,0.272684,0.291543,0
紧急(1946),紧急,notion,0,2,2,0,2,2,0.017582,4,0.278308,0.300878,864.242178
紧紧(1946),紧紧,notion,0,1,1,0,1,1,0.005461,4,0.25793,0.265322,0
紧要(1946),紧要,notion,0,1,1,0,1,1,0.009637,4,0.265506,0.27915,0
紫塞(1946),紫塞,notion,0,2,2,0,2,2,0.01513,4,0.274953,0.295399,633.585998
繁荣(1946),繁荣,notion,0,2,2,0,2,2,0.009784,4,0.265751,0.279657,874.170092
纠正(1946),纠正,notion,0,1,1,0,1,1,0.017626,4,0.281496,0.305894,0
纠纷(1946),纠纷,notion,0,4,4,0,4,4,0.049765,4,0.331488,0.373079,7941.503584
约束(1946),约束,notion,0,1,1,0,1,1,0.005304,4,0.259537,0.268322,0
约法(1946),约法,notion,0,1,1,0,1,1,0.009637,4,0.265506,0.27915,0
约章(1946),约章,notion,0,1,1,0,1,1,0.017626,4,0.281496,0.305894,0
约翰(1946),约翰,notion,0,1,1,0,1,1,0.004577,4,0.257676,0.264843,0
纪实(1946),纪实,notion,0,3,3,0,3,3,0.026942,4,0.295563,0.327173,5312.67013
纪录(1946),纪录,notion,0,1,1,0,1,1,0.018893,4,0.282798,0.307938,0
纪律(1946),纪律,notion,0,1,1,0,1,1,0.005304,4,0.259537,0.268322,0
纪念大会(1946),纪念大会,notion,0,1,1,0,1,1,0.013103,4,0.272684,0.291543,0
纪念日(1946),纪念日,notion,0,1,1,0,1,1,0.013103,4,0.272684,0.291543,0
纪游(1946),纪游,notion,0,1,1,0,1,1,0.013103,4,0.272684,0.291543,0
纪详(1946),纪详,notion,0,1,1,0,2,2,0.013634,4,0.273332,0.292631,0
纯粹(1946),纯粹,notion,0,1,1,0,1,1,0.018893,4,0.282798,0.307938,0
纲领(1946),纲领,notion,0,3,3,0,3,3,0.019336,4,0.27556,0.296472,1019.506992
纳粹党(1946),纳粹党,notion,0,1,1,0,1,1,0.013378,4,0.272039,0.290456,0
纵容(1946),纵容,notion,0,3,3,0,4,4,0.033639,4,0.301452,0.335435,3196.708035
纵横(1946),纵横,notion,0,2,2,0,2,2,0.027011,4,0.292079,0.322056,1114.922273
纵谈(1946),纵谈,notion,0,2,2,0,2,2,0.027153,4,0.296784,0.32884,1981.441549
纵队(1946),纵队,notion,0,1,1,0,2,2,0.00826,4,0.264992,0.278237,0
纶巾羽扇(1946),纶巾羽扇,notion,0,1,1,0,1,1,0.003608,4,0.255568,0.260842,0
纷争(1946),纷争,notion,0,1,1,0,2,2,0.013103,4,0.272684,0.291543,0
纷歧(1946),纷歧,notion,0,1,1,0,1,1,0.017626,4,0.281496,0.305894,0
纸老虎(1946),纸老虎,notion,0,1,1,0,1,1,0.009637,4,0.265506,0.27915,0
线上(1946),线上,notion,0,1,1,0,1,1,0.017626,4,0.281496,0.305894,0
组成(1946),组成,notion,0,1,1,0,1,1,0.013378,4,0.272039,0.290456,0
组阁(1946),组阁,notion,0,1,1,0,1,1,0.013103,4,0.272684,0.291543,0
绅士(1946),绅士,notion,0,1,1,0,1,1,0.013103,4,0.272684,0.291543,0
细菌(1946),细菌,notion,0,1,1,0,1,1,0.009637,4,0.265506,0.27915,0
细语(1946),细语,notion,0,1,1,0,1,1,0.00826,4,0.264992,0.278237,0
终于(1946),终于,notion,0,1,1,0,1,1,0.018893,4,0.282798,0.307938,0
终必(1946),终必,notion,0,1,1,0,1,1,0.018893,4,0.282798,0.307938,0
终止(1946),终止,notion,0,2,2,0,2,2,0.012823,4,0.270988,0.288746,913.401999
终结(1946),终结,notion,0,1,1,0,1,1,0.003608,4,0.255568,0.260842,0
绊住(1946),绊住,notion,0,1,1,0,1,1,0.013378,4,0.272039,0.290456,0
经来(1946),经来,notion,0,1,1,0,1,1,0.013378,4,0.272039,0.290456,0
经济恐慌(1946),经济恐慌,notion,0,2,2,0,2,2,0.016203,4,0.276115,0.297313,650.123339
经营(1946),经营,notion,0,1,1,0,1,1,0.017626,4,0.281496,0.305894,0
经费(1946),经费,notion,0,1,1,0,1,1,0.017626,4,0.281496,0.305894,0
经过(1946),经过,notion,0,9,9,0,11,11,0.085821,4,0.390265,0.430234,41357.328292
经验(1946),经验,notion,0,2,2,0,11,11,0.018407,4,0.281634,0.306184,1780.990245
绑架(1946),绑架,notion,0,1,1,0,1,1,0.007159,4,0.261235,0.271453,0
结合(1946),结合,notion,0,2,2,0,2,2,0.011868,4,0.270274,0.287528,1315.392171
结婚(1946),结婚,notion,0,2,2,0,2,2,0.025886,4,0.296968,0.329101,2935.752997
结实(1946),结实,notion,0,1,1,0,1,1,0.009637,4,0.265506,0.27915,0
结局(1946),结局,notion,0,1,1,0,1,1,0.017626,4,0.281496,0.305894,0
结束(1946),结束,notion,0,4,4,0,4,4,0.063531,4,0.355777,0.398823,10524.699811
结束任务(1946),结束任务,notion,0,1,1,0,1,1,0.005304,4,0.259537,0.268322,0
结构(1946),结构,notion,0,1,1,0,1,1,0.004577,4,0.257676,0.264843,0
结果(1946),结果,notion,0,3,3,0,5,5,0.031575,4,0.297213,0.329521,2648.921613
结算(1946),结算,notion,0,1,1,0,1,1,0.013634,4,0.273332,0.292631,0
结论(1946),结论,notion,0,1,1,0,1,1,0.00826,4,0.264992,0.278237,0
给予(1946),给予,notion,0,2,2,0,4,4,0.030729,4,0.302946,0.337407,2092.27198
绝不能(1946),绝不能,notion,0,1,1,0,1,1,0.00826,4,0.264992,0.278237,0
绝境(1946),绝境,notion,0,1,1,0,1,1,0.013378,4,0.272039,0.290456,0
绝望(1946),绝望,notion,0,2,2,0,2,2,0.021638,4,0.286262,0.313359,1666.282153
绝食(1946),绝食,notion,0,1,1,0,1,1,0.013378,4,0.272039,0.290456,0
绞死(1946),绞死,notion,0,1,1,0,1,1,0.013378,4,0.272039,0.290456,0
统制(1946),统制,notion,0,1,1,0,1,1,0.013378,4,0.272039,0.290456,0
统帅(1946),统帅,notion,0,1,1,0,1,1,0.017626,4,0.281496,0.305894,0
统治(1946),统治,notion,0,5,5,0,7,7,0.049028,4,0.332793,0.37463,15040.985094
统治者(1946),统治者,notion,0,2,2,0,2,2,0.032271,4,0.301168,0.334971,1271.496707
统治阶级(1946),统治阶级,notion,0,1,1,0,1,1,0.013634,4,0.273332,0.292631,0
绥靖(1946),绥靖,notion,0,1,1,0,1,1,0.017626,4,0.281496,0.305894,0
继任者(1946),继任者,notion,0,1,1,0,1,1,0.018893,4,0.282798,0.307938,0
继承(1946),继承,notion,0,2,2,0,2,2,0.009698,4,0.262356,0.273569,160.636246
继绩(1946),继绩,notion,0,1,1,0,1,1,0.003608,4,0.255568,0.260842,0
继续(1946),继续,notion,0,2,2,0,2,2,0.027011,4,0.292079,0.322056,1114.922273
续二(1946),续二,notion,0,1,1,0,1,1,0.007159,4,0.261235,0.271453,0
维克党(1946),维克党,notion,0,1,1,0,1,1,0.013103,4,0.272684,0.291543,0
维护(1946),维护,notion,0,1,1,0,1,1,0.004479,4,0.256686,0.262973,0
维持(1946),维持,notion,0,1,1,0,1,1,0.00826,4,0.264992,0.278237,0
综合(1946),综合,notion,0,1,1,0,1,1,0.013634,4,0.273332,0.292631,0
综述(1946),综述,notion,0,1,1,0,1,1,0.00826,4,0.264992,0.278237,0
绿洲(1946),绿洲,notion,0,1,1,0,1,1,0.017626,4,0.281496,0.305894,0
绿衣(1946),绿衣,notion,0,1,1,0,1,1,0.018893,4,0.282798,0.307938,0
绿野(1946),绿野,notion,0,1,1,0,1,1,0.013634,4,0.273332,0.292631,0
缄默(1946),缄默,notion,0,1,1,0,1,1,0.013103,4,0.272684,0.291543,0
缅甸(1946),缅甸,notion,0,1,1,0,1,1,0.017626,4,0.281496,0.305894,0
缅甸人(1946),缅甸人,notion,0,1,1,0,1,1,0.017626,4,0.281496,0.305894,0
缆车(1946),缆车,notion,0,1,1,0,1,1,0.004577,4,0.257676,0.264843,0
缔造(1946),缔造,notion,0,2,2,0,2,2,0.022204,4,0.287896,0.315838,1406.192172
编宪(1946),编宪,notion,0,1,1,0,1,1,0.013378,4,0.272039,0.290456,0
编纂(1946),编纂,notion,0,1,1,0,1,1,0.017626,4,0.281496,0.305894,0
编者(1946),编者,notion,0,3,3,0,8,8,0.033107,4,0.302722,0.337175,3830.700163
编者的话(1946),编者的话,notion,0,1,1,0,1,1,0.013103,4,0.272684,0.291543,0
编辑(1946),编辑,notion,0,2,2,0,2,2,0.022931,4,0.290456,0.319664,2102.663893
编辑室(1946),编辑室,notion,0,1,1,0,1,1,0.017626,4,0.281496,0.305894,0
编遣(1946),编遣,notion,0,1,1,0,1,1,0.0031,4,0.254504,0.258799,0
缩军(1946),缩军,notion,0,1,1,0,1,1,0.013103,4,0.272684,0.291543,0
缺少(1946),缺少,notion,0,1,1,0,1,1,0.013378,4,0.272039,0.290456,0
缺点(1946),缺点,notion,0,1,1,0,1,1,0.017626,4,0.281496,0.305894,0
罗卓英(1946),罗卓英,notion,0,1,1,0,1,1,0.017626,4,0.281496,0.305894,0
罗城(1946),罗城,notion,0,1,1,0,1,1,0.007159,4,0.261235,0.271453,0
罗士培(1946),罗士培,notion,0,1,1,0,1,1,0.017626,4,0.281496,0.305894,0
罗家伦(1946),罗家伦,notion,0,1,1,0,1,1,0.017626,4,0.281496,0.305894,0
罗山(1946),罗山,notion,0,1,1,0,1,1,0.013634,4,0.273332,0.292631,0
罗梦册(1946),罗梦册,notion,0,1,1,0,1,1,0.018893,4,0.282798,0.307938,0
罗素(1946),罗素,notion,0,1,1,0,1,1,0.009637,4,0.265506,0.27915,0
罗蘅(1946),罗蘅,notion,0,1,1,0,1,1,0.018893,4,0.282798,0.307938,0
罗课(1946),罗课,notion,0,1,1,0,1,1,0.005461,4,0.25793,0.265322,0
罗隆基(1946),罗隆基,notion,0,1,1,0,1,1,0.018893,4,0.282798,0.307938,0
罗马(1946),罗马,notion,0,1,1,0,1,1,0.017626,4,0.281496,0.305894,0
罗马尼亚(1946),罗马尼亚,notion,0,1,1,0,1,1,0.004564,4,0.256755,0.263104,0
罗马帝国(1946),罗马帝国,notion,0,1,1,0,1,1,0.017626,4,0.281496,0.305894,0
罢工(1946),罢工,notion,0,4,4,0,4,4,0.030078,4,0.293901,0.324854,3549.235324
罢教(1946),罢教,notion,0,1,1,0,1,1,0.009637,4,0.265506,0.27915,0
罪人(1946),罪人,notion,0,1,1,0,1,1,0.009637,4,0.265506,0.27915,0
罪名(1946),罪名,notion,0,1,1,0,1,1,0.018893,4,0.282798,0.307938,0
罪行(1946),罪行,notion,0,2,2,0,3,3,0.031004,4,0.302277,0.336493,1833.728143
罪言(1946),罪言,notion,0,1,1,0,1,1,0.005461,4,0.25793,0.265322,0
羊枣(1946),羊枣,notion,0,5,5,0,10,10,0.053242,4,0.329437,0.370804,8182.951165
美利坚(1946),美利坚,notion,0,1,1,0,1,1,0.017626,4,0.281496,0.305894,0
美利坚合众国(1946),美利坚合众国,notion,0,1,1,0,1,1,0.013103,4,0.272684,0.291543,0
美加(1946),美加,notion,0,1,1,0,1,1,0.009637,4,0.265506,0.27915,0
美南(1946),美南,notion,0,1,1,0,2,2,0.009637,4,0.265506,0.27915,0
美商(1946),美商,notion,0,5,5,0,7,7,0.039331,4,0.305749,0.341407,5731.339194
美国会(1946),美国会,notion,0,2,2,0,2,2,0.027264,4,0.294896,0.326144,1405.794223
美国共和党(1946),美国共和党,notion,0,1,1,0,1,1,0.007159,4,0.261235,0.271453,0
美国军舰(1946),美国军舰,notion,0,1,1,0,1,1,0.018893,4,0.282798,0.307938,0
美国国会(1946),美国国会,notion,0,1,1,0,1,1,0.009637,4,0.265506,0.27915,0
美大(1946),美大,notion,0,1,1,0,1,1,0.017626,4,0.281496,0.305894,0
美式(1946),美式,notion,0,1,1,0,1,1,0.018893,4,0.282798,0.307938,0
美感(1946),美感,notion,0,1,1,0,1,1,0.013103,4,0.272684,0.291543,0
美报(1946),美报,notion,0,1,1,0,1,1,0.013378,4,0.272039,0.290456,0
美政府(1946),美政府,notion,0,1,1,0,1,1,0.013103,4,0.272684,0.291543,0
美新(1946),美新,notion,0,1,1,0,1,1,0.004479,4,0.256686,0.262973,0
美日(1946),美日,notion,0,1,1,0,1,1,0.017626,4,0.281496,0.305894,0
美械师(1946),美械师,notion,0,1,1,0,1,1,0.00826,4,0.264992,0.278237,0
美海军(1946),美海军,notion,0,1,1,0,1,1,0.017626,4,0.281496,0.305894,0
美灵(1946),美灵,notion,0,1,1,0,1,1,0.013634,4,0.273332,0.292631,0
美的(1946),美的,notion,0,1,1,0,1,1,0.013378,4,0.272039,0.290456,0
美苏关系(1946),美苏关系,notion,0,5,5,0,7,7,0.059575,4,0.340843,0.383501,10647.94195
美英(1946),美英,notion,0,3,3,0,4,4,0.035307,4,0.309669,0.346437,4718.549721
美货(1946),美货,notion,0,1,1,0,1,1,0.004564,4,0.256755,0.263104,0
羡慕(1946),羡慕,notion,0,1,1,0,1,1,0.00826,4,0.264992,0.278237,0
羣衆(1946),羣衆,notion,0,1,1,0,1,1,0.017626,4,0.281496,0.305894,0
群众观点(1946),群众观点,notion,0,1,1,0,1,1,0.00826,4,0.264992,0.278237,0
群岛(1946),群岛,notion,0,1,1,0,1,1,0.00826,4,0.264992,0.278237,0
群魔乱舞(1946),群魔乱舞,notion,0,1,1,0,1,1,0.013378,4,0.272039,0.290456,0
翻译(1946),翻译,notion,0,1,1,0,1,1,0.004564,4,0.256755,0.263104,0
翻译官(1946),翻译官,notion,0,1,1,0,1,1,0.013634,4,0.273332,0.292631,0
翻身(1946),翻身,notion,0,2,2,0,2,2,0.015419,4,0.27556,0.296399,1296.225957
翻过(1946),翻过,notion,0,1,1,0,1,1,0.013634,4,0.273332,0.292631,0
老人(1946),老人,notion,0,2,2,0,2,2,0.027011,4,0.292079,0.322056,1114.922273
老太太(1946),老太太,notion,0,1,1,0,1,1,0.007159,4,0.261235,0.271453,0
老太婆(1946),老太婆,notion,0,1,1,0,1,1,0.013634,4,0.273332,0.292631,0
老师(1946),老师,notion,0,1,1,0,1,1,0.00826,4,0.264992,0.278237,0
老战士(1946),老战士,notion,0,2,2,0,2,2,0.008716,4,0.262045,0.273004,282.22732
老糠(1946),老糠,notion,0,1,1,0,1,1,0.00826,4,0.264992,0.278237,0
老而不死(1946),老而不死,notion,0,1,1,0,1,1,0.013634,4,0.273332,0.292631,0
考察(1946),考察,notion,0,2,2,0,3,3,0.023456,4,0.28781,0.315707,881.141468
而会(1946),而会,notion,0,1,1,0,1,1,0.013378,4,0.272039,0.290456,0
而作(1946),而作,notion,0,8,8,0,8,8,0.066537,4,0.356395,0.399722,26364.518952
而是(1946),而是,notion,0,3,3,0,3,3,0.039429,4,0.309669,0.346437,3086.693105
而来(1946),而来,notion,0,1,1,0,1,1,0.00826,4,0.264992,0.278237,0
而歌(1946),而歌,notion,0,4,4,0,4,4,0.041183,4,0.315238,0.353641,7723.494314
耕者有其田(1946),耕者有其田,notion,0,1,1,0,1,1,0.00826,4,0.264992,0.278237,0
耕耘(1946),耕耘,notion,0,1,1,0,1,1,0.005461,4,0.25793,0.265322,0
耶诞(1946),耶诞,notion,0,1,1,0,1,1,0.018893,4,0.282798,0.307938,0
耻辱(1946),耻辱,notion,0,1,1,0,1,1,0.005461,4,0.25793,0.265322,0
聂荣臻(1946),聂荣臻,notion,0,1,1,0,1,1,0.013634,4,0.273332,0.292631,0
职业(1946),职业,notion,0,3,3,0,3,3,0.031841,4,0.301263,0.335174,3684.483831
职员(1946),职员,notion,0,1,1,0,1,1,0.004479,4,0.256686,0.262973,0
联会(1946),联会,notion,0,1,1,0,1,1,0.005304,4,0.259537,0.268322,0
联军(1946),联军,notion,0,3,3,0,4,4,0.034023,4,0.304841,0.340045,2961.289954
联合(1946),联合,notion,0,2,2,0,2,2,0.016203,4,0.276115,0.297313,650.123339
联合会(1946),联合会,notion,0,1,1,0,1,1,0.013103,4,0.272684,0.291543,0
联合声明(1946),联合声明,notion,0,4,4,0,4,4,0.057312,4,0.346471,0.389387,9832.612964
联合政府(1946),联合政府,notion,0,7,7,0,9,9,0.068848,4,0.348911,0.392126,16071.888538
联合王国(1946),联合王国,notion,0,1,1,0,1,1,0.013103,4,0.272684,0.291543,0
联大(1946),联大,notion,0,2,2,0,2,2,0.019095,4,0.279064,0.302096,590.998645
联电(1946),联电,notion,0,1,1,0,1,1,0.00826,4,0.264992,0.278237,0
联盟(1946),联盟,notion,0,1,1,0,1,1,0.018893,4,0.282798,0.307938,0
联谊会(1946),联谊会,notion,0,2,2,0,2,2,0.012463,4,0.270274,0.287528,1220.09749
联防(1946),联防,notion,0,2,2,0,2,2,0.014214,4,0.272194,0.29079,872.497436
聚餐会(1946),聚餐会,notion,0,1,1,0,1,1,0.009637,4,0.265506,0.27915,0
肃清(1946),肃清,notion,0,1,1,0,1,1,0.013103,4,0.272684,0.291543,0
肆谈(1946),肆谈,notion,0,1,1,0,1,1,0.004479,4,0.256686,0.262973,0
肉食(1946),肉食,notion,0,1,1,0,1,1,0.009637,4,0.265506,0.27915,0
股匪(1946),股匪,notion,0,1,1,0,1,1,0.00826,4,0.264992,0.278237,0
肥皂泡(1946),肥皂泡,notion,0,1,1,0,1,1,0.018893,4,0.282798,0.307938,0
背后(1946),背后,notion,0,1,1,0,1,1,0.00826,4,0.264992,0.278237,0
背境(1946),背境,notion,0,1,1,0,1,1,0.005461,4,0.25793,0.265322,0
背着(1946),背着,notion,0,1,1,0,1,1,0.013634,4,0.273332,0.292631,0
背道而驰(1946),背道而驰,notion,0,1,1,0,1,1,0.013634,4,0.273332,0.292631,0
背面(1946),背面,notion,0,1,1,0,1,1,0.018893,4,0.282798,0.307938,0
胎动(1946),胎动,notion,0,2,2,0,2,2,0.032527,4,0.303393,0.338015,1614.891208
胜仗(1946),胜仗,notion,0,1,1,0,1,1,0.00826,4,0.264992,0.278237,0
胜境(1946),胜境,notion,0,1,1,0,1,1,0.013634,4,0.273332,0.292631,0
胜而(1946),胜而,notion,0,1,1,0,1,1,0.013378,4,0.272039,0.290456,0
胡子(1946),胡子,notion,0,2,2,0,2,2,0.020262,4,0.282243,0.30714,1027.722249
胡涂(1946),胡涂,notion,0,1,1,0,1,1,0.018893,4,0.282798,0.307938,0
胡适(1946),胡适,notion,0,1,1,0,1,1,0.004564,4,0.256755,0.263104,0
胡闹(1946),胡闹,notion,0,1,1,0,1,1,0.007159,4,0.261235,0.271453,0
能否(1946),能否,notion,0,1,1,0,1,1,0.018893,4,0.282798,0.307938,0
脚尖(1946),脚尖,notion,0,1,1,0,1,1,0.018893,4,0.282798,0.307938,0
脚踏实地(1946),脚踏实地,notion,0,1,1,0,1,1,0.003608,4,0.255568,0.260842,0
脱离(1946),脱离,notion,0,1,1,0,1,1,0.013378,4,0.272039,0.290456,0
脱节(1946),脱节,notion,0,1,1,0,1,1,0.013634,4,0.273332,0.292631,0
脱莱(1946),脱莱,notion,0,1,1,0,1,1,0.013103,4,0.272684,0.291543,0
脱轨(1946),脱轨,notion,0,1,1,0,1,1,0.00826,4,0.264992,0.278237,0
腐蚀(1946),腐蚀,notion,0,1,1,0,1,1,0.013634,4,0.273332,0.292631,0
自主权(1946),自主权,notion,0,1,1,0,1,1,0.013378,4,0.272039,0.290456,0
自从(1946),自从,notion,0,1,1,0,1,1,0.013103,4,0.272684,0.291543,0
自供(1946),自供,notion,0,1,1,0,1,1,0.013634,4,0.273332,0.292631,0
自侮(1946),自侮,notion,0,1,1,0,2,2,0.013634,4,0.273332,0.292631,0
自保(1946),自保,notion,0,1,1,0,1,1,0.017626,4,0.281496,0.305894,0
自动(1946),自动,notion,0,1,1,0,1,1,0.007159,4,0.261235,0.271453,0
自卫(1946),自卫,notion,0,1,1,0,3,3,0.00826,4,0.264992,0.278237,0
自卫战争(1946),自卫战争,notion,0,1,1,0,1,1,0.00826,4,0.264992,0.278237,0
自处(1946),自处,notion,0,1,1,0,1,1,0.009637,4,0.265506,0.27915,0
自夸(1946),自夸,notion,0,1,1,0,1,1,0.013378,4,0.272039,0.290456,0
自学(1946),自学,notion,0,1,1,0,1,1,0.005304,4,0.259537,0.268322,0
自守(1946),自守,notion,0,1,1,0,1,1,0.004479,4,0.256686,0.262973,0
自序(1946),自序,notion,0,1,1,0,1,1,0.009637,4,0.265506,0.27915,0
自强(1946),自强,notion,0,1,1,0,1,1,0.005304,4,0.259537,0.268322,0
自我(1946),自我,notion,0,1,1,0,2,2,0.005304,4,0.259537,0.268322,0
自我批评(1946),自我批评,notion,0,1,1,0,1,1,0.005304,4,0.259537,0.268322,0
自我改造(1946),自我改造,notion,0,1,1,0,1,1,0.018893,4,0.282798,0.307938,0
自救(1946),自救,notion,0,1,1,0,1,1,0.018893,4,0.282798,0.307938,0
自有(1946),自有,notion,0,1,1,0,1,1,0.018893,4,0.282798,0.307938,0
自杀(1946),自杀,notion,0,5,5,0,5,5,0.055885,4,0.337878,0.380284,12492.650999
自治(1946),自治,notion,0,5,5,0,6,6,0.058338,4,0.349292,0.392373,14930.592973
自然(1946),自然,notion,0,1,1,0,1,1,0.017626,4,0.281496,0.305894,0
自然界(1946),自然界,notion,0,1,1,0,1,1,0.017626,4,0.281496,0.305894,0
自由主义(1946),自由主义,notion,0,2,2,0,2,2,0.036519,4,0.313896,0.3518,2490.161613
自由民主(1946),自由民主,notion,0,1,1,0,1,1,0.018893,4,0.282798,0.307938,0
自由祖国(1946),自由祖国,notion,0,1,1,0,1,1,0.018893,4,0.282798,0.307938,0
自白(1946),自白,notion,0,1,1,0,1,1,0.005304,4,0.259537,0.268322,0
自觉(1946),自觉,notion,0,2,2,0,2,2,0.022931,4,0.290456,0.319664,2102.663893
自述(1946),自述,notion,0,1,1,0,1,1,0.00826,4,0.264992,0.278237,0
自食其果(1946),自食其果,notion,0,1,1,0,1,1,0.007159,4,0.261235,0.271453,0
自食其言(1946),自食其言,notion,0,1,1,0,1,1,0.018893,4,0.282798,0.307938,0
至今(1946),至今,notion,0,1,1,0,1,1,0.009637,4,0.265506,0.27915,0
致敬(1946),致敬,notion,0,3,3,0,3,3,0.022134,4,0.284844,0.311257,2943.023566
致谢(1946),致谢,notion,0,1,1,0,2,2,0.017626,4,0.281496,0.305894,0
舞弊(1946),舞弊,notion,0,1,1,0,1,1,0.00826,4,0.264992,0.278237,0
航权(1946),航权,notion,0,1,1,0,1,1,0.004479,4,0.256686,0.262973,0
航榷(1946),航榷,notion,0,1,1,0,1,1,0.013634,4,0.273332,0.292631,0
航行权(1946),航行权,notion,0,1,1,0,1,1,0.007159,4,0.261235,0.271453,0
般地(1946),般地,notion,0,1,1,0,1,1,0.013103,4,0.272684,0.291543,0
船夫(1946),船夫,notion,0,1,1,0,1,1,0.018893,4,0.282798,0.307938,0
良心(1946),良心,notion,0,1,1,0,1,1,0.017626,4,0.281496,0.305894,0
良心话(1946),良心话,notion,0,1,1,0,1,1,0.003608,4,0.255568,0.260842,0
艰辛(1946),艰辛,notion,0,1,1,0,1,1,0.00826,4,0.264992,0.278237,0
艰难(1946),艰难,notion,0,2,2,0,2,2,0.023088,4,0.287867,0.315794,912.175655
艺术品(1946),艺术品,notion,0,1,1,0,1,1,0.013103,4,0.272684,0.291543,0
节所(1946),节所,notion,0,1,1,0,1,1,0.013634,4,0.273332,0.292631,0
节日(1946),节日,notion,0,1,1,0,1,1,0.013103,4,0.272684,0.291543,0
节约(1946),节约,notion,0,2,2,0,5,5,0.03126,4,0.304035,0.338885,2199.499867
芗铭(1946),芗铭,notion,0,1,1,0,1,1,0.018893,4,0.282798,0.307938,0
花会(1946),花会,notion,0,1,1,0,1,1,0.017626,4,0.281496,0.305894,0
花开(1946),花开,notion,0,1,1,0,1,1,0.018893,4,0.282798,0.307938,0
花枪(1946),花枪,notion,0,1,1,0,1,1,0.009637,4,0.265506,0.27915,0
花样(1946),花样,notion,0,3,3,0,3,3,0.026824,4,0.293871,0.324738,3730.716385
花溪(1946),花溪,notion,0,1,1,0,1,1,0.017626,4,0.281496,0.305894,0
花絮(1946),花絮,notion,0,1,1,0,1,1,0.005304,4,0.259537,0.268322,0
苍山(1946),苍山,notion,0,1,1,0,1,1,0.017626,4,0.281496,0.305894,0
苏之关(1946),苏之关,notion,0,1,1,0,1,1,0.004577,4,0.257676,0.264843,0
苏京(1946),苏京,notion,0,1,1,0,1,1,0.013103,4,0.272684,0.291543,0
苏伊之争(1946),苏伊之争,notion,0,1,1,0,1,1,0.017626,4,0.281496,0.305894,0
苏侨(1946),苏侨,notion,0,1,1,0,1,1,0.013103,4,0.272684,0.291543,0
苏军(1946),苏军,notion,0,2,2,0,2,2,0.03126,4,0.304035,0.338885,2199.499867
苏州(1946),苏州,notion,0,2,2,0,3,3,0.027011,4,0.292079,0.322056,1114.922273
苏皖(1946),苏皖,notion,0,2,2,0,2,2,0.027153,4,0.296784,0.32884,1981.441549
苏美(1946),苏美,notion,0,2,2,0,2,2,0.031996,4,0.303907,0.338711,1883.718005
苏联红军(1946),苏联红军,notion,0,3,3,0,3,3,0.045904,4,0.321478,0.361266,4001.310187
苗区(1946),苗区,notion,0,1,1,0,1,1,0.017626,4,0.281496,0.305894,0
苗岭(1946),苗岭,notion,0,1,1,0,1,1,0.018893,4,0.282798,0.307938,0
苛法(1946),苛法,notion,0,1,1,0,1,1,0.0031,4,0.254504,0.258799,0
苛责(1946),苛责,notion,0,1,1,0,1,1,0.009637,4,0.265506,0.27915,0
苟延乎(1946),苟延乎,notion,0,1,1,0,1,1,0.017626,4,0.281496,0.305894,0
若干(1946),若干,notion,0,1,1,0,1,1,0.004564,4,0.256755,0.263104,0
苦乐(1946),苦乐,notion,0,1,1,0,1,1,0.017626,4,0.281496,0.305894,0
苦干(1946),苦干,notion,0,1,1,0,1,1,0.013103,4,0.272684,0.291543,0
苦幹(1946),苦幹,notion,0,1,1,0,1,1,0.017626,4,0.281496,0.305894,0
苦旅(1946),苦旅,notion,0,1,1,0,1,1,0.005304,4,0.259537,0.268322,0
苦瓜(1946),苦瓜,notion,0,1,1,0,1,1,0.009637,4,0.265506,0.27915,0
苦痛(1946),苦痛,notion,0,1,1,0,1,1,0.018893,4,0.282798,0.307938,0
苦闷(1946),苦闷,notion,0,4,4,0,4,4,0.04231,4,0.318169,0.357294,8238.551938
英军(1946),英军,notion,0,2,2,0,2,2,0.02274,4,0.286006,0.312967,1109.932808
英印(1946),英印,notion,0,1,1,0,1,1,0.013634,4,0.273332,0.292631,0
英国人(1946),英国人,notion,0,2,2,0,2,2,0.022106,4,0.287091,0.31462,1089.539125
英国工党(1946),英国工党,notion,0,1,1,0,1,1,0.004564,4,0.256755,0.263104,0
英国式(1946),英国式,notion,0,1,1,0,1,1,0.003608,4,0.255568,0.260842,0
英士(1946),英士,notion,0,1,1,0,1,1,0.013634,4,0.273332,0.292631,0
英苏(1946),英苏,notion,0,3,3,0,3,3,0.025841,4,0.289287,0.317997,2207.207416
英镑(1946),英镑,notion,0,1,1,0,1,1,0.009637,4,0.265506,0.27915,0
英雄主义(1946),英雄主义,notion,0,1,1,0,1,1,0.013103,4,0.272684,0.291543,0
英雄传(1946),英雄传,notion,0,1,1,0,1,1,0.004564,4,0.256755,0.263104,0
范围(1946),范围,notion,0,2,2,0,2,2,0.02274,4,0.286006,0.312967,1109.932808
范登堡(1946),范登堡,notion,0,1,1,0,1,1,0.009637,4,0.265506,0.27915,0
范筑先(1946),范筑先,notion,0,1,1,0,1,1,0.018893,4,0.282798,0.307938,0
茅盾(1946),茅盾,notion,0,1,1,0,1,1,0.018893,4,0.282798,0.307938,0
茶会(1946),茶会,notion,0,1,1,0,1,1,0.013634,4,0.273332,0.292631,0
茶壶(1946),茶壶,notion,0,1,1,0,1,1,0.007159,4,0.261235,0.271453,0
荆棘(1946),荆棘,notion,0,1,1,0,1,1,0.017626,4,0.281496,0.305894,0
荆轲(1946),荆轲,notion,0,1,1,0,1,1,0.009637,4,0.265506,0.27915,0
草原(1946),草原,notion,0,1,1,0,1,1,0.013103,4,0.272684,0.291543,0
草案(1946),草案,notion,0,1,1,0,2,2,0.017626,4,0.281496,0.305894,0
草莽英雄(1946),草莽英雄,notion,0,1,1,0,1,1,0.005304,4,0.259537,0.268322,0
草鞋(1946),草鞋,notion,0,1,1,0,1,1,0.017626,4,0.281496,0.305894,0
荒凉(1946),荒凉,notion,0,1,1,0,1,1,0.007159,4,0.261235,0.271453,0
荒灾(1946),荒灾,notion,0,1,1,0,1,1,0.013378,4,0.272039,0.290456,0
荷兰(1946),荷兰,notion,0,1,1,0,1,1,0.009637,4,0.265506,0.27915,0
莊严(1946),莊严,notion,0,1,1,0,1,1,0.017626,4,0.281496,0.305894,0
莫忘(1946),莫忘,notion,0,1,1,0,1,1,0.0031,4,0.254504,0.258799,0
莫斯科(1946),莫斯科,notion,0,3,3,0,4,4,0.026977,4,0.290721,0.320128,2226.154388
莫明其妙(1946),莫明其妙,notion,0,1,1,0,1,1,0.013378,4,0.272039,0.290456,0
莫须有(1946),莫须有,notion,0,1,1,0,1,1,0.018893,4,0.282798,0.307938,0
获得(1946),获得,notion,0,3,3,0,3,3,0.044107,4,0.323833,0.364092,5334.345912
获胜(1946),获胜,notion,0,1,1,0,1,1,0.018893,4,0.282798,0.307938,0
获选(1946),获选,notion,0,1,1,0,1,1,0.007159,4,0.261235,0.271453,0
菲图(1946),菲图,notion,0,1,1,0,1,1,0.00826,4,0.264992,0.278237,0
菲岛(1946),菲岛,notion,0,1,1,0,1,1,0.017626,4,0.281496,0.305894,0
菲律宾(1946),菲律宾,notion,0,4,4,0,4,4,0.063256,4,0.360552,0.403476,12249.942891
营养(1946),营养,notion,0,1,1,0,1,1,0.004237,4,0.256206,0.26206,0
萧一山(1946),萧一山,notion,0,1,1,0,1,1,0.017626,4,0.281496,0.305894,0
萧条(1946),萧条,notion,0,1,1,0,1,1,0.00826,4,0.264992,0.278237,0
落后(1946),落后,notion,0,2,2,0,2,2,0.036519,4,0.313896,0.3518,2490.161613
落空(1946),落空,notion,0,1,1,0,1,1,0.018893,4,0.282798,0.307938,0
落难(1946),落难,notion,0,1,1,0,1,1,0.018893,4,0.282798,0.307938,0
葡萄(1946),葡萄,notion,0,1,1,0,1,1,0.00826,4,0.264992,0.278237,0
葡警(1946),葡警,notion,0,1,1,0,1,1,0.017626,4,0.281496,0.305894,0
董曰(1946),董曰,notion,0,1,1,0,1,1,0.001496,4,0.252204,0.25432,0
葫芦依样(1946),葫芦依样,notion,0,1,1,0,1,1,0.018893,4,0.282798,0.307938,0
葬仪(1946),葬仪,notion,0,2,2,0,2,2,0.018839,4,0.277904,0.300226,537.484117
葬礼(1946),葬礼,notion,0,1,1,0,1,1,0.013103,4,0.272684,0.291543,0
蒋介石(1946),蒋介石,notion,0,3,3,0,5,5,0.0182,4,0.277127,0.299038,1873.984204
蒋先生(1946),蒋先生,notion,0,1,1,0,1,1,0.013378,4,0.272039,0.290456,0
蒋军(1946),蒋军,notion,0,1,1,0,7,7,0.00826,4,0.264992,0.278237,0
蒋匀田(1946),蒋匀田,notion,0,1,1,0,1,1,0.018893,4,0.282798,0.307938,0
蒋家(1946),蒋家,notion,0,1,1,0,1,1,0.00826,4,0.264992,0.278237,0
蒋廷(1946),蒋廷,notion,0,1,1,0,1,1,0.018893,4,0.282798,0.307938,0
蒋管区(1946),蒋管区,notion,0,1,1,0,1,1,0.00826,4,0.264992,0.278237,0
蒋记(1946),蒋记,notion,0,1,1,0,1,1,0.00826,4,0.264992,0.278237,0
蒙难(1946),蒙难,notion,0,1,1,0,1,1,0.017626,4,0.281496,0.305894,0
蒲城(1946),蒲城,notion,0,1,1,0,1,1,0.017626,4,0.281496,0.305894,0
蓉城(1946),蓉城,notion,0,1,1,0,1,1,0.004237,4,0.256206,0.26206,0
蔓延(1946),蔓延,notion,0,1,1,0,1,1,0.013103,4,0.272684,0.291543,0
蔡劲军(1946),蔡劲军,notion,0,1,1,0,1,1,0.00826,4,0.264992,0.278237,0
蔡廷锴(1946),蔡廷锴,notion,0,1,1,0,1,1,0.013634,4,0.273332,0.292631,0
蔷薇(1946),蔷薇,notion,0,1,1,0,1,1,0.018893,4,0.282798,0.307938,0
薪俸(1946),薪俸,notion,0,1,1,0,1,1,0.004577,4,0.257676,0.264843,0
藤县(1946),藤县,notion,0,1,1,0,1,1,0.007159,4,0.261235,0.271453,0
虎口余生(1946),虎口余生,notion,0,1,1,0,1,1,0.018893,4,0.282798,0.307938,0
虚伪(1946),虚伪,notion,0,1,1,0,1,1,0.004479,4,0.256686,0.262973,0
虚心接受(1946),虚心接受,notion,0,1,1,0,1,1,0.005304,4,0.259537,0.268322,0
虱子(1946),虱子,notion,0,1,1,0,1,1,0.018893,4,0.282798,0.307938,0
蛇鼠(1946),蛇鼠,notion,0,1,1,0,1,1,0.00826,4,0.264992,0.278237,0
蜀中(1946),蜀中,notion,0,1,1,0,2,2,0.017626,4,0.281496,0.305894,0
蜕变(1946),蜕变,notion,0,1,1,0,1,1,0.009637,4,0.265506,0.27915,0
螟目(1946),螟目,notion,0,1,1,0,1,1,0.005461,4,0.25793,0.265322,0
蠡测(1946),蠡测,notion,0,1,1,0,1,1,0.013103,4,0.272684,0.291543,0
血债(1946),血债,notion,0,1,1,0,1,1,0.00826,4,0.264992,0.278237,0
血写(1946),血写,notion,0,2,2,0,2,2,0.032527,4,0.303393,0.338015,1614.891208
血染(1946),血染,notion,0,1,1,0,1,1,0.013103,4,0.272684,0.291543,0
血汗(1946),血汗,notion,0,1,1,0,1,1,0.007159,4,0.261235,0.271453,0
血泪(1946),血泪,notion,0,2,2,0,2,2,0.025886,4,0.296968,0.329101,2935.752997
血痕(1946),血痕,notion,0,1,1,0,1,1,0.013634,4,0.273332,0.292631,0
血账(1946),血账,notion,0,1,1,0,1,1,0.00826,4,0.264992,0.278237,0
血迹(1946),血迹,notion,0,1,1,0,1,1,0.013378,4,0.272039,0.290456,0
行为(1946),行为,notion,0,1,1,0,1,1,0.013103,4,0.272684,0.291543,0
行列(1946),行列,notion,0,1,1,0,1,1,0.013634,4,0.273332,0.292631,0
行动(1946),行动,notion,0,1,1,0,1,1,0.00826,4,0.264992,0.278237,0
行宪(1946),行宪,notion,0,2,2,0,2,2,0.036519,4,0.313896,0.3518,2490.161613
行将(1946),行将,notion,0,1,1,0,1,1,0.00826,4,0.264992,0.278237,0
行帮(1946),行帮,notion,0,1,1,0,1,1,0.003608,4,0.255568,0.260842,0
行政(1946),行政,notion,0,4,4,0,4,4,0.03987,4,0.315135,0.353511,7192.300718
行政院(1946),行政院,notion,0,1,1,0,1,1,0.009637,4,0.265506,0.27915,0
行政院长(1946),行政院长,notion,0,1,1,0,2,2,0.009637,4,0.265506,0.27915,0
行程(1946),行程,notion,0,1,1,0,1,1,0.013634,4,0.273332,0.292631,0
行纪(1946),行纪,notion,0,1,1,0,1,1,0.013103,4,0.272684,0.291543,0
行营(1946),行营,notion,0,1,1,0,1,1,0.00826,4,0.264992,0.278237,0
行记(1946),行记,notion,0,1,1,0,1,1,0.004577,4,0.257676,0.264843,0
行路难(1946),行路难,notion,0,1,1,0,1,1,0.005304,4,0.259537,0.268322,0
行辕(1946),行辕,notion,0,1,1,0,1,1,0.013378,4,0.272039,0.290456,0
行进(1946),行进,notion,0,1,1,0,1,1,0.013634,4,0.273332,0.292631,0
街头(1946),街头,notion,0,1,1,0,1,1,0.018893,4,0.282798,0.307938,0
衝突(1946),衝突,notion,0,2,2,0,2,2,0.022204,4,0.287896,0.315838,1406.192172
衡阳(1946),衡阳,notion,0,1,1,0,1,1,0.005461,4,0.25793,0.265322,0
补习班(1946),补习班,notion,0,1,1,0,1,1,0.005304,4,0.259537,0.268322,0
补充(1946),补充,notion,0,1,1,0,1,1,0.005304,4,0.259537,0.268322,0
补品(1946),补品,notion,0,1,1,0,1,1,0.013634,4,0.273332,0.292631,0
补记(1946),补记,notion,0,1,1,0,1,1,0.013634,4,0.273332,0.292631,0
补遗(1946),补遗,notion,0,1,1,0,1,1,0.018893,4,0.282798,0.307938,0
表显(1946),表显,notion,0,1,1,0,1,1,0.009637,4,0.265506,0.27915,0
表演(1946),表演,notion,0,1,1,0,1,1,0.00826,4,0.264992,0.278237,0
表现(1946),表现,notion,0,1,1,0,1,1,0.018893,4,0.282798,0.307938,0
表示(1946),表示,notion,0,2,2,0,3,3,0.02853,4,0.295746,0.327361,1236.887723
表达思想(1946),表达思想,notion,0,1,1,0,1,1,0.004577,4,0.257676,0.264843,0
衰落(1946),衰落,notion,0,1,1,0,1,1,0.013103,4,0.272684,0.291543,0
袁同礼(1946),袁同礼,notion,0,1,1,0,1,1,0.013634,4,0.273332,0.292631,0
被俘(1946),被俘,notion,0,1,1,0,1,1,0.00826,4,0.264992,0.278237,0
被判(1946),被判,notion,0,1,1,0,1,1,0.017626,4,0.281496,0.305894,0
被剌案(1946),被剌案,notion,0,1,1,0,1,1,0.007159,4,0.261235,0.271453,0
被害(1946),被害,notion,0,1,1,0,1,1,0.018893,4,0.282798,0.307938,0
被弃(1946),被弃,notion,0,1,1,0,1,1,0.013634,4,0.273332,0.292631,0
被窃(1946),被窃,notion,0,1,1,0,1,1,0.013378,4,0.272039,0.290456,0
袭击(1946),袭击,notion,0,2,2,0,2,2,0.020389,4,0.284308,0.310358,712.812748
裁军(1946),裁军,notion,0,3,3,0,3,3,0.035209,4,0.308605,0.345046,4046.053282
裁决权(1946),裁决权,notion,0,2,2,0,2,2,0.031996,4,0.303907,0.338711,1883.718005
装备(1946),装备,notion,0,1,1,0,1,1,0.018893,4,0.282798,0.307938,0
装满(1946),装满,notion,0,1,1,0,1,1,0.013103,4,0.272684,0.291543,0
装腔作势(1946),装腔作势,notion,0,1,1,0,1,1,0.018893,4,0.282798,0.307938,0
装饰品(1946),装饰品,notion,0,1,1,0,1,1,0.007159,4,0.261235,0.271453,0
西北(1946),西北,notion,0,4,4,0,6,6,0.047738,4,0.326666,0.367513,7223.579089
西南(1946),西南,notion,0,1,1,0,1,1,0.017626,4,0.281496,0.305894,0
西园(1946),西园,notion,0,1,1,0,1,1,0.004564,4,0.256755,0.263104,0
西山(1946),西山,notion,0,1,1,0,1,1,0.004577,4,0.257676,0.264843,0
西工(1946),西工,notion,0,1,1,0,1,1,0.017626,4,0.281496,0.305894,0
西方人(1946),西方人,notion,0,1,1,0,1,1,0.004577,4,0.257676,0.264843,0
西施(1946),西施,notion,0,1,1,0,1,1,0.009637,4,0.265506,0.27915,0
西欧(1946),西欧,notion,0,1,1,0,1,1,0.004564,4,0.256755,0.263104,0
西江(1946),西江,notion,0,1,1,0,1,1,0.00826,4,0.264992,0.278237,0
西洋(1946),西洋,notion,0,3,3,0,3,3,0.041096,4,0.321012,0.3607,5617.668791
西洋镜(1946),西洋镜,notion,0,1,1,0,1,1,0.018893,4,0.282798,0.307938,0
西湖(1946),西湖,notion,0,2,2,0,3,3,0.03126,4,0.304035,0.338885,2199.499867
西陲(1946),西陲,notion,0,1,1,0,1,1,0.017626,4,0.281496,0.305894,0
要不得(1946),要不得,notion,0,1,1,0,1,1,0.018893,4,0.282798,0.307938,0
要件(1946),要件,notion,0,1,1,0,1,1,0.018893,4,0.282798,0.307938,0
要变(1946),要变,notion,0,1,1,0,1,1,0.004564,4,0.256755,0.263104,0
要和协(1946),要和协,notion,0,1,1,0,1,1,0.017626,4,0.281496,0.305894,0
要求(1946),要求,notion,0,9,9,0,15,15,0.086833,4,0.390265,0.430234,41017.886982
要说(1946),要说,notion,0,1,1,0,2,2,0.017626,4,0.281496,0.305894,0
要道(1946),要道,notion,0,1,1,0,2,2,0.017626,4,0.281496,0.305894,0
覆减(1946),覆减,notion,0,1,1,0,1,1,0.00826,4,0.264992,0.278237,0
覆奎龙(1946),覆奎龙,notion,0,1,1,0,1,1,0.005461,4,0.25793,0.265322,0
覆灭(1946),覆灭,notion,0,1,1,0,1,1,0.00826,4,0.264992,0.278237,0
覆议(1946),覆议,notion,0,1,1,0,1,1,0.009637,4,0.265506,0.27915,0
覆辙(1946),覆辙,notion,0,1,1,0,1,1,0.004237,4,0.256206,0.26206,0
见到(1946),见到,notion,0,2,2,0,2,2,0.016203,4,0.276115,0.297313,650.123339
见效(1946),见效,notion,0,1,1,0,1,1,0.004479,4,0.256686,0.262973,0
见赠(1946),见赠,notion,0,1,1,0,1,1,0.018893,4,0.282798,0.307938,0
见闻(1946),见闻,notion,0,4,4,0,4,4,0.035295,4,0.304389,0.339508,5599.798846
见闻录(1946),见闻录,notion,0,2,2,0,2,2,0.011396,4,0.26654,0.281049,423.548007
见面(1946),见面,notion,0,1,1,0,1,1,0.004237,4,0.256206,0.26206,0
见面礼(1946),见面礼,notion,0,1,1,0,1,1,0.017626,4,0.281496,0.305894,0
观后(1946),观后,notion,0,1,1,0,1,1,0.005304,4,0.259537,0.268322,0
观感(1946),观感,notion,0,4,4,0,8,8,0.059535,4,0.346806,0.389734,9135.64543
观点(1946),观点,notion,0,2,2,0,3,3,0.014214,4,0.272194,0.29079,872.497436
规律(1946),规律,notion,0,2,2,0,2,2,0.016711,4,0.277341,0.299313,944.999925
觅取(1946),觅取,notion,0,1,1,0,1,1,0.013103,4,0.272684,0.291543,0
视查(1946),视查,notion,0,1,1,0,1,1,0.018893,4,0.282798,0.307938,0
觉得(1946),觉得,notion,0,1,1,0,1,1,0.007159,4,0.261235,0.271453,0
觉悟(1946),觉悟,notion,0,1,1,0,1,1,0.017626,4,0.281496,0.305894,0
觉醒(1946),觉醒,notion,0,1,1,0,1,1,0.00826,4,0.264992,0.278237,0
角度看(1946),角度看,notion,0,1,1,0,1,1,0.004564,4,0.256755,0.263104,0
角色(1946),角色,notion,0,1,1,0,1,1,0.013378,4,0.272039,0.290456,0
解决不了(1946),解决不了,notion,0,1,1,0,1,1,0.004564,4,0.256755,0.263104,0
解决问题(1946),解决问题,notion,0,1,1,0,2,2,0.013634,4,0.273332,0.292631,0
解剖(1946),解剖,notion,0,1,1,0,1,1,0.013378,4,0.272039,0.290456,0
解放(1946),解放,notion,0,3,3,0,3,3,0.027977,4,0.294503,0.325651,2762.477446
解放运动(1946),解放运动,notion,0,1,1,0,1,1,0.017626,4,0.281496,0.305894,0
解救(1946),解救,notion,0,1,1,0,2,2,0.017626,4,0.281496,0.305894,0
解散国会(1946),解散国会,notion,0,1,1,0,1,1,0.013103,4,0.272684,0.291543,0
解释(1946),解释,notion,0,1,1,0,1,1,0.009637,4,0.265506,0.27915,0
解铃还是系铃人(1946),解铃还是系铃人,notion,0,1,1,0,1,1,0.005461,4,0.25793,0.265322,0
解除(1946),解除,notion,0,2,2,0,2,2,0.020727,4,0.284759,0.311054,789.620977
言寄美旅(1946),言寄美旅,notion,0,1,1,0,1,1,0.009637,4,0.265506,0.27915,0
言行(1946),言行,notion,0,1,1,0,1,1,0.007159,4,0.261235,0.271453,0
言论自由(1946),言论自由,notion,0,5,5,0,10,10,0.05915,4,0.339515,0.382066,10702.121333
警世钟(1946),警世钟,notion,0,1,1,0,1,1,0.004564,4,0.256755,0.263104,0
警区(1946),警区,notion,0,1,1,0,1,1,0.013378,4,0.272039,0.290456,0
警告(1946),警告,notion,0,3,3,0,3,3,0.023246,4,0.285949,0.312953,3071.785795
警局(1946),警局,notion,0,1,1,0,1,1,0.013634,4,0.273332,0.292631,0
警惕(1946),警惕,notion,0,1,1,0,1,1,0.013103,4,0.272684,0.291543,0
警校(1946),警校,notion,0,1,1,0,1,1,0.017626,4,0.281496,0.305894,0
警管(1946),警管,notion,0,1,1,0,1,1,0.018893,4,0.282798,0.307938,0
警觉性(1946),警觉性,notion,0,1,1,0,1,1,0.013378,4,0.272039,0.290456,0
警钟(1946),警钟,notion,0,1,1,0,1,1,0.013103,4,0.272684,0.291543,0
警震(1946),警震,notion,0,1,1,0,1,1,0.005461,4,0.25793,0.265322,0
计划(1946),计划,notion,0,4,4,0,6,6,0.045671,4,0.326147,0.366904,10051.150323
计时(1946),计时,notion,0,1,1,0,1,1,0.018893,4,0.282798,0.307938,0
订户(1946),订户,notion,0,1,1,0,1,1,0.017626,4,0.281496,0.305894,0
订约(1946),订约,notion,0,1,1,0,1,1,0.013634,4,0.273332,0.292631,0
认清(1946),认清,notion,0,1,1,0,2,2,0.013378,4,0.272039,0.290456,0
讨价还价(1946),讨价还价,notion,0,1,1,0,1,1,0.009637,4,0.265506,0.27915,0
讨论(1946),讨论,notion,0,3,3,0,4,4,0.015004,4,0.271243,0.289253,1357.632879
让人(1946),让人,notion,0,1,1,0,1,1,0.018893,4,0.282798,0.307938,0
让步(1946),让步,notion,0,1,1,0,1,1,0.013634,4,0.273332,0.292631,0
训导(1946),训导,notion,0,1,1,0,1,1,0.017626,4,0.281496,0.305894,0
训练(1946),训练,notion,0,2,2,0,2,2,0.027264,4,0.294896,0.326144,1405.794223
训练团(1946),训练团,notion,0,1,1,0,1,1,0.005304,4,0.259537,0.268322,0
议会(1946),议会,notion,0,2,2,0,2,2,0.018564,4,0.2792,0.302313,744.038498
议会制(1946),议会制,notion,0,1,1,0,1,1,0.013103,4,0.272684,0.291543,0
议员(1946),议员,notion,0,2,2,0,2,2,0.020262,4,0.282243,0.30714,1027.722249
议场(1946),议场,notion,0,1,1,0,1,1,0.018893,4,0.282798,0.307938,0
议长(1946),议长,notion,0,1,1,0,1,1,0.004479,4,0.256686,0.262973,0
记住(1946),记住,notion,0,1,1,0,1,1,0.004564,4,0.256755,0.263104,0
记后(1946),记后,notion,0,1,1,0,1,1,0.017626,4,0.281496,0.305894,0
记复社(1946),记复社,notion,0,1,1,0,1,1,0.013634,4,0.273332,0.292631,0
记实(1946),记实,notion,0,1,1,0,1,1,0.004479,4,0.256686,0.262973,0
记步(1946),记步,notion,0,1,1,0,1,1,0.005304,4,0.259537,0.268322,0
记洗(1946),记洗,notion,0,1,1,0,1,1,0.013634,4,0.273332,0.292631,0
记略(1946),记略,notion,0,1,1,0,1,1,0.004577,4,0.257676,0.264843,0
记者(1946),记者,notion,0,8,8,0,13,13,0.084452,4,0.393902,0.433119,38648.614896
记者节(1946),记者节,notion,0,1,1,0,1,1,0.017626,4,0.281496,0.305894,0
记遊(1946),记遊,notion,0,1,1,0,1,1,0.017626,4,0.281496,0.305894,0
记郭(1946),记郭,notion,0,1,1,0,1,1,0.004479,4,0.256686,0.262973,0
记闻(1946),记闻,notion,0,1,1,0,1,1,0.018893,4,0.282798,0.307938,0
讲些(1946),讲些,notion,0,1,1,0,1,1,0.009637,4,0.265506,0.27915,0
讲座(1946),讲座,notion,0,2,2,0,3,3,0.031004,4,0.302277,0.336493,1833.728143
讲故事(1946),讲故事,notion,0,1,1,0,1,1,0.018893,4,0.282798,0.307938,0
讲演(1946),讲演,notion,0,2,2,0,2,2,0.016796,4,0.275164,0.295747,753.735684
讲述(1946),讲述,notion,0,1,1,0,3,3,0.005304,4,0.259537,0.268322,0
论争(1946),论争,notion,0,1,1,0,1,1,0.013378,4,0.272039,0.290456,0
论文集(1946),论文集,notion,0,1,1,0,1,1,0.013103,4,0.272684,0.291543,0
讽刺(1946),讽刺,notion,0,1,1,0,1,1,0.00826,4,0.264992,0.278237,0
设立(1946),设立,notion,0,1,1,0,1,1,0.009637,4,0.265506,0.27915,0
设站(1946),设站,notion,0,1,1,0,1,1,0.005304,4,0.259537,0.268322,0
设行(1946),设行,notion,0,1,1,0,1,1,0.017626,4,0.281496,0.305894,0
设防(1946),设防,notion,0,1,1,0,1,1,0.017626,4,0.281496,0.305894,0
访华团(1946),访华团,notion,0,1,1,0,1,1,0.00826,4,0.264992,0.278237,0
访滞(1946),访滞,notion,0,1,1,0,1,1,0.013634,4,0.273332,0.292631,0
访问(1946),访问,notion,0,5,5,0,7,7,0.052424,4,0.332793,0.37463,11892.330755
访问记(1946),访问记,notion,0,5,5,0,6,6,0.043713,4,0.320368,0.360063,10926.688511
诀议(1946),诀议,notion,0,1,1,0,1,1,0.013378,4,0.272039,0.290456,0
证实(1946),证实,notion,0,1,1,0,1,1,0.013378,4,0.272039,0.290456,0
证明(1946),证明,notion,0,1,1,0,1,1,0.013634,4,0.273332,0.292631,0
评中(1946),评中,notion,0,1,1,0,1,1,0.004479,4,0.256686,0.262973,0
评价(1946),评价,notion,0,1,1,0,1,1,0.013378,4,0.272039,0.290456,0
评判(1946),评判,notion,0,1,1,0,1,1,0.018893,4,0.282798,0.307938,0
评注(1946),评注,notion,0,1,1,0,1,1,0.013378,4,0.272039,0.290456,0
评语(1946),评语,notion,0,2,2,0,2,2,0.014214,4,0.272194,0.29079,872.497436
评贺昌群(1946),评贺昌群,notion,0,1,1,0,1,1,0.013634,4,0.273332,0.292631,0
评述(1946),评述,notion,0,1,1,0,1,1,0.0031,4,0.254504,0.258799,0
诊断(1946),诊断,notion,0,1,1,0,1,1,0.005461,4,0.25793,0.265322,0
诊疗(1946),诊疗,notion,0,1,1,0,1,1,0.005304,4,0.259537,0.268322,0
诊费(1946),诊费,notion,0,1,1,0,1,1,0.013634,4,0.273332,0.292631,0
词话(1946),词话,notion,0,1,1,0,1,1,0.018893,4,0.282798,0.307938,0
译员(1946),译员,notion,0,1,1,0,1,1,0.017626,4,0.281496,0.305894,0
试笔(1946),试笔,notion,0,1,1,0,1,1,0.013634,4,0.273332,0.292631,0
试问(1946),试问,notion,0,1,1,0,1,1,0.007159,4,0.261235,0.271453,0
试验(1946),试验,notion,0,4,4,0,4,4,0.043467,4,0.319265,0.358642,6494.894596
试验者(1946),试验者,notion,0,1,1,0,1,1,0.018893,4,0.282798,0.307938,0
诗二首(1946),诗二首,notion,0,1,1,0,1,1,0.018893,4,0.282798,0.307938,0
诗人(1946),诗人,notion,0,2,2,0,2,2,0.031996,4,0.303907,0.338711,1883.718005
诗作(1946),诗作,notion,0,1,1,0,1,1,0.013103,4,0.272684,0.291543,0
诗兰(1946),诗兰,notion,0,1,1,0,1,1,0.013378,4,0.272039,0.290456,0
诗画(1946),诗画,notion,0,1,1,0,1,1,0.013378,4,0.272039,0.290456,0
诗章(1946),诗章,notion,0,1,1,0,1,1,0.018893,4,0.282798,0.307938,0
诗话(1946),诗话,notion,0,1,1,0,1,1,0.013378,4,0.272039,0.290456,0
诗选(1946),诗选,notion,0,1,1,0,1,1,0.009637,4,0.265506,0.27915,0
诗钞(1946),诗钞,notion,0,1,1,0,1,1,0.013634,4,0.273332,0.292631,0
诚实(1946),诚实,notion,0,1,1,0,1,1,0.009637,4,0.265506,0.27915,0
诚惶诚恐(1946),诚惶诚恐,notion,0,1,1,0,1,1,0.003608,4,0.255568,0.260842,0
话别(1946),话别,notion,0,1,1,0,1,1,0.017626,4,0.281496,0.305894,0
话剧(1946),话剧,notion,0,1,1,0,1,1,0.013634,4,0.273332,0.292631,0
诞生(1946),诞生,notion,0,2,2,0,2,2,0.01136,4,0.269135,0.285571,964.924012
诞辰(1946),诞辰,notion,0,2,2,0,3,3,0.031996,4,0.303907,0.338711,1883.718005
诡辩(1946),诡辩,notion,0,1,1,0,1,1,0.004564,4,0.256755,0.263104,0
详细(1946),详细,notion,0,1,1,0,1,1,0.007159,4,0.261235,0.271453,0
详记(1946),详记,notion,0,1,1,0,1,1,0.004479,4,0.256686,0.262973,0
语丝(1946),语丝,notion,0,1,1,0,1,1,0.018893,4,0.282798,0.307938,0
语声(1946),语声,notion,0,1,1,0,1,1,0.018893,4,0.282798,0.307938,0
诱惑(1946),诱惑,notion,0,1,1,0,1,1,0.017626,4,0.281496,0.305894,0
说不完(1946),说不完,notion,0,1,1,0,1,1,0.005461,4,0.25793,0.265322,0
说军(1946),说军,notion,0,1,1,0,1,1,0.009637,4,0.265506,0.27915,0
说实话(1946),说实话,notion,0,1,1,0,1,1,0.013103,4,0.272684,0.291543,0
说德(1946),说德,notion,0,1,1,0,1,1,0.009637,4,0.265506,0.27915,0
说教(1946),说教,notion,0,1,1,0,1,1,0.018893,4,0.282798,0.307938,0
说明(1946),说明,notion,0,3,3,0,3,3,0.023246,4,0.285949,0.312953,3071.785795
说话(1946),说话,notion,0,2,2,0,2,2,0.017955,4,0.278848,0.301748,1157.770247
说谎(1946),说谎,notion,0,1,1,0,1,1,0.004237,4,0.256206,0.26206,0
请勿(1946),请勿,notion,0,2,2,0,2,2,0.025886,4,0.296968,0.329101,2935.752997
请愿(1946),请愿,notion,0,4,4,0,5,5,0.033501,4,0.301516,0.335595,4545.590814
请求(1946),请求,notion,0,1,1,0,1,1,0.018893,4,0.282798,0.307938,0
请辞(1946),请辞,notion,0,1,1,0,1,1,0.018893,4,0.282798,0.307938,0
请重(1946),请重,notion,0,1,1,0,1,1,0.013378,4,0.272039,0.290456,0
请问(1946),请问,notion,0,1,1,0,1,1,0.013634,4,0.273332,0.292631,0
诸公(1946),诸公,notion,0,3,3,0,4,4,0.030174,4,0.293661,0.324433,2411.952703
诸子(1946),诸子,notion,0,1,1,0,1,1,0.007159,4,0.261235,0.271453,0
诺言(1946),诺言,notion,0,6,6,0,9,9,0.063112,4,0.348234,0.391358,15298.573363
读书人(1946),读书人,notion,0,1,1,0,1,1,0.009637,4,0.265506,0.27915,0
读书会(1946),读书会,notion,0,1,1,0,3,3,0.005304,4,0.259537,0.268322,0
读了(1946),读了,notion,0,1,1,0,1,1,0.018893,4,0.282798,0.307938,0
读后(1946),读后,notion,0,1,1,0,1,1,0.00826,4,0.264992,0.278237,0
读唐(1946),读唐,notion,0,1,1,0,1,1,0.018893,4,0.282798,0.307938,0
读好(1946),读好,notion,0,1,1,0,1,1,0.013634,4,0.273332,0.292631,0
读本(1946),读本,notion,0,1,1,0,1,1,0.009637,4,0.265506,0.27915,0
读林砺(1946),读林砺,notion,0,1,1,0,1,1,0.007159,4,0.261235,0.271453,0
读物(1946),读物,notion,0,1,1,0,1,1,0.005304,4,0.259537,0.268322,0
读者(1946),读者,notion,0,7,7,0,19,19,0.077649,4,0.381006,0.422305,29685.358599
诽谤(1946),诽谤,notion,0,1,1,0,1,1,0.013103,4,0.272684,0.291543,0
课外活动(1946),课外活动,notion,0,1,1,0,1,1,0.017626,4,0.281496,0.305894,0
课程(1946),课程,notion,0,2,2,0,2,2,0.022501,4,0.28712,0.314663,997.953629
课题(1946),课题,notion,0,1,1,0,1,1,0.017626,4,0.281496,0.305894,0
谁在(1946),谁在,notion,0,1,1,0,1,1,0.00826,4,0.264992,0.278237,0
调处(1946),调处,notion,0,1,1,0,1,1,0.013378,4,0.272039,0.290456,0
调查(1946),调查,notion,0,2,2,0,3,3,0.012739,4,0.270758,0.288354,795.473237
谈一谈(1946),谈一谈,notion,0,1,1,0,1,1,0.005461,4,0.25793,0.265322,0
谈人荒(1946),谈人荒,notion,0,1,1,0,1,1,0.017626,4,0.281496,0.305894,0
谈到(1946),谈到,notion,0,3,3,0,7,7,0.027508,4,0.291458,0.321215,2213.806217
谈勇(1946),谈勇,notion,0,1,1,0,1,1,0.005304,4,0.259537,0.268322,0
谈片(1946),谈片,notion,0,1,1,0,1,1,0.013634,4,0.273332,0.292631,0
谈美棉(1946),谈美棉,notion,0,1,1,0,1,1,0.0031,4,0.254504,0.258799,0
谈话(1946),谈话,notion,0,5,5,0,6,6,0.05949,4,0.340843,0.383501,10767.284099
谈谈(1946),谈谈,notion,0,3,3,0,4,4,0.049897,4,0.333295,0.375051,5595.386463
谈起(1946),谈起,notion,0,3,3,0,3,3,0.040531,4,0.315723,0.354178,4919.220408
谈道(1946),谈道,notion,0,1,1,0,1,1,0.009637,4,0.265506,0.27915,0
谋略(1946),谋略,notion,0,1,1,0,1,1,0.017626,4,0.281496,0.305894,0
谋阴(1946),谋阴,notion,0,1,1,0,1,1,0.013103,4,0.272684,0.291543,0
谎话(1946),谎话,notion,0,1,1,0,1,1,0.003608,4,0.255568,0.260842,0
谒陵(1946),谒陵,notion,0,1,1,0,1,1,0.017626,4,0.281496,0.305894,0
谢主龙恩(1946),谢主龙恩,notion,0,1,1,0,1,1,0.013634,4,0.273332,0.292631,0
谢罪(1946),谢罪,notion,0,1,1,0,1,1,0.00826,4,0.264992,0.278237,0
谢谢(1946),谢谢,notion,0,1,1,0,1,1,0.007159,4,0.261235,0.271453,0
谣傅(1946),谣傅,notion,0,1,1,0,1,1,0.013378,4,0.272039,0.290456,0
谣言(1946),谣言,notion,0,1,1,0,1,1,0.004237,4,0.256206,0.26206,0
谣谤(1946),谣谤,notion,0,1,1,0,1,1,0.009637,4,0.265506,0.27915,0
谦虚(1946),谦虚,notion,0,1,1,0,1,1,0.009637,4,0.265506,0.27915,0
谨告(1946),谨告,notion,0,1,1,0,1,1,0.018893,4,0.282798,0.307938,0
谨悼(1946),谨悼,notion,0,1,1,0,1,1,0.013378,4,0.272039,0.290456,0
谭琐(1946),谭琐,notion,0,1,1,0,1,1,0.005304,4,0.259537,0.268322,0
谰言(1946),谰言,notion,0,1,1,0,1,1,0.017626,4,0.281496,0.305894,0
贝尔纳斯(1946),贝尔纳斯,notion,0,5,5,0,6,6,0.066418,4,0.360055,0.40307,14465.523526
贝文(1946),贝文,notion,0,1,1,0,1,1,0.005461,4,0.25793,0.265322,0
贞节牌坊(1946),贞节牌坊,notion,0,1,1,0,1,1,0.013634,4,0.273332,0.292631,0
负责(1946),负责,notion,0,1,1,0,1,1,0.007159,4,0.261235,0.271453,0
财产(1946),财产,notion,0,1,1,0,1,1,0.013634,4,0.273332,0.292631,0
财产税(1946),财产税,notion,0,1,1,0,1,1,0.017626,4,0.281496,0.305894,0
财务(1946),财务,notion,0,1,1,0,3,3,0.005304,4,0.259537,0.268322,0
财富(1946),财富,notion,0,1,1,0,1,1,0.00826,4,0.264992,0.278237,0
财迷(1946),财迷,notion,0,1,1,0,1,1,0.013378,4,0.272039,0.290456,0
败降(1946),败降,notion,0,1,1,0,1,1,0.017626,4,0.281496,0.305894,0
货币(1946),货币,notion,0,1,1,0,1,1,0.005461,4,0.25793,0.265322,0
贪官污吏(1946),贪官污吏,notion,0,1,1,0,1,1,0.017626,4,0.281496,0.305894,0
贪污(1946),贪污,notion,0,1,1,0,1,1,0.018893,4,0.282798,0.307938,0
贪污案(1946),贪污案,notion,0,1,1,0,1,1,0.013634,4,0.273332,0.292631,0
贫乏(1946),贫乏,notion,0,1,1,0,1,1,0.005304,4,0.259537,0.268322,0
贫困(1946),贫困,notion,0,4,4,0,4,4,0.027653,4,0.288938,0.317548,3586.781881
贬值(1946),贬值,notion,0,1,1,0,1,1,0.004479,4,0.256686,0.262973,0
购买力(1946),购买力,notion,0,2,2,0,2,2,0.023271,4,0.287177,0.31475,1230.541816
购粮(1946),购粮,notion,0,1,1,0,1,1,0.013634,4,0.273332,0.292631,0
贵刊(1946),贵刊,notion,0,1,1,0,1,1,0.017626,4,0.281496,0.305894,0
贵妇(1946),贵妇,notion,0,1,1,0,1,1,0.013634,4,0.273332,0.292631,0
贵州(1946),贵州,notion,0,2,2,0,2,2,0.022501,4,0.28712,0.314663,997.953629
贵阳(1946),贵阳,notion,0,1,1,0,1,1,0.005461,4,0.25793,0.265322,0
贷学金(1946),贷学金,notion,0,1,1,0,2,2,0.005304,4,0.259537,0.268322,0
贷案(1946),贷案,notion,0,1,1,0,1,1,0.013634,4,0.273332,0.292631,0
贷款(1946),贷款,notion,0,1,1,0,1,1,0.0031,4,0.254504,0.258799,0
贷疑(1946),贷疑,notion,0,1,1,0,1,1,0.005461,4,0.25793,0.265322,0
贸易(1946),贸易,notion,0,2,2,0,2,2,0.036519,4,0.313896,0.3518,2490.161613
费劲(1946),费劲,notion,0,1,1,0,1,1,0.013634,4,0.273332,0.292631,0
费奥(1946),费奥,notion,0,1,1,0,1,1,0.013103,4,0.272684,0.291543,0
费孝通(1946),费孝通,notion,0,2,2,0,2,2,0.014214,4,0.272194,0.29079,872.497436
费正清(1946),费正清,notion,0,2,2,0,2,2,0.032271,4,0.301168,0.334971,1271.496707
贺词(1946),贺词,notion,0,1,1,0,2,2,0.013103,4,0.272684,0.291543,0
贺龙(1946),贺龙,notion,0,1,1,0,1,1,0.00826,4,0.264992,0.278237,0
贾克逊(1946),贾克逊,notion,0,1,1,0,1,1,0.004577,4,0.257676,0.264843,0
资产阶级(1946),资产阶级,notion,0,2,2,0,2,2,0.026481,4,0.292853,0.323187,1408.34579
资料(1946),资料,notion,0,1,1,0,1,1,0.005304,4,0.259537,0.268322,0
资本(1946),资本,notion,0,2,2,0,2,2,0.027011,4,0.292079,0.322056,1114.922273
资本家(1946),资本家,notion,0,2,2,0,2,2,0.031996,4,0.303907,0.338711,1883.718005
资格(1946),资格,notion,0,1,1,0,1,1,0.007159,4,0.261235,0.271453,0
资金(1946),资金,notion,0,1,1,0,1,1,0.018893,4,0.282798,0.307938,0
赈团(1946),赈团,notion,0,1,1,0,1,1,0.00826,4,0.264992,0.278237,0
赌博(1946),赌博,notion,0,1,1,0,1,1,0.018893,4,0.282798,0.307938,0
赌气(1946),赌气,notion,0,1,1,0,1,1,0.013378,4,0.272039,0.290456,0
赎罪(1946),赎罪,notion,0,1,1,0,1,1,0.013378,4,0.272039,0.290456,0
赔款(1946),赔款,notion,0,1,1,0,1,1,0.013103,4,0.272684,0.291543,0
赛特(1946),赛特,notion,0,1,1,0,1,1,0.013103,4,0.272684,0.291543,0
赛珍珠(1946),赛珍珠,notion,0,1,1,0,1,1,0.013634,4,0.273332,0.292631,0
赣西(1946),赣西,notion,0,1,1,0,1,1,0.003608,4,0.255568,0.260842,0
赤区(1946),赤区,notion,0,1,1,0,1,1,0.004237,4,0.256206,0.26206,0
赤卫队(1946),赤卫队,notion,0,1,1,0,1,1,0.013103,4,0.272684,0.291543,0
赫尔利(1946),赫尔利,notion,0,1,1,0,1,1,0.013103,4,0.272684,0.291543,0
赫赫战功(1946),赫赫战功,notion,0,1,1,0,1,1,0.00826,4,0.264992,0.278237,0
走上(1946),走上,notion,0,3,3,0,4,4,0.023259,4,0.287925,0.315953,4141.749375
走入(1946),走入,notion,0,1,1,0,1,1,0.013378,4,0.272039,0.290456,0
走向(1946),走向,notion,0,5,5,0,11,11,0.071516,4,0.378947,0.420377,21363.139634
赴美(1946),赴美,notion,0,1,1,0,1,1,0.018893,4,0.282798,0.307938,0
赵匡胤(1946),赵匡胤,notion,0,1,1,0,1,1,0.004237,4,0.256206,0.26206,0
赵树理(1946),赵树理,notion,0,1,1,0,1,1,0.018893,4,0.282798,0.307938,0
赶快(1946),赶快,notion,0,3,3,0,5,5,0.045904,4,0.321478,0.361266,4001.310187
起床(1946),起床,notion,0,1,1,0,1,1,0.004237,4,0.256206,0.26206,0
起来(1946),起来,notion,0,6,6,0,11,11,0.052735,4,0.323432,0.363831,9633.435918
起步(1946),起步,notion,0,1,1,0,1,1,0.005304,4,0.259537,0.268322,0
起点(1946),起点,notion,0,1,1,0,1,1,0.017626,4,0.281496,0.305894,0
起飞(1946),起飞,notion,0,1,1,0,1,1,0.009637,4,0.265506,0.27915,0
超越(1946),超越,notion,0,1,1,0,1,1,0.018893,4,0.282798,0.307938,0
越南(1946),越南,notion,0,2,2,0,2,2,0.012497,4,0.270554,0.288007,774.807195
越盟(1946),越盟,notion,0,1,1,0,1,1,0.018893,4,0.282798,0.307938,0
足恃乎(1946),足恃乎,notion,0,1,1,0,1,1,0.017626,4,0.281496,0.305894,0
足足(1946),足足,notion,0,1,1,0,1,1,0.007159,4,0.261235,0.271453,0
距离(1946),距离,notion,0,1,1,0,1,1,0.018893,4,0.282798,0.307938,0
路向(1946),路向,notion,0,2,2,0,2,2,0.021638,4,0.286262,0.313359,1666.282153
路数(1946),路数,notion,0,1,1,0,1,1,0.009637,4,0.265506,0.27915,0
跳荡(1946),跳荡,notion,0,1,1,0,1,1,0.003608,4,0.255568,0.260842,0
踏勘(1946),踏勘,notion,0,1,1,0,1,1,0.005304,4,0.259537,0.268322,0
踏着(1946),踏着,notion,0,3,3,0,3,3,0.040531,4,0.315723,0.354178,4919.220408
踏莎行(1946),踏莎行,notion,0,1,1,0,1,1,0.018893,4,0.282798,0.307938,0
身上(1946),身上,notion,0,1,1,0,1,1,0.009637,4,0.265506,0.27915,0
身份(1946),身份,notion,0,1,1,0,1,1,0.017626,4,0.281496,0.305894,0
身份证(1946),身份证,notion,0,1,1,0,1,1,0.005461,4,0.25793,0.265322,0
身历(1946),身历,notion,0,1,1,0,1,1,0.013634,4,0.273332,0.292631,0
身外之物(1946),身外之物,notion,0,1,1,0,1,1,0.013378,4,0.272039,0.290456,0
身边(1946),身边,notion,0,1,1,0,1,1,0.018893,4,0.282798,0.307938,0
輓歌(1946),輓歌,notion,0,1,1,0,1,1,0.001496,4,0.252204,0.25432,0
车上(1946),车上,notion,0,1,1,0,1,1,0.005304,4,0.259537,0.268322,0
车临(1946),车临,notion,0,1,1,0,1,1,0.005461,4,0.25793,0.265322,0
车夫(1946),车夫,notion,0,1,1,0,1,1,0.00826,4,0.264992,0.278237,0
车站(1946),车站,notion,0,2,2,0,2,2,0.027264,4,0.294896,0.326144,1405.794223
轨道(1946),轨道,notion,0,1,1,0,1,1,0.005304,4,0.259537,0.268322,0
转变(1946),转变,notion,0,3,3,0,5,5,0.037575,4,0.310942,0.34809,5120.881642
转向(1946),转向,notion,0,1,1,0,1,1,0.009637,4,0.265506,0.27915,0
转形(1946),转形,notion,0,1,1,0,1,1,0.013378,4,0.272039,0.290456,0
转换(1946),转换,notion,0,1,1,0,1,1,0.018893,4,0.282798,0.307938,0
转机(1946),转机,notion,0,1,1,0,1,1,0.004479,4,0.256686,0.262973,0
转移(1946),转移,notion,0,2,2,0,3,3,0.027011,4,0.292079,0.322056,1114.922273
转载(1946),转载,notion,0,1,1,0,1,1,0.013103,4,0.272684,0.291543,0
轮廓(1946),轮廓,notion,0,2,2,0,3,3,0.022931,4,0.290456,0.319664,2102.663893
轰动(1946),轰动,notion,0,3,3,0,3,3,0.050153,4,0.336337,0.378443,6304.552689
轰炸(1946),轰炸,notion,0,2,2,0,2,2,0.02853,4,0.295746,0.327361,1236.887723
较场口(1946),较场口,notion,0,3,3,0,5,5,0.01823,4,0.278577,0.301386,1587.057339
辛亥(1946),辛亥,notion,0,1,1,0,1,1,0.007159,4,0.261235,0.271453,0
辛亥革命(1946),辛亥革命,notion,0,1,1,0,1,1,0.018893,4,0.282798,0.307938,0
辛辣(1946),辛辣,notion,0,1,1,0,1,1,0.00826,4,0.264992,0.278237,0
辞职(1946),辞职,notion,0,3,3,0,3,3,0.041633,4,0.316488,0.355134,4230.538536
辣椒(1946),辣椒,notion,0,1,1,0,1,1,0.009637,4,0.265506,0.27915,0
辩证关系(1946),辩证关系,notion,0,1,1,0,1,1,0.013634,4,0.273332,0.292631,0
辱国(1946),辱国,notion,0,1,1,0,1,1,0.018893,4,0.282798,0.307938,0
辱骂(1946),辱骂,notion,0,1,1,0,2,2,0.018893,4,0.282798,0.307938,0
边疆(1946),边疆,notion,0,1,1,0,1,1,0.0031,4,0.254504,0.258799,0
边缘(1946),边缘,notion,0,1,1,0,1,1,0.013634,4,0.273332,0.292631,0
边陲(1946),边陲,notion,0,1,1,0,8,8,0.017626,4,0.281496,0.305894,0
达林(1946),达林,notion,0,2,2,0,2,2,0.027264,4,0.294896,0.326144,1405.794223
达格斯(1946),达格斯,notion,0,1,1,0,1,1,0.007159,4,0.261235,0.271453,0
达观(1946),达观,notion,0,1,1,0,1,1,0.017626,4,0.281496,0.305894,0
迁港(1946),迁港,notion,0,1,1,0,1,1,0.004479,4,0.256686,0.262973,0
迂回曲折(1946),迂回曲折,notion,0,1,1,0,1,1,0.013103,4,0.272684,0.291543,0
过分(1946),过分,notion,0,1,1,0,1,1,0.017626,4,0.281496,0.305894,0
过渡时期(1946),过渡时期,notion,0,1,1,0,1,1,0.013378,4,0.272039,0.290456,0
过程(1946),过程,notion,0,1,1,0,1,1,0.013103,4,0.272684,0.291543,0
迈步前进(1946),迈步前进,notion,0,1,1,0,1,1,0.018893,4,0.282798,0.307938,0
迈进(1946),迈进,notion,0,2,2,0,2,2,0.017941,4,0.27702,0.298791,611.724515
迎接(1946),迎接,notion,0,3,3,0,3,3,0.039264,4,0.317958,0.356961,6435.763293
迎春(1946),迎春,notion,0,1,1,0,1,1,0.018893,4,0.282798,0.307938,0
迎此(1946),迎此,notion,0,1,1,0,1,1,0.0031,4,0.254504,0.258799,0
迎马(1946),迎马,notion,0,1,1,0,1,1,0.013378,4,0.272039,0.290456,0
运动场(1946),运动场,notion,0,1,1,0,1,1,0.005304,4,0.259537,0.268322,0
运华(1946),运华,notion,0,1,1,0,1,1,0.018893,4,0.282798,0.307938,0
运命(1946),运命,notion,0,1,1,0,1,1,0.013103,4,0.272684,0.291543,0
运气(1946),运气,notion,0,1,1,0,1,1,0.017626,4,0.281496,0.305894,0
运用(1946),运用,notion,0,1,1,0,1,1,0.017626,4,0.281496,0.305894,0
近东(1946),近东,notion,0,1,1,0,2,2,0.013103,4,0.272684,0.291543,0
近事(1946),近事,notion,0,3,3,0,4,4,0.035497,4,0.308572,0.345002,3653.200008
近代(1946),近代,notion,0,3,3,0,3,3,0.027651,4,0.293152,0.323694,2289.643009
近作(1946),近作,notion,0,1,1,0,1,1,0.013634,4,0.273332,0.292631,0
近情(1946),近情,notion,0,1,1,0,2,2,0.017626,4,0.281496,0.305894,0
近闻(1946),近闻,notion,0,1,1,0,2,2,0.017626,4,0.281496,0.305894,0
返任(1946),返任,notion,0,2,2,0,2,2,0.023271,4,0.287177,0.31475,1230.541816
还政(1946),还政,notion,0,1,1,0,1,1,0.017626,4,0.281496,0.305894,0
还政于民(1946),还政于民,notion,0,1,1,0,1,1,0.009637,4,0.265506,0.27915,0
还是(1946),还是,notion,0,6,6,0,8,8,0.06718,4,0.349632,0.392793,14309.582326
还有(1946),还有,notion,0,2,2,0,2,2,0.032271,4,0.301168,0.334971,1271.496707
还给(1946),还给,notion,0,2,2,0,2,2,0.007845,4,0.261069,0.271221,313.925463
还要(1946),还要,notion,0,1,1,0,1,1,0.013634,4,0.273332,0.292631,0
还魂(1946),还魂,notion,0,1,1,0,1,1,0.013103,4,0.272684,0.291543,0
这么(1946),这么,notion,0,1,1,0,1,1,0.005304,4,0.259537,0.268322,0
这匹(1946),这匹,notion,0,1,1,0,1,1,0.018893,4,0.282798,0.307938,0
这是(1946),这是,notion,0,4,4,0,4,4,0.04243,4,0.316279,0.354946,7921.53985
这样(1946),这样,notion,0,2,2,0,2,2,0.032271,4,0.301168,0.334971,1271.496707
这样的话(1946),这样的话,notion,0,1,1,0,1,1,0.013378,4,0.272039,0.290456,0
这次(1946),这次,notion,0,2,2,0,2,2,0.011396,4,0.26654,0.281049,423.548007
这算(1946),这算,notion,0,1,1,0,1,1,0.018893,4,0.282798,0.307938,0
这里(1946),这里,notion,0,1,1,0,1,1,0.013103,4,0.272684,0.291543,0
进一解(1946),进一解,notion,0,2,2,0,2,2,0.013245,4,0.269995,0.28705,596.681008
进一言(1946),进一言,notion,0,1,1,0,1,1,0.005461,4,0.25793,0.265322,0
进修(1946),进修,notion,0,1,1,0,5,5,0.005304,4,0.259537,0.268322,0
进入(1946),进入,notion,0,1,1,0,1,1,0.018893,4,0.282798,0.307938,0
进军(1946),进军,notion,0,2,2,0,2,2,0.02313,4,0.287378,0.315055,697.222
进出口(1946),进出口,notion,0,1,1,0,1,1,0.017626,4,0.281496,0.305894,0
进化(1946),进化,notion,0,1,1,0,1,1,0.017626,4,0.281496,0.305894,0
进取(1946),进取,notion,0,1,1,0,1,1,0.017626,4,0.281496,0.305894,0
进展(1946),进展,notion,0,2,2,0,3,3,0.022204,4,0.287896,0.315838,1406.192172
进攻(1946),进攻,notion,0,2,2,0,2,2,0.032527,4,0.303393,0.338015,1614.891208
进步力量(1946),进步力量,notion,0,1,1,0,1,1,0.018893,4,0.282798,0.307938,0
进行曲(1946),进行曲,notion,0,1,1,0,1,1,0.007159,4,0.261235,0.271453,0
进言(1946),进言,notion,0,1,1,0,1,1,0.013378,4,0.272039,0.290456,0
进退(1946),进退,notion,0,1,1,0,1,1,0.00826,4,0.264992,0.278237,0
远东(1946),远东,notion,0,3,3,0,3,3,0.029264,4,0.296692,0.328782,2967.03912
远景(1946),远景,notion,0,1,1,0,1,1,0.017626,4,0.281496,0.305894,0
违反(1946),违反,notion,0,1,1,0,1,1,0.001496,4,0.252204,0.25432,0
违约(1946),违约,notion,0,1,1,0,1,1,0.017626,4,0.281496,0.305894,0
连写(1946),连写,notion,0,1,1,0,1,1,0.003608,4,0.255568,0.260842,0
连天(1946),连天,notion,0,1,1,0,1,1,0.013634,4,0.273332,0.292631,0
连环图画(1946),连环图画,notion,0,1,1,0,1,1,0.017626,4,0.281496,0.305894,0
连长(1946),连长,notion,0,1,1,0,1,1,0.00826,4,0.264992,0.278237,0
迟误(1946),迟误,notion,0,1,1,0,1,1,0.013378,4,0.272039,0.290456,0
迪化(1946),迪化,notion,0,1,1,0,1,1,0.017626,4,0.281496,0.305894,0
迫切(1946),迫切,notion,0,2,2,0,2,2,0.021993,4,0.286376,0.313533,863.759047
迷惘(1946),迷惘,notion,0,1,1,0,1,1,0.005304,4,0.259537,0.268322,0
迷梦(1946),迷梦,notion,0,2,2,0,2,2,0.02219,4,0.287062,0.314576,1087.606545
迷雾(1946),迷雾,notion,0,2,2,0,2,2,0.020262,4,0.282243,0.30714,1027.722249
追击(1946),追击,notion,0,1,1,0,1,1,0.013103,4,0.272684,0.291543,0
追忆(1946),追忆,notion,0,1,1,0,1,1,0.018893,4,0.282798,0.307938,0
追念(1946),追念,notion,0,1,1,0,1,1,0.013378,4,0.272039,0.290456,0
追悼(1946),追悼,notion,0,1,1,0,1,1,0.013378,4,0.272039,0.290456,0
追悼会(1946),追悼会,notion,0,3,3,0,3,3,0.037006,4,0.308307,0.344654,3214.406986
追慕(1946),追慕,notion,0,1,1,0,1,1,0.013103,4,0.272684,0.291543,0
追根穷源(1946),追根穷源,notion,0,1,1,0,1,1,0.00826,4,0.264992,0.278237,0
追索(1946),追索,notion,0,1,1,0,1,1,0.007159,4,0.261235,0.271453,0
追记(1946),追记,notion,0,2,2,0,2,2,0.009784,4,0.265751,0.279657,874.170092
退学(1946),退学,notion,0,1,1,0,1,1,0.013378,4,0.272039,0.290456,0
送来(1946),送来,notion,0,1,1,0,1,1,0.013634,4,0.273332,0.292631,0
逃兵(1946),逃兵,notion,0,2,2,0,2,2,0.021894,4,0.287839,0.315751,2020.708436
逃港(1946),逃港,notion,0,2,2,0,3,3,0.027153,4,0.296784,0.32884,1981.441549
逃票(1946),逃票,notion,0,1,1,0,1,1,0.005304,4,0.259537,0.268322,0
逃离(1946),逃离,notion,0,1,1,0,1,1,0.00826,4,0.264992,0.278237,0
逃难(1946),逃难,notion,0,1,1,0,1,1,0.005304,4,0.259537,0.268322,0
逆产(1946),逆产,notion,0,1,1,0,1,1,0.017626,4,0.281496,0.305894,0
逆我者亡(1946),逆我者亡,notion,0,1,1,0,1,1,0.013634,4,0.273332,0.292631,0
逆波(1946),逆波,notion,0,1,1,0,1,1,0.004564,4,0.256755,0.263104,0
逆耳之言(1946),逆耳之言,notion,0,1,1,0,1,1,0.013378,4,0.272039,0.290456,0
选举制(1946),选举制,notion,0,1,1,0,1,1,0.017626,4,0.281496,0.305894,0
选举票(1946),选举票,notion,0,1,1,0,1,1,0.007159,4,0.261235,0.271453,0
选择(1946),选择,notion,0,1,1,0,1,1,0.005304,4,0.259537,0.268322,0
选民(1946),选民,notion,0,1,1,0,1,1,0.017626,4,0.281496,0.305894,0
选都誌(1946),选都誌,notion,0,1,1,0,1,1,0.017626,4,0.281496,0.305894,0
逍遥法外(1946),逍遥法外,notion,0,1,1,0,1,1,0.013103,4,0.272684,0.291543,0
逐渐(1946),逐渐,notion,0,1,1,0,1,1,0.009637,4,0.265506,0.27915,0
途上(1946),途上,notion,0,3,3,0,3,3,0.028508,4,0.293571,0.324303,2285.315065
途中(1946),途中,notion,0,1,1,0,1,1,0.005304,4,0.259537,0.268322,0
途径(1946),途径,notion,0,3,3,0,3,3,0.022101,4,0.284449,0.310648,3533.33035
途艰(1946),途艰,notion,0,1,1,0,1,1,0.013378,4,0.272039,0.290456,0
通俗(1946),通俗,notion,0,2,2,0,2,2,0.021234,4,0.286205,0.313272,1214.025388
通益(1946),通益,notion,0,1,1,0,2,2,0.005304,4,0.259537,0.268322,0
逝者(1946),逝者,notion,0,1,1,0,1,1,0.009637,4,0.265506,0.27915,0
速写(1946),速写,notion,0,2,2,0,2,2,0.018407,4,0.281634,0.306184,1780.990245
速度(1946),速度,notion,0,1,1,0,1,1,0.00826,4,0.264992,0.278237,0
速捕(1946),速捕,notion,0,1,1,0,1,1,0.013378,4,0.272039,0.290456,0
造反(1946),造反,notion,0,1,1,0,1,1,0.018893,4,0.282798,0.307938,0
造成(1946),造成,notion,0,3,3,0,3,3,0.035568,4,0.307318,0.34335,3533.059203
逢凶化吉(1946),逢凶化吉,notion,0,1,1,0,1,1,0.013634,4,0.273332,0.292631,0
逮捕(1946),逮捕,notion,0,1,1,0,1,1,0.018893,4,0.282798,0.307938,0
週刊(1946),週刊,notion,0,2,2,0,2,2,0.022204,4,0.287896,0.315838,1406.192172
逼近(1946),逼近,notion,0,1,1,0,1,1,0.013103,4,0.272684,0.291543,0
遁辞(1946),遁辞,notion,0,1,1,0,1,1,0.017626,4,0.281496,0.305894,0
遇难(1946),遇难,notion,0,2,2,0,2,2,0.020389,4,0.284308,0.310358,712.812748
遍地(1946),遍地,notion,0,1,1,0,1,1,0.00826,4,0.264992,0.278237,0
遍韶市(1946),遍韶市,notion,0,1,1,0,1,1,0.00826,4,0.264992,0.278237,0
遏止(1946),遏止,notion,0,1,1,0,1,1,0.013378,4,0.272039,0.290456,0
道义(1946),道义,notion,0,1,1,0,1,1,0.013378,4,0.272039,0.290456,0
道席(1946),道席,notion,0,1,1,0,1,1,0.017626,4,0.281496,0.305894,0
道教(1946),道教,notion,0,1,1,0,1,1,0.017626,4,0.281496,0.305894,0
道断(1946),道断,notion,0,1,1,0,1,1,0.013634,4,0.273332,0.292631,0
道理(1946),道理,notion,0,2,2,0,2,2,0.027011,4,0.292079,0.322056,1114.922273
遗事(1946),遗事,notion,0,1,1,0,1,1,0.004577,4,0.257676,0.264843,0
遗传(1946),遗传,notion,0,1,1,0,1,1,0.004577,4,0.257676,0.264843,0
遗嘱(1946),遗嘱,notion,0,1,1,0,1,1,0.018893,4,0.282798,0.307938,0
遗墨(1946),遗墨,notion,0,1,1,0,1,1,0.013103,4,0.272684,0.291543,0
遗忘(1946),遗忘,notion,0,2,2,0,2,2,0.027264,4,0.294896,0.326144,1405.794223
遗教(1946),遗教,notion,0,2,2,0,2,2,0.006958,4,0.259631,0.268568,235.614975
遗族(1946),遗族,notion,0,1,1,0,1,1,0.017626,4,0.281496,0.305894,0
遥望(1946),遥望,notion,0,1,1,0,1,1,0.018893,4,0.282798,0.307938,0
遭受(1946),遭受,notion,0,2,2,0,2,2,0.026737,4,0.295411,0.326883,1969.400217
遭殃(1946),遭殃,notion,0,1,1,0,1,1,0.017626,4,0.281496,0.305894,0
遭逢(1946),遭逢,notion,0,1,1,0,1,1,0.0031,4,0.254504,0.258799,0
遵义(1946),遵义,notion,0,1,1,0,1,1,0.017626,4,0.281496,0.305894,0
避寿时(1946),避寿时,notion,0,1,1,0,1,1,0.007159,4,0.261235,0.271453,0
避役(1946),避役,notion,0,1,1,0,1,1,0.00826,4,0.264992,0.278237,0
邓初民(1946),邓初民,notion,0,1,1,0,1,1,0.003608,4,0.255568,0.260842,0
邓择生(1946),邓择生,notion,0,1,1,0,2,2,0.004564,4,0.256755,0.263104,0
邓演达(1946),邓演达,notion,0,2,2,0,5,5,0.009043,4,0.262236,0.273352,284.685012
邓黄(1946),邓黄,notion,0,1,1,0,1,1,0.013378,4,0.272039,0.290456,0
那些(1946),那些,notion,0,1,1,0,1,1,0.013378,4,0.272039,0.290456,0
那天(1946),那天,notion,0,1,1,0,1,1,0.013634,4,0.273332,0.292631,0
邦交(1946),邦交,notion,0,1,1,0,1,1,0.017626,4,0.281496,0.305894,0
邦国殄瘁(1946),邦国殄瘁,notion,0,1,1,0,1,1,0.004564,4,0.256755,0.263104,0
邮政(1946),邮政,notion,0,1,1,0,1,1,0.013634,4,0.273332,0.292631,0
邮电(1946),邮电,notion,0,1,1,0,1,1,0.004564,4,0.256755,0.263104,0
邱吉(1946),邱吉,notion,0,1,1,0,1,1,0.013378,4,0.272039,0.290456,0
邱吉而(1946),邱吉而,notion,0,1,1,0,1,1,0.013378,4,0.272039,0.290456,0
邹容(1946),邹容,notion,0,1,1,0,1,1,0.017626,4,0.281496,0.305894,0
邹秉文(1946),邹秉文,notion,0,1,1,0,1,1,0.004577,4,0.257676,0.264843,0
邹韬奋(1946),邹韬奋,notion,0,1,1,0,1,1,0.013378,4,0.272039,0.290456,0
郁达夫(1946),郁达夫,notion,0,3,3,0,5,5,0.035627,4,0.306924,0.342828,3209.801402
郁逵(1946),郁逵,notion,0,1,1,0,1,1,0.013378,4,0.272039,0.290456,0
郁香(1946),郁香,notion,0,1,1,0,1,1,0.018893,4,0.282798,0.307938,0
部队(1946),部队,notion,0,1,1,0,1,1,0.00826,4,0.264992,0.278237,0
郭沫若(1946),郭沫若,notion,0,1,1,0,1,1,0.018893,4,0.282798,0.307938,0
郭逆(1946),郭逆,notion,0,1,1,0,1,1,0.00826,4,0.264992,0.278237,0
都城(1946),都城,notion,0,1,1,0,1,1,0.017626,4,0.281496,0.305894,0
都市(1946),都市,notion,0,1,1,0,1,1,0.018893,4,0.282798,0.307938,0
鄕村(1946),鄕村,notion,0,1,1,0,1,1,0.017626,4,0.281496,0.305894,0
配有(1946),配有,notion,0,1,1,0,1,1,0.013378,4,0.272039,0.290456,0
酒楼(1946),酒楼,notion,0,1,1,0,1,1,0.00826,4,0.264992,0.278237,0
酝酿(1946),酝酿,notion,0,2,2,0,2,2,0.025886,4,0.296968,0.329101,2935.752997
酷刑(1946),酷刑,notion,0,1,1,0,1,1,0.013634,4,0.273332,0.292631,0
采职叶(1946),采职叶,notion,0,1,1,0,1,1,0.017626,4,0.281496,0.305894,0
采访(1946),采访,notion,0,2,2,0,2,2,0.036519,4,0.313896,0.3518,2490.161613
采风(1946),采风,notion,0,2,2,0,2,2,0.022931,4,0.290456,0.319664,2102.663893
释和(1946),释和,notion,0,1,1,0,1,1,0.013634,4,0.273332,0.292631,0
释放(1946),释放,notion,0,2,2,0,3,3,0.017871,4,0.277958,0.300313,580.923774
重临(1946),重临,notion,0,2,2,0,2,2,0.03126,4,0.304035,0.338885,2199.499867
重典(1946),重典,notion,0,1,1,0,1,1,0.005304,4,0.259537,0.268322,0
重压(1946),重压,notion,0,1,1,0,1,1,0.013378,4,0.272039,0.290456,0
重大(1946),重大,notion,0,3,3,0,3,3,0.024964,4,0.289695,0.318606,1888.203672
重工业(1946),重工业,notion,0,1,1,0,1,1,0.013103,4,0.272684,0.291543,0
重建(1946),重建,notion,0,2,2,0,2,2,0.007677,4,0.261592,0.272178,462.162807
重开(1946),重开,notion,0,3,3,0,4,4,0.050153,4,0.336337,0.378443,6304.552689
重担(1946),重担,notion,0,1,1,0,1,1,0.013378,4,0.272039,0.290456,0
重新(1946),重新,notion,0,2,2,0,2,2,0.027153,4,0.296784,0.32884,1981.441549
重演(1946),重演,notion,0,1,1,0,1,1,0.017626,4,0.281496,0.305894,0
重行(1946),重行,notion,0,1,1,0,1,1,0.013378,4,0.272039,0.290456,0
重要(1946),重要,notion,0,6,6,0,10,10,0.064534,4,0.350485,0.393663,15623.320002
重见(1946),重见,notion,0,1,1,0,1,1,0.013634,4,0.273332,0.292631,0
重蹈(1946),重蹈,notion,0,1,1,0,1,1,0.004237,4,0.256206,0.26206,0
重选(1946),重选,notion,0,3,3,0,3,3,0.026738,4,0.291605,0.321433,2009.101092
重重(1946),重重,notion,0,2,2,0,2,2,0.025886,4,0.296968,0.329101,2935.752997
重重的(1946),重重的,notion,0,1,1,0,1,1,0.00826,4,0.264992,0.278237,0
重镇(1946),重镇,notion,0,1,1,0,1,1,0.017626,4,0.281496,0.305894,0
量尺(1946),量尺,notion,0,1,1,0,1,1,0.005304,4,0.259537,0.268322,0
金元(1946),金元,notion,0,1,1,0,1,1,0.017626,4,0.281496,0.305894,0
金圆(1946),金圆,notion,0,1,1,0,1,1,0.013378,4,0.272039,0.290456,0
金翅雀(1946),金翅雀,notion,0,1,1,0,1,1,0.013103,4,0.272684,0.291543,0
金融(1946),金融,notion,0,4,4,0,7,7,0.044451,4,0.325372,0.365991,9670.917017
钞票(1946),钞票,notion,0,1,1,0,1,1,0.004479,4,0.256686,0.262973,0
钟声(1946),钟声,notion,0,1,1,0,1,1,0.018893,4,0.282798,0.307938,0
钟头(1946),钟头,notion,0,1,1,0,1,1,0.007159,4,0.261235,0.271453,0
钥匙(1946),钥匙,notion,0,2,2,0,2,2,0.032527,4,0.303393,0.338015,1614.891208
钦定(1946),钦定,notion,0,1,1,0,1,1,0.013634,4,0.273332,0.292631,0
钮扣(1946),钮扣,notion,0,1,1,0,1,1,0.013103,4,0.272684,0.291543,0
钱素(1946),钱素,notion,0,1,1,0,1,1,0.013634,4,0.273332,0.292631,0
铁壁(1946),铁壁,notion,0,1,1,0,1,1,0.00826,4,0.264992,0.278237,0
铁幕(1946),铁幕,notion,0,2,2,0,2,2,0.023015,4,0.2849,0.311272,897.577022
铁蹄(1946),铁蹄,notion,0,1,1,0,1,1,0.013378,4,0.272039,0.290456,0
铜仁(1946),铜仁,notion,0,1,1,0,1,1,0.017626,4,0.281496,0.305894,0
铺子(1946),铺子,notion,0,1,1,0,1,1,0.013378,4,0.272039,0.290456,0
链球菌(1946),链球菌,notion,0,1,1,0,1,1,0.017626,4,0.281496,0.305894,0
锁得(1946),锁得,notion,0,1,1,0,1,1,0.013378,4,0.272039,0.290456,0
锁钥(1946),锁钥,notion,0,1,1,0,1,1,0.004564,4,0.256755,0.263104,0
锄奸(1946),锄奸,notion,0,1,1,0,1,1,0.013378,4,0.272039,0.290456,0
错失(1946),错失,notion,0,1,1,0,1,1,0.009637,4,0.265506,0.27915,0
错字(1946),错字,notion,0,1,1,0,1,1,0.007159,4,0.261235,0.271453,0
错综(1946),错综,notion,0,1,1,0,1,1,0.009637,4,0.265506,0.27915,0
错觉(1946),错觉,notion,0,2,2,0,2,2,0.03126,4,0.304035,0.338885,2199.499867
错误行为(1946),错误行为,notion,0,1,1,0,1,1,0.017626,4,0.281496,0.305894,0
锦城(1946),锦城,notion,0,1,1,0,1,1,0.017626,4,0.281496,0.305894,0
锦片(1946),锦片,notion,0,1,1,0,1,1,0.017626,4,0.281496,0.305894,0
镇江(1946),镇江,notion,0,1,1,0,1,1,0.017626,4,0.281496,0.305894,0
镜子(1946),镜子,notion,0,1,1,0,1,1,0.013378,4,0.272039,0.290456,0
长安(1946),长安,notion,0,1,1,0,1,1,0.017626,4,0.281496,0.305894,0
长安道上(1946),长安道上,notion,0,1,1,0,1,1,0.013634,4,0.273332,0.292631,0
长成(1946),长成,notion,0,1,1,0,1,1,0.017626,4,0.281496,0.305894,0
长期(1946),长期,notion,0,5,5,0,5,5,0.05214,4,0.336258,0.378501,13670.461542
长胜(1946),长胜,notion,0,1,1,0,1,1,0.00826,4,0.264992,0.278237,0
閒话(1946),閒话,notion,0,1,1,0,1,1,0.017626,4,0.281496,0.305894,0
门户开放(1946),门户开放,notion,0,2,2,0,3,3,0.026052,4,0.291576,0.321317,1054.556401
门槛(1946),门槛,notion,0,1,1,0,1,1,0.004479,4,0.256686,0.262973,0
闪耀(1946),闪耀,notion,0,1,1,0,1,1,0.018893,4,0.282798,0.307938,0
闭会(1946),闭会,notion,0,1,1,0,1,1,0.018893,4,0.282798,0.307938,0
闭幕(1946),闭幕,notion,0,3,3,0,4,4,0.044638,4,0.323432,0.363614,5148.150283
闲话(1946),闲话,notion,0,3,3,0,3,3,0.040786,4,0.31831,0.357395,5617.041193
间接(1946),间接,notion,0,1,1,0,1,1,0.009637,4,0.265506,0.27915,0
闷烧(1946),闷烧,notion,0,1,1,0,1,1,0.013103,4,0.272684,0.291543,0
闷热(1946),闷热,notion,0,1,1,0,1,1,0.009637,4,0.265506,0.27915,0
闻人(1946),闻人,notion,0,1,1,0,1,1,0.018893,4,0.282798,0.307938,0
闻先生(1946),闻先生,notion,0,1,1,0,1,1,0.003608,4,0.255568,0.260842,0
闻其声(1946),闻其声,notion,0,1,1,0,1,1,0.013634,4,0.273332,0.292631,0
闻见(1946),闻见,notion,0,2,2,0,2,2,0.013874,4,0.270198,0.287398,402.340627
闽南(1946),闽南,notion,0,1,1,0,1,1,0.013634,4,0.273332,0.292631,0
阎锡山(1946),阎锡山,notion,0,1,1,0,1,1,0.005461,4,0.25793,0.265322,0
防线(1946),防线,notion,0,1,1,0,1,1,0.013103,4,0.272684,0.291543,0
阳光(1946),阳光,notion,0,2,2,0,2,2,0.021993,4,0.286376,0.313533,863.759047
阳奉阴违(1946),阳奉阴违,notion,0,2,2,0,2,2,0.009698,4,0.262356,0.273569,160.636246
阴影(1946),阴影,notion,0,1,1,0,1,1,0.00826,4,0.264992,0.278237,0
阴晴不定(1946),阴晴不定,notion,0,1,1,0,1,1,0.017626,4,0.281496,0.305894,0
阴郁(1946),阴郁,notion,0,1,1,0,1,1,0.013634,4,0.273332,0.292631,0
阴魂(1946),阴魂,notion,0,1,1,0,1,1,0.013634,4,0.273332,0.292631,0
阵线(1946),阵线,notion,0,1,1,0,1,1,0.013634,4,0.273332,0.292631,0
阵营(1946),阵营,notion,0,1,1,0,1,1,0.017626,4,0.281496,0.305894,0
阶段(1946),阶段,notion,0,3,3,0,3,3,0.045904,4,0.321478,0.361266,4001.310187
阻力(1946),阻力,notion,0,1,1,0,1,1,0.017626,4,0.281496,0.305894,0
阻挠(1946),阻挠,notion,0,1,1,0,2,2,0.017626,4,0.281496,0.305894,0
阻止(1946),阻止,notion,0,1,1,0,1,1,0.018893,4,0.282798,0.307938,0
阻难(1946),阻难,notion,0,1,1,0,1,1,0.005461,4,0.25793,0.265322,0
阿Q(1946),阿Q,notion,0,2,2,0,2,2,0.020536,4,0.280891,0.30501,760.639997
阿富汗(1946),阿富汗,notion,0,1,1,0,1,1,0.013103,4,0.272684,0.291543,0
阿普莱丁致(1946),阿普莱丁致,notion,0,1,1,0,1,1,0.013103,4,0.272684,0.291543,0
阿根廷(1946),阿根廷,notion,0,1,1,0,1,1,0.013103,4,0.272684,0.291543,0
陀索娃(1946),陀索娃,notion,0,1,1,0,1,1,0.013103,4,0.272684,0.291543,0
附庸(1946),附庸,notion,0,1,1,0,1,1,0.018893,4,0.282798,0.307938,0
附庸国(1946),附庸国,notion,0,1,1,0,1,1,0.018893,4,0.282798,0.307938,0
附录(1946),附录,notion,0,1,1,0,1,1,0.013103,4,0.272684,0.291543,0
际遇(1946),际遇,notion,0,1,1,0,1,1,0.013378,4,0.272039,0.290456,0
陆丰(1946),陆丰,notion,0,1,1,0,2,2,0.004479,4,0.256686,0.262973,0
陈光甫(1946),陈光甫,notion,0,1,1,0,1,1,0.0031,4,0.254504,0.258799,0
陈公博(1946),陈公博,notion,0,1,1,0,2,2,0.013634,4,0.273332,0.292631,0
陈喜庚(1946),陈喜庚,notion,0,1,1,0,1,1,0.007159,4,0.261235,0.271453,0
陈嘉庚(1946),陈嘉庚,notion,0,1,1,0,1,1,0.018893,4,0.282798,0.307938,0
陈士(1946),陈士,notion,0,1,1,0,1,1,0.00826,4,0.264992,0.278237,0
陈小姐(1946),陈小姐,notion,0,1,1,0,1,1,0.018893,4,0.282798,0.307938,0
陈立夫(1946),陈立夫,notion,0,1,1,0,1,1,0.009637,4,0.265506,0.27915,0
陈纳德(1946),陈纳德,notion,0,1,1,0,1,1,0.018893,4,0.282798,0.307938,0
陈郁兰(1946),陈郁兰,notion,0,1,1,0,1,1,0.018893,4,0.282798,0.307938,0
降生(1946),降生,notion,0,1,1,0,1,1,0.004564,4,0.256755,0.263104,0
限写(1946),限写,notion,0,1,1,0,1,1,0.007159,4,0.261235,0.271453,0
限度(1946),限度,notion,0,2,2,0,2,2,0.023456,4,0.28781,0.315707,881.141468
陕西(1946),陕西,notion,0,3,3,0,3,3,0.050153,4,0.336337,0.378443,6304.552689
院长(1946),院长,notion,0,3,3,0,3,3,0.040999,4,0.319194,0.358483,4429.485077
除夕(1946),除夕,notion,0,1,1,0,1,1,0.013378,4,0.272039,0.290456,0
陪部(1946),陪部,notion,0,1,1,0,1,1,0.018893,4,0.282798,0.307938,0
陶孟(1946),陶孟,notion,0,1,1,0,1,1,0.013378,4,0.272039,0.290456,0
陶李(1946),陶李,notion,0,1,1,0,1,1,0.013634,4,0.273332,0.292631,0
陶行知(1946),陶行知,notion,0,7,7,0,15,15,0.066683,4,0.349165,0.392387,19358.755311
陷害(1946),陷害,notion,0,1,1,0,1,1,0.00826,4,0.264992,0.278237,0
隋唐(1946),隋唐,notion,0,1,1,0,1,1,0.017626,4,0.281496,0.305894,0
随感(1946),随感,notion,0,1,1,0,1,1,0.013103,4,0.272684,0.291543,0
随行(1946),随行,notion,0,1,1,0,1,1,0.018893,4,0.282798,0.307938,0
隐优(1946),隐优,notion,0,1,1,0,1,1,0.005461,4,0.25793,0.265322,0
隔离(1946),隔离,notion,0,1,1,0,1,1,0.009637,4,0.265506,0.27915,0
隶属(1946),隶属,notion,0,1,1,0,1,1,0.017626,4,0.281496,0.305894,0
难于(1946),难于,notion,0,1,1,0,1,1,0.009637,4,0.265506,0.27915,0
难产(1946),难产,notion,0,4,4,0,4,4,0.048792,4,0.325483,0.366122,7066.55287
难关(1946),难关,notion,0,2,2,0,2,2,0.013874,4,0.270198,0.287398,402.340627
难分(1946),难分,notion,0,1,1,0,1,1,0.00826,4,0.264992,0.278237,0
难开(1946),难开,notion,0,1,1,0,1,1,0.017626,4,0.281496,0.305894,0
难得(1946),难得,notion,0,1,1,0,1,1,0.013378,4,0.272039,0.290456,0
难民(1946),难民,notion,0,3,3,0,3,3,0.050153,4,0.336337,0.378443,6304.552689
难胞(1946),难胞,notion,0,1,1,0,1,1,0.001496,4,0.252204,0.25432,0
难见(1946),难见,notion,0,1,1,0,1,1,0.013634,4,0.273332,0.292631,0
难道(1946),难道,notion,0,1,1,0,1,1,0.018893,4,0.282798,0.307938,0
雄伟(1946),雄伟,notion,0,1,1,0,1,1,0.004564,4,0.256755,0.263104,0
雄辩(1946),雄辩,notion,0,1,1,0,1,1,0.005304,4,0.259537,0.268322,0
集中(1946),集中,notion,0,2,2,0,2,2,0.025886,4,0.296968,0.329101,2935.752997
集中营(1946),集中营,notion,0,1,1,0,1,1,0.004237,4,0.256206,0.26206,0
集会(1946),集会,notion,0,2,2,0,2,2,0.024197,4,0.292198,0.32223,2288.2854
集会结社(1946),集会结社,notion,0,1,1,0,1,1,0.017626,4,0.281496,0.305894,0
集团(1946),集团,notion,0,2,2,0,2,2,0.02853,4,0.295746,0.327361,1236.887723
集子(1946),集子,notion,0,1,1,0,1,1,0.017626,4,0.281496,0.305894,0
集评(1946),集评,notion,0,1,1,0,1,1,0.00826,4,0.264992,0.278237,0
集锦(1946),集锦,notion,0,1,1,0,1,1,0.013378,4,0.272039,0.290456,0
雕刻(1946),雕刻,notion,0,1,1,0,1,1,0.013103,4,0.272684,0.291543,0
雪亮(1946),雪亮,notion,0,1,1,0,1,1,0.004237,4,0.256206,0.26206,0
雪茄烟(1946),雪茄烟,notion,0,1,1,0,1,1,0.018893,4,0.282798,0.307938,0
零食(1946),零食,notion,0,1,1,0,1,1,0.018893,4,0.282798,0.307938,0
雷海宗(1946),雷海宗,notion,0,1,1,0,1,1,0.018893,4,0.282798,0.307938,0
雷雨(1946),雷雨,notion,0,1,1,0,2,2,0.007159,4,0.261235,0.271453,0
雷风(1946),雷风,notion,0,1,1,0,1,1,0.017626,4,0.281496,0.305894,0
青城(1946),青城,notion,0,1,1,0,1,1,0.004577,4,0.257676,0.264843,0
青岛(1946),青岛,notion,0,2,2,0,3,3,0.018938,4,0.282437,0.307445,1861.68946
青干班(1946),青干班,notion,0,1,1,0,1,1,0.00826,4,0.264992,0.278237,0
青年人(1946),青年人,notion,0,1,1,0,1,1,0.004237,4,0.256206,0.26206,0
青年会(1946),青年会,notion,0,1,1,0,1,1,0.009637,4,0.265506,0.27915,0
青年党(1946),青年党,notion,0,3,3,0,6,6,0.027609,4,0.292169,0.322259,1829.233659
青年团(1946),青年团,notion,0,1,1,0,1,1,0.017626,4,0.281496,0.305894,0
青年节(1946),青年节,notion,0,1,1,0,1,1,0.017626,4,0.281496,0.305894,0
青春(1946),青春,notion,0,2,2,0,2,2,0.030729,4,0.302946,0.337407,2092.27198
青菜(1946),青菜,notion,0,1,1,0,1,1,0.018893,4,0.282798,0.307938,0
青诚(1946),青诚,notion,0,1,1,0,1,1,0.017626,4,0.281496,0.305894,0
静默(1946),静默,notion,0,1,1,0,1,1,0.007159,4,0.261235,0.271453,0
非正式(1946),非正式,notion,0,1,1,0,1,1,0.013378,4,0.272039,0.290456,0
非法(1946),非法,notion,0,2,2,0,2,2,0.019095,4,0.279064,0.302096,590.998645
面临(1946),面临,notion,0,1,1,0,1,1,0.013634,4,0.273332,0.292631,0
面包(1946),面包,notion,0,1,1,0,1,1,0.005304,4,0.259537,0.268322,0
面对(1946),面对,notion,0,2,2,0,2,2,0.032271,4,0.301168,0.334971,1271.496707
面粉(1946),面粉,notion,0,1,1,0,1,1,0.007159,4,0.261235,0.271453,0
面面观(1946),面面观,notion,0,1,1,0,1,1,0.017626,4,0.281496,0.305894,0
革命军(1946),革命军,notion,0,1,1,0,1,1,0.017626,4,0.281496,0.305894,0
革命史(1946),革命史,notion,0,1,1,0,1,1,0.005304,4,0.259537,0.268322,0
革新(1946),革新,notion,0,1,1,0,1,1,0.017626,4,0.281496,0.305894,0
革新运动(1946),革新运动,notion,0,1,1,0,1,1,0.018893,4,0.282798,0.307938,0
鞑虏(1946),鞑虏,notion,0,1,1,0,1,1,0.007159,4,0.261235,0.271453,0
鞑靼(1946),鞑靼,notion,0,1,1,0,1,1,0.009637,4,0.265506,0.27915,0
鞭策(1946),鞭策,notion,0,1,1,0,1,1,0.013634,4,0.273332,0.292631,0
韧力(1946),韧力,notion,0,1,1,0,1,1,0.0031,4,0.254504,0.258799,0
韧性(1946),韧性,notion,0,2,2,0,2,2,0.013564,4,0.274324,0.294356,2085.288442
韬奋(1946),韬奋,notion,0,3,3,0,11,11,0.040531,4,0.315723,0.354178,4919.220408
音乐堂(1946),音乐堂,notion,0,1,1,0,1,1,0.018893,4,0.282798,0.307938,0
音乐性(1946),音乐性,notion,0,1,1,0,1,1,0.004577,4,0.257676,0.264843,0
音容宛在(1946),音容宛在,notion,0,1,1,0,1,1,0.013634,4,0.273332,0.292631,0
音讯(1946),音讯,notion,0,1,1,0,1,1,0.007159,4,0.261235,0.271453,0
顶好(1946),顶好,notion,0,2,2,0,2,2,0.020262,4,0.282243,0.30714,1027.722249
项城(1946),项城,notion,0,1,1,0,1,1,0.013378,4,0.272039,0.290456,0
须重(1946),须重,notion,0,1,1,0,1,1,0.0031,4,0.254504,0.258799,0
顽固(1946),顽固,notion,0,3,3,0,3,3,0.027454,4,0.292287,0.322433,1900.211044
顽强(1946),顽强,notion,0,1,1,0,1,1,0.018893,4,0.282798,0.307938,0
顾影自怜(1946),顾影自怜,notion,0,1,1,0,1,1,0.013634,4,0.273332,0.292631,0
顾问(1946),顾问,notion,0,1,1,0,2,2,0.004577,4,0.257676,0.264843,0
顿趋(1946),顿趋,notion,0,1,1,0,1,1,0.018893,4,0.282798,0.307938,0
预备(1946),预备,notion,0,1,1,0,1,1,0.018893,4,0.282798,0.307938,0
预定(1946),预定,notion,0,1,1,0,1,1,0.017626,4,0.281496,0.305894,0
预祝(1946),预祝,notion,0,1,1,0,1,1,0.004237,4,0.256206,0.26206,0
预见(1946),预见,notion,0,1,1,0,1,1,0.00826,4,0.264992,0.278237,0
领土(1946),领土,notion,0,1,1,0,1,1,0.013103,4,0.272684,0.291543,0
领导(1946),领导,notion,0,4,4,0,5,5,0.054102,4,0.341775,0.384429,9269.71724
题丁聪兄(1946),题丁聪兄,notion,0,1,1,0,1,1,0.018893,4,0.282798,0.307938,0
题记(1946),题记,notion,0,1,1,0,1,1,0.013634,4,0.273332,0.292631,0
题词(1946),题词,notion,0,2,2,0,5,5,0.026737,4,0.295411,0.326883,1969.400217
风俗习惯(1946),风俗习惯,notion,0,1,1,0,1,1,0.00826,4,0.264992,0.278237,0
风光(1946),风光,notion,0,1,1,0,1,1,0.00826,4,0.264992,0.278237,0
风向(1946),风向,notion,0,1,1,0,1,1,0.007159,4,0.261235,0.271453,0
风土(1946),风土,notion,0,1,1,0,1,1,0.017626,4,0.281496,0.305894,0
风尚(1946),风尚,notion,0,1,1,0,1,1,0.017626,4,0.281496,0.305894,0
风景(1946),风景,notion,0,1,1,0,4,4,0.017626,4,0.281496,0.305894,0
风景线(1946),风景线,notion,0,2,2,0,6,6,0.025886,4,0.296968,0.329101,2935.752997
风暴(1946),风暴,notion,0,2,2,0,2,2,0.032527,4,0.303393,0.338015,1614.891208
风格(1946),风格,notion,0,2,2,0,2,2,0.030729,4,0.302946,0.337407,2092.27198
风沙(1946),风沙,notion,0,1,1,0,1,1,0.017626,4,0.281496,0.305894,0
风波(1946),风波,notion,0,2,2,0,2,2,0.036519,4,0.313896,0.3518,2490.161613
风潮(1946),风潮,notion,0,4,4,0,4,4,0.045135,4,0.322055,0.362034,6691.876674
风砂(1946),风砂,notion,0,1,1,0,1,1,0.004564,4,0.256755,0.263104,0
风雨(1946),风雨,notion,0,4,4,0,4,4,0.044909,4,0.320868,0.360599,8695.907444
风雪(1946),风雪,notion,0,1,1,0,1,1,0.018893,4,0.282798,0.307938,0
飞去(1946),飞去,notion,0,2,2,0,2,2,0.020389,4,0.284308,0.310358,712.812748
食堂(1946),食堂,notion,0,1,1,0,1,1,0.005304,4,0.259537,0.268322,0
饑荒(1946),饑荒,notion,0,1,1,0,1,1,0.017626,4,0.281496,0.305894,0
饥民(1946),饥民,notion,0,2,2,0,2,2,0.015419,4,0.27556,0.296399,1296.225957
饥荒(1946),饥荒,notion,0,4,4,0,4,4,0.04501,4,0.320475,0.360121,7227.357688
饥饿(1946),饥饿,notion,0,3,3,0,6,6,0.039685,4,0.312463,0.350046,3732.208643
饥馑(1946),饥馑,notion,0,1,1,0,1,1,0.017626,4,0.281496,0.305894,0
饮酒(1946),饮酒,notion,0,1,1,0,1,1,0.013103,4,0.272684,0.291543,0
饰物(1946),饰物,notion,0,1,1,0,1,1,0.013634,4,0.273332,0.292631,0
饶舌(1946),饶舌,notion,0,1,1,0,1,1,0.013378,4,0.272039,0.290456,0
馆长(1946),馆长,notion,0,1,1,0,1,1,0.013634,4,0.273332,0.292631,0
首在(1946),首在,notion,0,1,1,0,1,1,0.017626,4,0.281496,0.305894,0
首届(1946),首届,notion,0,1,1,0,1,1,0.017626,4,0.281496,0.305894,0
首府(1946),首府,notion,0,1,1,0,1,1,0.013103,4,0.272684,0.291543,0
首途(1946),首途,notion,0,1,1,0,1,1,0.013634,4,0.273332,0.292631,0
首都(1946),首都,notion,0,2,2,0,2,2,0.022931,4,0.290456,0.319664,2102.663893
香港(1946),香港,notion,0,4,4,0,5,5,0.049259,4,0.334731,0.376732,10142.152859
马先生(1946),马先生,notion,0,1,1,0,1,1,0.013378,4,0.272039,0.290456,0
马克思(1946),马克思,notion,0,1,1,0,1,1,0.009637,4,0.265506,0.27915,0
马公(1946),马公,notion,0,1,1,0,1,1,0.004577,4,0.257676,0.264843,0
马凡(1946),马凡,notion,0,1,1,0,1,1,0.018893,4,0.282798,0.307938,0
马凡陀(1946),马凡陀,notion,0,1,1,0,1,1,0.018893,4,0.282798,0.307938,0
马利亚(1946),马利亚,notion,0,1,1,0,1,1,0.004577,4,0.257676,0.264843,0
马司(1946),马司,notion,0,3,3,0,4,4,0.042164,4,0.316662,0.355352,4082.320747
马后炮(1946),马后炮,notion,0,1,1,0,1,1,0.013634,4,0.273332,0.292631,0
马寅初(1946),马寅初,notion,0,1,1,0,1,1,0.0031,4,0.254504,0.258799,0
马帅(1946),马帅,notion,0,1,1,0,1,1,0.013378,4,0.272039,0.290456,0
马来亚(1946),马来亚,notion,0,1,1,0,1,1,0.013634,4,0.273332,0.292631,0
马歇(1946),马歇,notion,0,1,1,0,1,1,0.013378,4,0.272039,0.290456,0
马相伯(1946),马相伯,notion,0,1,1,0,1,1,0.017626,4,0.281496,0.305894,0
马茨坦(1946),马茨坦,notion,0,1,1,0,1,1,0.018893,4,0.282798,0.307938,0
马路(1946),马路,notion,0,1,1,0,1,1,0.018893,4,0.282798,0.307938,0
驱逐(1946),驱逐,notion,0,1,1,0,1,1,0.007159,4,0.261235,0.271453,0
驳正(1946),驳正,notion,0,1,1,0,1,1,0.009637,4,0.265506,0.27915,0
驻军(1946),驻军,notion,0,5,5,0,7,7,0.072638,4,0.370879,0.413202,15629.914012
驻华(1946),驻华,notion,0,2,2,0,2,2,0.012739,4,0.270758,0.288354,795.473237
驻华大使(1946),驻华大使,notion,0,1,1,0,1,1,0.013103,4,0.272684,0.291543,0
驻外(1946),驻外,notion,0,1,1,0,1,1,0.013103,4,0.272684,0.291543,0
驻沪(1946),驻沪,notion,0,1,1,0,1,1,0.013103,4,0.272684,0.291543,0
驻英(1946),驻英,notion,0,1,1,0,1,1,0.009637,4,0.265506,0.27915,0
骄傲(1946),骄傲,notion,0,1,1,0,1,1,0.018893,4,0.282798,0.307938,0
骗局(1946),骗局,notion,0,2,2,0,2,2,0.012823,4,0.270988,0.288746,913.401999
骗惯(1946),骗惯,notion,0,1,1,0,1,1,0.013378,4,0.272039,0.290456,0
骚动(1946),骚动,notion,0,1,1,0,1,1,0.004479,4,0.256686,0.262973,0
高不可攀(1946),高不可攀,notion,0,1,1,0,1,1,0.013103,4,0.272684,0.291543,0
高中(1946),高中,notion,0,1,1,0,1,1,0.017626,4,0.281496,0.305894,0
高利率(1946),高利率,notion,0,1,1,0,1,1,0.017626,4,0.281496,0.305894,0
高利贷(1946),高利贷,notion,0,1,1,0,1,1,0.007159,4,0.261235,0.271453,0
高加索(1946),高加索,notion,0,1,1,0,1,1,0.013103,4,0.272684,0.291543,0
高声(1946),高声,notion,0,1,1,0,1,1,0.018893,4,0.282798,0.307938,0
高宝(1946),高宝,notion,0,1,1,0,1,1,0.013634,4,0.273332,0.292631,0
高尔史(1946),高尔史,notion,0,1,1,0,1,1,0.013103,4,0.272684,0.291543,0
高度(1946),高度,notion,0,1,1,0,1,1,0.005304,4,0.259537,0.268322,0
高等教育(1946),高等教育,notion,0,2,2,0,2,2,0.031004,4,0.302277,0.336493,1833.728143
高考(1946),高考,notion,0,1,1,0,1,1,0.013378,4,0.272039,0.290456,0
高而基(1946),高而基,notion,0,1,1,0,1,1,0.013378,4,0.272039,0.290456,0
高院(1946),高院,notion,0,1,1,0,1,1,0.018893,4,0.282798,0.307938,0
高集(1946),高集,notion,0,1,1,0,1,1,0.013634,4,0.273332,0.292631,0
高龙斯基(1946),高龙斯基,notion,0,1,1,0,1,1,0.013103,4,0.272684,0.291543,0
鬥士(1946),鬥士,notion,0,1,1,0,1,1,0.017626,4,0.281496,0.305894,0
鬼国(1946),鬼国,notion,0,1,1,0,1,1,0.017626,4,0.281496,0.305894,0
魅影(1946),魅影,notion,0,1,1,0,1,1,0.013634,4,0.273332,0.292631,0
魏劳德(1946),魏劳德,notion,0,1,1,0,1,1,0.013103,4,0.272684,0.291543,0
魏来国(1946),魏来国,notion,0,1,1,0,1,1,0.00826,4,0.264992,0.278237,0
魔手(1946),魔手,notion,0,2,2,0,2,2,0.027153,4,0.296784,0.32884,1981.441549
魔术家(1946),魔术家,notion,0,1,1,0,1,1,0.013378,4,0.272039,0.290456,0
鲁尔(1946),鲁尔,notion,0,1,1,0,1,1,0.017626,4,0.281496,0.305894,0
鲁斯(1946),鲁斯,notion,0,1,1,0,1,1,0.013378,4,0.272039,0.290456,0
鳞爪(1946),鳞爪,notion,0,3,3,0,5,5,0.035837,4,0.310975,0.348133,5214.773728
鸟瞰(1946),鸟瞰,notion,0,1,1,0,1,1,0.004479,4,0.256686,0.262973,0
鸡鸣(1946),鸡鸣,notion,0,1,1,0,1,1,0.00826,4,0.264992,0.278237,0
鸡鸣寺(1946),鸡鸣寺,notion,0,1,1,0,1,1,0.017626,4,0.281496,0.305894,0
鸭绿江(1946),鸭绿江,notion,0,1,1,0,1,1,0.018893,4,0.282798,0.307938,0
鹏飞(1946),鹏飞,notion,0,1,1,0,1,1,0.00826,4,0.264992,0.278237,0
鹰之歌(1946),鹰之歌,notion,0,1,1,0,1,1,0.013103,4,0.272684,0.291543,0
鹳山(1946),鹳山,notion,0,1,1,0,1,1,0.013634,4,0.273332,0.292631,0
麦克(1946),麦克,notion,0,1,1,0,1,1,0.009637,4,0.265506,0.27915,0
麦帅(1946),麦帅,notion,0,1,1,0,1,1,0.017626,4,0.281496,0.305894,0
麻木(1946),麻木,notion,0,1,1,0,1,1,0.018893,4,0.282798,0.307938,0
黄埔(1946),黄埔,notion,0,1,1,0,1,1,0.017626,4,0.281496,0.305894,0
黄季陆(1946),黄季陆,notion,0,1,1,0,1,1,0.018893,4,0.282798,0.307938,0
黄水(1946),黄水,notion,0,1,1,0,1,1,0.018893,4,0.282798,0.307938,0
黄河(1946),黄河,notion,0,2,2,0,2,2,0.012837,4,0.272632,0.291529,2112.615352
黄浦江(1946),黄浦江,notion,0,1,1,0,1,1,0.018893,4,0.282798,0.307938,0
黄花岗(1946),黄花岗,notion,0,1,1,0,1,1,0.017626,4,0.281496,0.305894,0
黄金(1946),黄金,notion,0,1,1,0,2,2,0.013634,4,0.273332,0.292631,0
黄金时代(1946),黄金时代,notion,0,1,1,0,2,2,0.017626,4,0.281496,0.305894,0
黄鱼(1946),黄鱼,notion,0,2,2,0,2,2,0.032527,4,0.303393,0.338015,1614.891208
黎巴嫩(1946),黎巴嫩,notion,0,1,1,0,2,2,0.013103,4,0.272684,0.291543,0
黎珊(1946),黎珊,notion,0,1,1,0,1,1,0.005461,4,0.25793,0.265322,0
黑名单(1946),黑名单,notion,0,1,1,0,1,1,0.00826,4,0.264992,0.278237,0
黑市(1946),黑市,notion,0,1,1,0,1,1,0.018893,4,0.282798,0.307938,0
黑息(1946),黑息,notion,0,1,1,0,1,1,0.017626,4,0.281496,0.305894,0
黑暗(1946),黑暗,notion,0,4,4,0,5,5,0.055542,4,0.334887,0.376906,7366.316748
黑流(1946),黑流,notion,0,1,1,0,1,1,0.00826,4,0.264992,0.278237,0
黑色(1946),黑色,notion,0,1,1,0,1,1,0.013378,4,0.272039,0.290456,0
黔东(1946),黔东,notion,0,1,1,0,1,1,0.017626,4,0.281496,0.305894,0
黔北(1946),黔北,notion,0,1,1,0,1,1,0.017626,4,0.281496,0.305894,0
黔灵(1946),黔灵,notion,0,1,1,0,1,1,0.017626,4,0.281496,0.305894,0
默告(1946),默告,notion,0,1,1,0,1,1,0.004564,4,0.256755,0.263104,0
黩式(1946),黩式,notion,0,1,1,0,1,1,0.013103,4,0.272684,0.291543,0
黩武(1946),黩武,notion,0,3,3,0,4,4,0.031841,4,0.301263,0.335174,3684.483831
鼓励(1946),鼓励,notion,0,1,1,0,1,1,0.018893,4,0.282798,0.307938,0
龙头(1946),龙头,notion,0,1,1,0,1,1,0.018893,4,0.282798,0.307938,0
龙岸(1946),龙岸,notion,0,1,1,0,1,1,0.007159,4,0.261235,0.271453,0
龚击(1946),龚击,notion,0,1,1,0,1,1,0.00826,4,0.264992,0.278237,0
